Date,Open,High,Low,Close,Volume,person_buyer_count,company_buyer_count,person_buy_volume,company_buy_volume,person_seller_count,company_seller_count,person_sell_volume,company_sell_volume,person_owner_change,company_owner_change
2015-06-23,15,15,15,15,9085134,399,2,8585134,500000,284,10,5548416,3536718,3036718,-3036718
2015-06-24,15,15,15,15,9693569,424,10,8524791,1168778,304,4,6191532,3502037,2333259,-2333259
2015-06-27,15,15,15,15,7534854,303,7,4857105,2677749,219,5,3470540,4064314,1386565,-1386565
2015-06-28,14,14,14,14,7342096,270,6,4337096,3005000,205,4,3253085,4089011,1084011,-1084011
2015-06-29,14,15,14,15,5739709,218,6,3306492,2433217,190,4,2841157,2898552,465335,-465335
2015-06-30,15,15,15,15,18729948,434,8,16289622,2440326,367,13,6071886,12658062,10217736,-10217736
2015-07-01,15,15,15,15,10565761,346,5,9760761,805000,403,6,10137761,428000,-377000,377000
2015-07-04,16,16,16,16,44734910,688,8,40016648,4718262,549,16,13354163,31380747,26662485,-26662485
2015-07-05,16,16,16,16,21721616,696,1,21521616,200000,535,12,14443849,7277767,7077767,-7077767
2015-07-06,16,16,16,16,14549211,559,4,13298256,1250955,288,5,7030710,7518501,6267546,-6267546
2015-07-07,16,16,16,16,22368093,794,3,22060093,308000,542,12,11779682,10588411,10280411,-10280411
2015-07-11,16,16,16,16,12770994,403,11,8599559,4171435,500,4,10279350,2491644,-1679791,1679791
2015-07-12,16,17,16,16,16179368,453,5,8911083,2626519,438,7,10619012,918590,-1707929,1707929
2015-07-13,16,17,16,16,62621208,1865,26,46258678,16362530,1161,20,30470336,32150872,15788342,-15788342
2015-07-22,15,15,14,14,15232360,566,7,10282360,4950000,403,4,14152360,1080000,-3870000,3870000
2015-07-25,14,15,14,14,14531378,399,14,7080055,7451323,404,2,14530368,1010,-7450313,7450313
2015-07-26,14,15,14,15,14882478,427,13,8095960,6786518,500,3,14805436,77042,-6709476,6709476
2015-07-27,14,14,14,14,5392465,184,8,2469587,2922878,240,1,5112024,280441,-2642437,2642437
2015-07-28,14,14,14,14,4405597,170,5,3372534,1027063,272,0,4399597,0,-1027063,1027063
2015-07-29,15,15,14,15,24061326,382,11,12481326,11580000,588,11,14293251,9768075,-1811925,1811925
2015-08-01,15,15,15,15,12209997,217,6,4010506,3188561,307,5,6181866,1017201,-2171360,2171360
2015-08-02,15,15,15,15,7042815,233,2,4801429,2241386,283,2,5730974,1311841,-929545,929545
2015-08-03,15,15,15,15,5698914,123,6,1953113,3745801,293,0,5698914,0,-3745801,3745801
2015-08-04,15,15,14,15,8489371,119,6,1850149,6639222,350,1,8354371,135000,-6504222,6504222
2015-08-05,15,15,14,15,7940607,241,4,5798150,2139500,298,1,7437650,500000,-1639500,1639500
2015-08-08,15,15,14,14,8341391,202,6,3065391,5276000,284,2,8031503,309888,-4966112,4966112
2015-08-09,14,14,14,14,5871012,134,4,1473640,4397372,246,0,5871012,0,-4397372,4397372
2015-08-10,14,14,14,14,4362257,72,5,679339,3682918,194,2,2362257,2000000,-1682918,1682918
2015-08-12,14,14,14,14,1369202,108,1,1239202,130000,121,0,1369202,0,-130000,130000
2015-08-15,14,14,14,14,5978595,285,3,3688595,2290000,219,1,3004139,2974456,684456,-684456
2015-08-16,14,14,14,14,5477651,150,7,2094016,3383635,181,3,3582273,1895378,-1488257,1488257
2015-08-17,14,14,14,14,3376193,100,8,1168103,2208090,174,2,2953731,422462,-1785628,1785628
2015-08-18,14,14,14,14,4795902,101,3,966704,1191095,74,1,2134213,23586,-1167509,1167509
2015-08-19,14,14,14,14,3441319,135,4,1262309,2179010,111,3,2935591,505728,-1673282,1673282
2015-08-22,14,14,13,13,3807855,291,5,3397855,410000,109,2,2826198,981657,571657,-571657
2015-08-23,13,13,13,13,10770930,417,9,7536070,3234860,155,7,5227096,5543834,2308974,-2308974
2015-08-24,13,13,13,13,8346357,206,5,5996337,2350020,186,4,4877568,3468789,1118769,-1118769
2015-08-25,13,13,13,13,13327118,286,11,3834212,9492906,269,7,8792261,4534857,-4958049,4958049
2015-08-26,13,13,13,13,3304039,130,5,1621556,1682483,119,4,1566064,1737975,55492,-55492
2015-08-29,13,14,13,14,9947489,192,5,5838463,4209026,189,13,4810156,5237333,1028307,-1028307
2015-08-30,14,14,13,13,6417915,145,6,2612818,3805097,152,5,4990212,1427703,-2377394,2377394
2015-08-31,13,13,13,13,2138084,166,3,1961654,176430,125,2,2036084,102000,-74430,74430
2015-09-01,13,13,13,13,4719522,121,5,3307033,1412489,134,4,3208459,1511063,98574,-98574
2015-09-02,13,13,13,13,2530900,163,4,1921341,609559,86,5,1926650,604250,-5309,5309
2015-09-05,13,14,13,13,5326703,218,1,5276703,50000,218,3,5180499,146204,96204,-96204
2015-09-06,13,14,13,13,5891193,217,4,4116193,1775000,187,2,5726227,164966,-1610034,1610034
2015-09-07,13,13,13,13,5704310,154,4,1873193,3831117,219,3,3604451,2099859,-1731258,1731258
2015-09-08,13,13,13,13,4550478,276,2,3950478,600000,130,5,3985898,564580,-35420,35420
2015-09-09,13,13,13,13,8352030,278,6,7282030,1070000,162,4,2370130,5981900,4911900,-4911900
2015-09-12,13,13,13,13,3605891,220,3,3493891,112000,140,4,2537670,1068221,956221,-956221
2015-09-13,13,13,12,12,17984678,691,9,13009678,4975000,238,10,10238181,7746497,2771497,-2771497
2015-09-14,13,13,12,12,6357707,208,4,2851003,3506704,242,2,5741657,616050,-2890654,2890654
2015-09-15,12,12,12,12,6085395,288,3,4814501,1270894,230,3,5645395,440000,-830894,830894
2015-09-16,12,12,12,12,4911497,316,4,4714497,197000,274,0,4911497,0,-197000,197000
2015-09-19,12,12,12,12,4244987,178,4,3946987,298000,169,4,3735125,509862,211862,-211862
2015-09-20,12,12,11,11,4907041,265,2,4857041,50000,140,4,4631031,276010,226010,-226010
2015-09-21,11,11,11,11,17802890,496,12,12331732,5471158,360,9,15762809,2040081,-3431077,3431077
2015-09-22,11,11,11,11,6875265,275,2,6615265,260000,215,4,4955265,1920000,1660000,-1660000
2015-09-23,11,11,11,11,7457970,261,3,6480368,1020000,236,4,6120368,1380000,360000,-360000
2015-09-23,11,11,11,11,42398,261,3,6480368,1020000,236,4,6120368,1380000,360000,-360000
2015-09-26,11,11,11,11,5570247,157,5,2491178,3079069,209,2,5170247,400000,-2679069,2679069
2015-09-27,11,11,11,11,8014602,231,7,4692573,3322029,253,5,7134899,879703,-2442326,2442326
2015-09-28,11,11,11,11,3514972,99,7,1119511,2395461,150,4,3299981,214991,-2180470,2180470
2015-09-29,11,11,11,11,5262404,139,4,3774404,1488000,131,1,3262404,2000000,512000,-512000
2015-09-30,11,11,11,11,2945035,148,5,1661035,1284000,134,2,2756035,189000,-1095000,1095000
2015-10-03,11,11,10,10,10353955,283,8,4339955,6014000,148,10,6390029,3963926,-2050074,2050074
2015-10-04,10,10,10,10,28140436,769,16,24751597,3388839,491,15,16464742,11675694,8286855,-8286855
2015-10-05,10,10,10,10,6894619,305,2,5537619,1357000,211,7,5920464,974155,-382845,382845
2015-10-06,10,10,9,9,12203337,457,11,9758337,2445000,269,3,9077232,3126105,681105,-681105
2015-10-07,9,10,9,9,10728480,301,7,8401903,2326577,276,4,8664945,2063535,-263042,263042
2015-10-10,9,9,9,9,6243183,209,5,4454757,1788426,244,1,5643183,600000,-1188426,1188426
2015-10-11,9,9,9,9,11322931,326,5,10672931,650000,267,7,9096628,2226303,1576303,-1576303
2015-10-12,9,9,9,9,6660895,169,6,5783895,877000,234,4,5057658,1603237,726237,-726237
2015-10-13,9,10,9,10,8485662,193,2,7965662,520000,277,5,5826595,2659067,2139067,-2139067
2015-10-14,10,10,10,10,11859379,223,15,7994535,3864844,295,8,10885121,974258,-2890586,2890586
2015-10-17,10,11,10,11,17683848,397,5,16687848,996000,343,11,9887027,7796821,6800821,-6800821
2015-10-18,11,11,11,11,42745823,718,15,39945823,2800000,726,19,26505587,16240236,13440236,-13440236
2015-10-19,11,11,11,11,12134155,365,9,9745903,2388252,402,6,10294155,1840000,-548252,548252
2015-10-20,11,11,10,10,10968453,346,4,8968453,2000000,243,4,7428213,3540240,1540240,-1540240
2015-10-21,10,10,10,10,9388610,266,5,7788610,1600000,264,0,9388610,0,-1600000,1600000
2015-10-28,10,10,10,10,14923969,196,5,5213071,1686531,137,4,6323451,576151,-1110380,1110380
2015-10-31,10,10,10,10,51914095,284,5,5987955,45926140,205,3,5695492,46218603,292463,-292463
2015-11-01,10,10,10,10,8340703,175,3,7359449,981254,262,4,6094383,2246320,1265066,-1265066
2015-11-02,10,11,10,10,133021184,363,4,12312797,120708387,441,6,12042392,120978792,270405,-270405
2015-11-03,10,10,10,10,3259707,131,3,2649707,610000,178,2,3059615,200092,-409908,409908
2015-11-04,10,10,10,10,125091697,218,3,6104214,118987483,147,2,4555197,120536500,1549017,-1549017
2015-11-07,10,11,10,11,128809116,252,5,8382463,120426653,283,4,8459116,120350000,-76653,76653
2015-11-08,11,11,11,11,83626479,153,6,5178851,78447628,261,2,7890811,75735668,-2711960,2711960
2015-11-09,11,11,11,11,8219417,226,3,7262110,957307,203,6,7193290,1026127,68820,-68820
2015-11-10,11,11,11,11,11703224,278,1,11698224,5000,313,6,11154686,548538,543538,-543538
2015-11-11,11,11,11,11,6559140,145,3,4681505,1869635,212,3,6004136,547004,-1322631,1322631
2015-11-14,11,11,11,11,7490937,314,6,6961991,528946,193,2,6956329,534608,5662,-5662
2015-11-15,11,11,10,10,11269882,459,7,10189882,1070000,228,3,10557899,701983,-368017,368017
2015-11-16,10,11,10,11,25755273,703,7,25015303,739970,558,14,19631796,6123477,5383507,-5383507
2015-11-17,10,10,10,10,21155109,751,4,20344309,810800,306,5,18358702,2796407,1985607,-1985607
2015-12-05,10,10,10,10,19449089,793,3,17484790,1951639,239,5,15269325,4167104,2215465,-2215465
2015-12-06,10,10,9,9,11356758,572,5,10514258,842500,341,1,11330758,26000,-816500,816500
2015-12-07,9,10,9,9,5956122,369,2,5856122,100000,238,2,4906122,1050000,950000,-950000
2015-12-08,9,9,9,9,4022269,165,2,3952269,70000,184,1,3522269,500000,430000,-430000
2015-12-09,9,10,9,10,6314188,150,4,3483335,258365,135,5,2693652,1048048,789683,-789683
2015-12-13,10,10,9,9,3698741,190,3,3257221,441520,149,3,3228741,470000,28480,-28480
2015-12-14,9,10,9,10,4552923,172,0,4552923,0,228,2,4458872,94051,94051,-94051
2015-12-15,10,10,10,10,4806748,187,2,4413194,393554,217,2,4557015,249733,-143821,143821
2015-12-16,10,10,9,9,6389591,226,4,5329591,1060000,161,1,6289591,100000,-960000,960000
2015-12-19,9,9,9,9,8293618,274,1,8243618,50000,176,0,8293618,0,-50000,50000
2015-12-20,9,9,9,9,11697625,280,4,8708167,2989458,173,3,6465529,5232096,2242638,-2242638
2015-12-21,9,9,9,9,4464022,165,3,3992808,471214,136,3,3726118,737904,266690,-266690
2015-12-22,9,9,9,9,5034748,97,4,3206097,1828651,194,2,4634748,400000,-1428651,1428651
2015-12-23,9,9,9,9,6070203,120,6,4871933,1198270,135,3,3590203,2480000,1281730,-1281730
2015-12-26,9,9,9,9,5856781,79,10,5170931,685850,171,1,5855353,1428,-684422,684422
2015-12-27,9,9,9,9,7724806,233,1,7646806,78000,255,6,6250725,1474081,1396081,-1396081
2015-12-28,9,9,9,9,8462671,247,6,7482671,980000,153,1,8396671,66000,-914000,914000
2015-12-30,9,9,9,9,8081181,147,4,5481181,2600000,239,1,7621365,459816,-2140184,2140184
2016-01-02,9,9,9,9,3142317,122,3,2169694,972623,147,2,2935463,206854,-765769,765769
2016-01-03,9,9,9,9,2816879,122,2,2300379,516500,125,2,2713382,103497,-413003,413003
2016-01-04,9,9,9,9,34169856,178,4,3214872,30954984,139,3,4090745,30079111,-875873,875873
2016-01-05,9,10,9,10,5981162,149,1,5731162,250000,279,0,5981162,0,-250000,250000
2016-01-06,10,10,10,10,18070306,328,3,15470306,2600000,406,9,12294889,5775417,3175417,-3175417
2016-01-09,10,10,10,10,11730403,402,4,9670403,2060000,340,2,9733574,1996829,-63171,63171
2016-01-10,10,10,10,10,8398748,271,1,8298748,100000,282,3,7698748,700000,600000,-600000
2016-01-11,10,11,10,11,19417710,238,11,14937719,4479991,278,6,5622526,13795184,9315193,-9315193
2016-01-12,11,11,11,11,26405862,702,7,23045862,3360000,492,13,21361709,5044153,1684153,-1684153
2016-01-13,11,11,11,11,20164115,460,3,19661012,503103,518,9,17892115,2272000,1768897,-1768897
2016-01-16,11,12,11,12,23198425,497,2,22560925,637500,373,12,14263874,8934551,8297051,-8297051
2016-01-17,12,12,11,11,36161755,954,8,32536179,3625576,751,13,29637755,6524000,2898424,-2898424
2016-01-18,11,12,11,12,39481495,546,11,23022315,16459180,681,17,26014596,13466899,-2992281,2992281
2016-01-19,12,12,12,12,12797558,79,4,10397426,2400132,269,5,8237558,4560000,2159868,-2159868
2016-01-20,12,13,12,13,57754935,962,13,47849935,9905000,845,24,39474759,18280176,8375176,-8375176
2016-01-23,13,13,12,13,56801514,1036,11,48431905,8369609,924,22,39386269,17415245,9045636,-9045636
2016-01-24,13,13,13,13,46996199,1079,19,41162109,5834090,614,23,27672515,19323684,13489594,-13489594
2016-01-25,13,14,13,14,52555472,1384,22,45708132,6847340,658,21,25235379,27320093,20472753,-20472753
2016-01-26,14,15,14,15,47937523,1167,17,45500854,2436669,411,22,10032846,37904677,35468008,-35468008
2016-01-27,15,15,14,14,112422927,2207,20,102316427,10106500,1367,35,64282865,48140062,38033562,-38033562
2016-01-30,15,15,14,14,76254295,2111,22,65299295,10955000,1229,17,65983184,10271111,-683889,683889
2016-01-31,14,14,14,14,56592662,1107,22,37459083,19133579,1195,11,52388200,4204462,-14929117,14929117
2016-02-01,14,14,14,14,59063678,1238,20,48648945,10414733,768,15,30823382,28240296,17825563,-17825563
2016-02-02,15,15,14,14,39759380,1353,13,36844440,2914940,717,13,31264909,8494471,5579531,-5579531
2016-02-03,14,15,14,14,42830749,1048,19,35965904,6864845,948,8,35959808,6870941,6096,-6096
2016-02-06,15,15,15,15,40446256,151,8,11046256,29400000,737,11,26477756,13968500,-15431500,15431500
2016-02-07,16,16,16,16,7161289,60,10,5662289,1499000,126,3,1551282,5610007,4111007,-4111007
2016-02-08,17,17,17,17,861627,10,1,761627,100000,43,0,861627,0,-100000,100000
2016-02-10,17,17,17,17,27019273,179,10,24919273,2100000,111,2,3519273,23500000,21400000,-21400000
2016-02-13,17,18,17,17,225671310,2993,46,150055310,75616000,2212,58,139742639,85928671,10312671,-10312671
2016-02-14,17,18,17,17,75884227,1485,15,65435543,10448684,1335,27,66885626,8998601,-1450083,1450083
2016-02-15,18,18,18,18,148860968,880,32,87822344,61038624,1233,32,51114022,97746946,36708322,-36708322
2016-02-16,19,19,18,19,130161896,2086,33,107610477,22551419,1446,30,70141141,60020755,37469336,-37469336
2016-02-17,20,20,20,20,43955205,286,10,24269880,19685325,527,13,18522670,25432535,5747210,-5747210
2016-02-20,20,20,19,19,116368906,2961,9,99338606,17030300,1119,23,88530906,27838000,10807700,-10807700
2016-02-21,19,19,18,18,105739299,1814,24,64117799,41621500,1459,22,78259799,27479500,-14142000,14142000
2016-02-22,19,19,19,19,95668296,857,20,80930556,14737740,915,18,31255296,64413000,49675260,-49675260
2016-02-23,20,20,19,19,185997164,3204,40,158591898,27405266,1867,43,119408444,66588720,39183454,-39183454
2016-02-24,19,21,19,20,103682720,2069,21,85152498,18530222,1766,20,71420680,32262040,13731818,-13731818
2016-02-27,21,21,21,21,129317516,2554,38,111227221,18090295,1501,22,61252699,68064817,49974522,-49974522
2016-02-28,21,21,20,20,74695267,2446,22,64465664,10229603,1354,21,62897382,11797885,1568282,-1568282
2016-02-29,20,21,20,20,75097402,2130,18,61454322,13643080,1269,12,57098158,17999244,4356164,-4356164
2016-03-01,21,21,21,21,83949736,1841,45,65141468,18808268,1658,25,62825578,21124158,2315890,-2315890
2016-03-02,21,22,20,22,113950118,1823,32,92354618,21595500,1926,21,78189558,35760560,14165060,-14165060
2016-03-05,22,22,22,22,44289988,376,9,33536988,10753000,779,8,23878265,20411723,9658723,-9658723
2016-03-06,23,23,23,23,30904439,431,14,28104439,2800000,211,3,3004439,27900000,25100000,-25100000
2016-03-07,25,25,24,24,236128463,3663,86,176101658,60026805,2770,43,180617421,55511042,-4515763,4515763
2016-03-08,24,25,24,24,103690869,2383,34,76528429,27162440,2246,24,87671376,16019493,-11142947,11142947
2016-03-14,26,26,26,26,93751023,506,22,81401023,12350000,156,5,1350023,92401000,80051000,-80051000
2016-03-15,27,27,26,27,250040294,4547,88,188437161,61603133,1468,28,89948544,160091750,98488617,-98488617
2016-03-16,27,28,26,27,167126567,3593,57,123444962,43681605,1984,32,104202817,62923750,19242145,-19242145
2016-03-26,27,27,26,26,35567119,1208,8,31567119,4000000,608,12,31885855,3681264,-318736,318736
2016-03-27,25,27,25,25,41231912,1478,22,32793629,8438283,637,10,37755450,3476462,-4961821,4961821
2016-03-28,24,25,24,24,16776728,659,1,16276728,500000,405,3,15776728,1000000,500000,-500000
2016-03-29,23,25,23,25,144905516,3350,35,106641940,38263576,2449,33,125724012,19181504,-19082072,19082072
2016-03-30,25,25,25,25,34215165,241,3,31215165,3000000,173,5,2546180,31668985,28668985,-28668985
2016-04-02,25,26,24,24,90761525,2881,14,77558069,13203456,1606,21,83822837,6938688,-6264768,6264768
2016-04-03,25,25,24,25,88901659,2518,32,73641635,15260024,1506,22,80963919,7937740,-7322284,7322284
2016-04-04,25,25,24,25,91652574,2691,33,79544705,12107869,1367,26,76494115,15158459,3050590,-3050590
2016-04-05,25,26,25,26,79439555,1380,29,65989016,13450539,1666,27,50983574,28455981,15005442,-15005442
2016-04-06,26,27,25,25,71694247,2795,16,63119112,8575135,1603,22,60365728,11328519,2753384,-2753384
2016-04-09,26,27,26,27,64055867,2419,27,59555867,4500000,1624,22,54302064,9753803,5253803,-5253803
2016-04-10,26,26,25,25,85507940,2694,24,69669311,15838629,1496,34,66970103,18537837,2699208,-2699208
2016-04-11,25,26,24,25,47699941,2111,18,39898977,7800964,1041,17,39521965,8177976,377012,-377012
2016-04-12,25,25,24,24,63510213,2540,14,44105695,19404518,832,9,53767602,9742611,-9661907,9661907
2016-04-13,23,24,23,23,94372709,2766,39,55965597,38407112,1481,35,84036387,10336322,-28070790,28070790
2016-04-16,22,23,22,22,14273578,648,8,11933578,2340000,241,8,12998578,1275000,-1065000,1065000
2016-04-17,21,21,21,21,110242780,2666,29,85552780,24690000,1898,30,88104117,22138663,-2551337,2551337
2016-04-18,21,22,21,21,55192429,1854,12,53399929,1792500,1104,21,44666820,10525609,8733109,-8733109
2016-04-19,21,21,20,20,37077490,950,5,24057390,13020100,634,13,32365611,4711879,-8308221,8308221
2016-04-20,20,20,19,19,23121671,866,7,17003671,6118000,469,4,21132331,1989340,-4128660,4128660
2016-04-23,19,20,19,19,73305214,2043,17,57238592,16066622,1478,9,68898904,4406310,-11660312,11660312
2016-04-24,19,20,19,20,24104338,450,12,19958038,4146300,820,5,23383240,721098,-3425202,3425202
2016-04-25,21,21,20,20,79271879,1931,25,58435221,20836658,1481,18,65557977,13713902,-7122756,7122756
2016-04-26,20,21,20,20,58720349,964,9,30550124,28170225,1120,5,38589058,20131291,-8038934,8038934
2016-04-27,21,21,20,21,39265089,254,5,35165089,4100000,804,3,17165089,22100000,18000000,-18000000
2016-04-30,22,22,21,22,198967562,1498,42,160439029,38530433,2873,42,111186785,87782677,49252244,-49252244
2016-04-30,22,22,22,22,1900,1498,42,160439029,38530433,2873,42,111186785,87782677,49252244,-49252244
2016-05-01,22,23,22,22,98104683,1852,31,84914771,13189912,2019,34,73360469,24744214,11554302,-11554302
2016-05-02,22,24,22,23,125749386,2114,30,107160728,18588658,2356,31,110919862,14829524,-3759134,3759134
2016-05-03,23,24,23,23,85366358,1505,18,62569158,22797200,1323,25,67601274,17765084,-5032116,5032116
2016-05-04,23,24,23,24,120192869,1682,29,102897368,17295501,2485,48,98025679,22167190,4871689,-4871689
2016-05-07,24,24,23,23,41111345,1265,16,34889345,6222000,650,5,34077379,7033966,811966,-811966
2016-05-08,22,23,22,22,125161976,2319,23,90396453,34765523,1625,20,107213791,17948185,-16817338,16817338
2016-05-09,22,22,21,21,42082060,1873,12,32764070,9317990,692,2,41183560,898500,-8419490,8419490
2016-05-10,20,21,20,20,47609987,1536,19,35657487,11952500,553,3,43094987,4515000,-7437500,7437500
2016-05-11,20,20,19,20,122770703,2442,27,63516133,59254570,1420,21,101538510,21232193,-38022377,38022377
2016-05-14,20,20,20,20,15892844,229,2,14909138,983706,618,2,15662844,230000,-753706,753706
2016-05-15,21,21,20,21,84597507,1277,19,66190456,18407051,2068,16,57432417,27165090,8758039,-8758039
2016-05-17,21,21,20,20,26492769,802,9,21162769,5330000,686,5,25724619,768150,-4561850,4561850
2016-05-18,20,21,20,21,30712673,714,9,21894573,8818100,766,6,28884161,1828512,-6989588,6989588
2016-05-21,21,22,21,21,17507675,526,5,15417675,2090000,630,2,17257675,250000,-1840000,1840000
2016-05-23,22,22,21,22,37558959,869,10,33695959,3863000,1113,7,34008959,3550000,-313000,313000
2016-05-24,22,22,21,21,29662023,1026,5,28242023,1420000,873,4,29646873,15150,-1404850,1404850
2016-05-25,21,22,21,22,21502625,438,3,9282717,12219908,666,6,19632625,1870000,-10349908,10349908
2016-05-28,22,22,21,21,10813078,486,4,9981622,831456,576,4,10083078,730000,-101456,101456
2016-05-29,21,22,21,21,11295502,538,4,10798166,497336,459,1,11038566,256936,-240400,240400
2016-05-30,21,22,21,21,18912957,518,12,12983354,5929603,503,3,14611957,4301000,-1628603,1628603
2016-05-31,21,21,20,21,12099698,519,8,8795654,3304044,405,1,12091742,7956,-3296088,3296088
2016-06-01,20,22,20,22,33751846,434,8,15850846,17901000,809,8,17981678,15770168,-2130832,2130832
2016-06-05,22,22,21,22,36948587,691,16,28178587,8770000,1088,7,30593587,6355000,-2415000,2415000
2016-06-06,22,22,21,21,16267566,608,7,11828566,4439000,599,3,15623117,644449,-3794551,3794551
2016-06-07,21,22,21,21,8453433,391,2,5553433,2900000,363,3,7795691,657742,-2242258,2242258
2016-06-08,21,22,21,21,11191309,540,5,9690039,1501270,705,4,10351309,840000,-661270,661270
2016-06-11,21,22,20,20,20131930,795,6,10088034,10043896,406,3,19826930,305000,-9738896,9738896
2016-06-12,20,21,19,20,14908385,702,5,9820249,5088136,505,3,13208385,1700000,-3388136,3388136
2016-06-13,20,20,19,20,17315593,771,7,10609739,6705854,402,6,12163493,5152100,-1553754,1553754
2016-06-14,20,20,19,19,38574973,1151,15,22802612,15772361,767,4,33024973,5550000,-10222361,10222361
2016-06-15,19,20,19,20,23956799,854,7,19406799,4550000,768,8,20455299,3501500,-1048500,1048500
2016-06-18,20,20,19,19,36747812,527,7,8679043,28068769,453,4,15347812,21400000,-6668769,6668769
2016-06-19,19,19,19,19,22613098,813,4,16066144,6546954,550,6,20299717,2313381,-4233573,4233573
2016-06-20,19,19,18,18,32080031,699,7,11930832,20149199,639,4,21372428,10707603,-9441596,9441596
2016-06-21,19,20,18,20,24323534,665,12,14565443,9758091,876,5,22589534,1734000,-8024091,8024091
2016-06-22,20,20,20,20,16059964,429,8,12459964,3600000,525,5,12234964,3825000,225000,-225000
2016-06-25,20,21,19,19,17031887,747,4,14862905,2168982,608,10,15633503,1398384,-770598,770598
2016-06-26,19,21,19,21,24018117,710,8,19688117,4330000,989,8,22306501,1711616,-2618384,2618384
2016-06-28,21,21,21,21,61586532,1358,14,51959132,9627400,919,20,34240416,27346116,17718716,-17718716
2016-06-29,21,22,20,21,47163568,1604,13,41080568,6083000,1152,12,45158568,2005000,-4078000,4078000
2016-07-02,21,21,20,20,36357593,1478,5,35113525,1244068,697,6,29188032,7169561,5925493,-5925493
2016-07-03,21,21,20,20,28943472,1282,7,26379462,2564010,644,10,18830116,10113356,7549346,-7549346
2016-07-04,21,21,20,20,30906101,1154,11,18856401,12049700,699,1,29106101,1800000,-10249700,10249700
2016-07-05,20,20,20,20,14933853,662,5,12466680,2467173,511,3,12995997,1937856,-529317,529317
2016-07-09,19,20,19,19,32911784,1602,7,26589274,6322510,628,17,29288536,3623248,-2699262,2699262
2016-07-10,19,19,18,19,24702194,1091,13,18829660,5872534,686,1,21902194,2800000,-3072534,3072534
2016-07-11,19,19,18,18,28496244,1124,13,20157513,8338731,833,8,24260903,4235341,-4103390,4103390
2016-07-17,19,19,18,18,21272115,701,5,15048115,6224000,371,7,14977724,6294391,70391,-70391
2016-07-18,18,18,18,18,19221734,594,9,11913320,7308414,604,7,17232738,1988996,-5319418,5319418
2016-07-19,18,19,18,19,24605339,891,14,16854330,7751009,715,10,14651335,9954004,2202995,-2202995
2016-07-25,20,20,19,19,28171138,860,13,20515242,7655896,950,16,20906933,7264205,-391691,391691
2016-07-26,19,20,19,19,13881295,541,7,10381328,3499967,468,1,11281295,2600000,-899967,899967
2016-07-27,19,19,19,19,28421747,993,9,15820649,12601098,448,13,24594149,3827598,-8773500,8773500
2016-07-31,19,20,19,19,20256958,514,10,13201447,7055511,770,5,19406879,850079,-6205432,6205432
2016-08-01,19,19,19,19,10361483,463,3,5861483,4500000,356,7,8678783,1682700,-2817300,2817300
2016-08-02,19,19,18,19,15319181,596,9,9349181,5970000,671,6,13817139,1502042,-4467958,4467958
2016-08-03,20,20,19,20,53198625,878,14,42672215,11195676,1206,24,42917464,10950427,-245249,245249
2016-08-06,20,20,19,19,21462469,874,7,19774712,1687757,595,6,18142119,3320350,1632593,-1632593
2016-08-07,19,20,19,19,21295644,818,6,19525644,1770000,639,7,15866704,5428940,3658940,-3658940
2016-08-08,20,20,19,19,15506315,531,4,11429539,4076776,424,5,11694230,3812085,-264691,264691
2016-08-09,19,19,19,19,16857641,697,8,10371438,6486203,380,3,11788341,5069300,-1416903,1416903
2016-08-10,19,19,19,19,16138306,719,7,12330706,3807600,322,6,10084306,6054000,2246400,-2246400
2016-08-13,19,19,19,19,14942656,619,3,14659677,282979,506,5,13409656,1533000,1250021,-1250021
2016-08-14,19,20,19,19,14441843,704,13,13106843,1335000,506,5,14086531,355312,-979688,979688
2016-08-15,19,19,19,19,11653874,484,9,6193874,5460000,315,3,8761874,2892000,-2568000,2568000
2016-08-16,19,19,19,19,9406838,497,8,6525517,2881321,266,1,9306838,100000,-2781321,2781321
2016-08-17,19,19,19,19,10210168,358,5,9102911,1107257,272,3,10100599,109569,-997688,997688
2016-08-20,19,19,18,19,14700306,721,9,11810876,2889430,329,2,12200306,2500000,-389430,389430
2016-08-21,18,19,18,19,15238372,627,4,11811139,3427233,334,5,9380025,5858347,2431114,-2431114
2016-08-22,19,20,19,19,37232355,601,18,23312774,13919581,1004,14,24755057,12477298,-1442283,1442283
2016-08-23,19,19,19,19,13095816,254,19,5685756,7410060,416,7,8856436,4239380,-3170680,3170680
2016-08-24,19,19,19,19,11909598,238,7,5703002,6206596,355,4,8112869,3796729,-2409867,2409867
2016-08-27,19,19,19,19,10758043,319,6,5258043,5500000,303,2,7658043,3100000,-2400000,2400000
2016-08-28,19,19,18,18,16126938,676,13,7692249,8434689,357,3,13086938,3040000,-5394689,5394689
2016-08-29,18,19,18,18,18334030,421,11,5309630,13024400,236,4,7034030,11300000,-1724400,1724400
2016-08-30,18,19,18,18,5347511,333,4,4520858,826653,219,2,4565309,782202,-44451,44451
2016-08-31,18,19,18,18,11507976,669,9,8122976,3385000,272,6,7865471,3642505,257505,-257505
2016-09-03,18,18,17,17,20331860,992,9,14256230,6075630,594,12,17965360,2366500,-3709130,3709130
2016-09-04,17,18,17,17,14331583,547,3,10756583,3575000,404,6,10440896,3890687,315687,-315687
2016-09-05,18,18,17,17,7097165,251,3,4980162,2117003,286,9,6441858,655307,-1461696,1461696
2016-09-06,18,18,18,18,17572407,439,8,13649022,3923385,554,10,14274439,3297968,-625417,625417
2016-09-07,18,19,18,18,13384691,299,11,6212150,7172541,450,8,9299439,4085252,-3087289,3087289
2016-09-10,18,18,18,18,10005353,225,8,4655116,5350237,340,2,6895650,3109703,-2240534,2240534
2016-09-11,18,19,18,18,13246312,291,8,9789812,3456500,479,5,9958304,3288008,-168492,168492
2016-09-13,18,19,18,18,9017448,308,7,8103648,913800,294,4,5615190,3402258,2488458,-2488458
2016-09-14,18,18,18,18,15990000,389,10,10320478,5669522,271,4,12727281,3262719,-2406803,2406803
2016-09-17,18,18,18,18,11841304,406,9,9176862,2664442,316,2,10935360,905944,-1758498,1758498
2016-09-18,18,18,18,18,5712175,272,3,5162175,550000,203,2,2977476,2734699,2184699,-2184699
2016-09-19,18,18,18,18,13635378,321,7,12045026,1590352,329,4,7403077,6232301,4641949,-4641949
2016-09-21,18,18,18,18,6743728,299,8,5064369,1679359,322,4,6412753,330975,-1348384,1348384
2016-09-24,18,19,18,19,18717733,298,17,10672733,8045000,533,11,11512381,7205352,-839648,839648
2016-09-25,19,19,19,19,23714357,509,15,18291357,5423000,778,8,19674249,4040108,-1382892,1382892
2016-09-26,19,19,18,18,10371272,426,7,9086272,1285000,335,3,8591086,1780186,495186,-495186
2016-09-27,18,19,18,18,10297913,365,3,9097913,1200000,282,1,10272913,25000,-1175000,1175000
2016-09-28,18,19,18,19,15472169,435,2,15207169,265000,633,6,14761253,710916,445916,-445916
2016-10-01,19,19,19,19,20303644,683,6,17503644,2800000,618,12,17704588,2599056,-200944,200944
2016-10-02,19,19,19,19,18269445,576,7,14456321,3813124,455,10,14840953,3428492,-384632,384632
2016-10-03,19,20,19,20,122653021,1000,36,105723021,16930000,1564,29,41298996,81354025,64424025,-64424025
2016-10-04,20,21,20,20,148812645,1175,35,128828645,19984000,2080,35,90194347,58618298,38634298,-38634298
2016-10-05,20,21,20,21,68067239,1318,15,60159609,7907630,1985,21,61431225,6636014,-1271616,1271616
2016-10-08,21,22,20,20,33824840,978,6,31712340,2112500,770,13,29729859,4094981,1982481,-1982481
2016-10-09,20,21,20,20,14738659,510,6,12830696,1907963,473,4,13827659,911000,-996963,996963
2016-10-10,20,21,20,21,18394585,390,7,13093585,5301000,645,7,17366165,1028420,-4272580,4272580
2016-10-15,21,21,20,20,14865262,512,6,12965262,1900000,396,12,12293075,2572187,672187,-672187
2016-10-16,20,20,20,20,15398381,522,6,15083381,315000,483,5,13895593,1502788,1187788,-1187788
2016-10-17,20,20,19,20,14071528,417,6,13010528,1061000,567,4,13116095,955433,-105567,105567
2016-10-18,20,21,20,20,8807706,252,4,8007706,800000,356,6,8311237,496469,-303531,303531
2016-10-19,20,21,20,20,19028302,332,5,17588302,1440000,655,10,17091892,1936410,496410,-496410
2016-10-22,20,21,20,20,19770021,605,7,17577021,2193000,479,5,18998021,772000,-1421000,1421000
2016-10-23,20,20,20,20,12972197,611,4,12610438,361759,402,4,12673971,298226,-63533,63533
2016-10-24,20,20,20,20,14898115,736,6,13878112,1020003,393,0,14898115,0,-1020003,1020003
2016-10-25,20,20,20,20,10946237,645,5,10211237,735000,347,4,9566287,1379950,644950,-644950
2016-10-26,20,20,20,20,12515589,504,6,8107589,4408000,398,5,11567267,948322,-3459678,3459678
2016-10-29,20,20,20,20,20979399,643,11,17764399,3215000,466,5,19396745,1582654,-1632346,1632346
2016-10-30,20,20,20,20,13283746,569,9,10275173,3008573,391,1,13282746,1000,-3007573,3007573
2016-10-31,20,20,20,20,16962919,689,7,15142919,1820000,497,1,15962919,1000000,-820000,820000
2016-11-01,20,20,19,19,11298989,642,6,8123989,3175000,337,1,11098989,200000,-2975000,2975000
2016-11-02,19,20,19,19,11372363,520,8,9559780,1812583,359,2,10272363,1100000,-712583,712583
2016-11-05,19,19,19,19,14690941,738,9,10120667,4570274,340,1,14665941,25000,-4545274,4545274
2016-11-06,19,19,19,19,6548347,339,3,5996013,552334,284,2,6256105,292242,-260092,260092
2016-11-07,19,20,19,20,20393192,362,14,17257047,3136145,680,10,14616463,5776729,2640584,-2640584
2016-11-08,20,20,20,20,14858947,494,8,13382579,1476368,479,9,9015683,5843264,4366896,-4366896
2016-11-09,19,19,19,19,51831253,940,24,26790703,25040550,581,13,45019350,6811903,-18228647,18228647
2016-11-12,19,19,18,18,39926960,1613,12,33456921,6470039,578,18,32159485,7767475,1297436,-1297436
2016-11-13,18,19,18,18,10798448,501,7,9634343,1164105,370,4,10446448,352000,-812105,812105
2016-11-14,18,19,18,19,14357155,547,5,13273941,1083214,485,6,13407155,950000,-133214,133214
2016-11-15,19,19,18,18,11434229,600,3,8034229,3400000,281,2,10819656,614573,-2785427,2785427
2016-11-16,18,18,18,18,10566784,695,6,8260803,2305981,266,2,9666784,900000,-1405981,1405981
2016-11-19,18,19,18,18,6865186,478,1,6365186,500000,240,7,5261280,1603906,1103906,-1103906
2016-11-21,18,19,18,18,5627167,402,7,3654827,2303427,219,7,3656712,2301542,-1885,1885
2016-11-22,18,18,18,18,12354609,595,6,9957363,2397246,281,4,8636388,3718221,1320975,-1320975
2016-11-23,18,18,18,18,6455549,450,3,5403897,1051652,228,2,5910955,544594,-507058,507058
2016-11-26,18,18,17,17,15599427,883,10,12165151,3434276,335,4,14100933,1498494,-1935782,1935782
2016-11-27,18,18,17,18,12287150,747,8,9260011,3027139,249,4,10478816,1808334,-1218805,1218805
2016-11-29,18,18,17,17,24013025,1297,9,20969939,3043086,351,8,20121359,3891666,848580,-848580
2016-12-03,17,17,16,16,30716044,1099,19,16966044,13750000,283,4,27215044,3501000,-10249000,10249000
2016-12-04,16,16,16,16,23532014,1024,16,18621289,4910725,522,22,15213185,8318829,3408104,-3408104
2016-12-05,16,17,16,16,14493885,660,5,13414332,1079553,315,5,12643685,1850200,770647,-770647
2016-12-06,16,16,16,16,25986818,761,9,16942318,9044500,334,13,19951079,6035739,-3008761,3008761
2016-12-07,16,17,16,17,47896225,564,15,25824225,22072000,868,22,33372632,14523593,-7548407,7548407
2016-12-10,17,17,16,17,20622467,577,8,11758533,8863934,487,6,12071834,8550633,-313301,313301
2016-12-11,17,17,16,16,14572373,488,6,9067885,5504488,294,3,9817373,4755000,-749488,749488
2016-12-12,16,17,16,16,21907965,960,12,15197608,6803763,321,6,16860082,5141289,-1662474,1662474
2016-12-13,16,17,16,16,29273001,349,7,15065001,14208000,636,8,23889291,5383710,-8824290,8824290
2016-12-14,16,17,16,17,54319222,793,20,26366235,27952987,1344,15,40455442,13863780,-14089207,14089207
2016-12-18,17,17,17,17,15043922,341,10,7250305,7793617,428,11,9336879,5707043,-2086574,2086574
2016-12-19,17,17,17,17,15437998,459,6,8381523,7056475,276,3,9530925,5907073,-1149402,1149402
2016-12-20,17,17,16,16,17455596,399,9,5909821,11545775,268,5,10663758,6791838,-4753937,4753937
2016-12-21,16,17,16,17,5965472,215,5,4962472,1003000,234,5,5544364,421108,-581892,581892
2016-12-24,17,17,16,17,10258652,358,7,5825220,4433432,265,3,8950552,1308100,-3125332,3125332
2016-12-25,17,17,16,17,6253000,239,4,3738000,2515000,236,5,4499642,1753358,-761642,761642
2016-12-26,16,17,16,16,11115522,316,5,8985266,2130256,206,4,6134050,4981472,2851216,-2851216
2016-12-27,16,16,16,16,13683513,417,7,5991026,7692487,237,1,12183513,1500000,-6192487,6192487
2016-12-28,16,16,16,16,9166895,239,4,5026895,4140000,227,4,5557817,3609078,-530922,530922
2016-12-31,16,17,16,16,15041834,248,7,9126834,5915000,478,6,8864563,6177271,262271,-262271
2017-01-01,17,17,16,16,15961903,429,9,8172903,7789000,193,1,11262685,4699218,-3089782,3089782
2017-01-02,16,16,16,16,15684042,441,6,14996042,688000,326,11,9291922,6392120,5704120,-5704120
2017-01-03,16,16,16,16,7093262,337,2,6193262,900000,276,2,6743262,350000,-550000,550000
2017-01-04,16,16,16,16,10722350,343,2,10257489,1000000,171,1,11207489,50000,-950000,950000
2017-01-07,16,16,15,15,22080517,616,12,13285790,8794727,373,5,20957986,1122531,-7672196,7672196
2017-01-08,15,16,15,16,14551143,297,5,7591115,6960028,460,5,7849344,6701799,-258229,258229
2017-01-09,16,16,15,15,13598351,564,5,7146223,6452128,282,3,7880522,5717829,-734299,734299
2017-01-11,15,15,15,15,21109921,265,8,4921836,16188085,594,4,15631939,5477982,-10710103,10710103
2017-01-14,16,16,16,16,25575793,348,10,19495793,6080000,346,4,4975792,20600001,14520001,-14520001
2017-01-15,17,17,16,17,32961297,516,9,20974004,11987293,932,10,23553593,9407704,-2579589,2579589
2017-01-16,17,17,16,17,26548453,381,9,10813010,15735443,731,4,19734031,6814422,-8921021,8921021
2017-01-17,17,17,17,17,33456240,545,11,22223615,11232625,764,5,27261868,6194372,-5038253,5038253
2017-01-18,17,18,17,17,34168209,632,14,22266759,11901450,903,10,27261761,6906448,-4995002,4995002
2017-01-21,18,18,17,17,18094286,603,8,10956281,7138005,415,8,14339872,3754414,-3383591,3383591
2017-01-22,17,17,17,17,14133707,386,11,7460421,6673286,311,4,9399523,4734184,-1939102,1939102
2017-01-23,17,17,16,16,12285214,311,5,8380214,3905000,270,4,8816973,3468241,-436759,436759
2017-01-24,17,17,17,17,13873376,277,5,8043376,5830000,373,6,5013098,8860278,3030278,-3030278
2017-01-25,17,17,17,17,13512790,231,6,5437807,8074983,253,3,8786222,4726568,-3348415,3348415
2017-01-28,17,17,16,16,12229736,389,6,5682736,6547000,211,5,6964652,5265084,-1281916,1281916
2017-01-29,17,17,16,17,17723949,467,7,9348949,8375000,256,5,12266768,5457181,-2917819,2917819
2017-01-30,17,18,17,18,27763384,476,9,21979884,5783500,748,13,15979954,11783430,5999930,-5999930
2017-01-31,18,18,17,17,38643001,1065,12,30452344,8190657,693,15,25453770,13189231,4998574,-4998574
2017-02-01,17,18,17,17,22895973,581,10,15288757,7607216,674,10,20944973,1951000,-5656216,5656216
2017-02-04,17,17,17,17,10143813,311,9,6417505,3726308,436,5,9099037,1044776,-2681532,2681532
2017-02-05,17,17,17,17,15460118,305,6,4722230,10737888,419,7,6741940,8718178,-2019710,2019710
2017-02-06,17,17,17,17,13979460,265,6,5239707,8739753,297,7,7247989,6731471,-2008282,2008282
2017-02-07,17,18,17,17,16174483,338,13,14273703,1900780,343,6,9305204,6869279,4968499,-4968499
2017-02-08,17,17,16,17,19181033,642,10,11538638,7642395,206,3,19011104,169929,-7472466,7472466
2017-02-11,17,17,16,16,9210123,421,4,6682591,2527532,231,1,8210123,1000000,-1527532,1527532
2017-02-12,16,17,16,17,11413546,346,6,4236446,7177100,246,1,10413546,1000000,-6177100,6177100
2017-02-13,16,17,16,16,9465537,344,4,7032518,2433019,197,2,7525537,1940000,-493019,493019
2017-02-14,17,17,16,16,11404785,303,10,3115939,8436079,217,9,5380018,6172000,-2264079,2264079
2017-02-15,17,17,16,16,6889935,252,4,4994935,1895000,205,9,5908735,981200,-913800,913800
2017-02-18,16,17,16,17,10850524,287,7,8764524,2086000,343,9,7476050,3374474,1288474,-1288474
2017-03-13,16,16,16,16,22909634,620,11,12301684,10607950,321,15,13105096,9804538,-803412,803412
2017-03-14,16,16,15,16,21822316,601,8,7529130,14293186,322,5,16625316,5197000,-9096186,9096186
2017-03-15,16,16,15,15,9448627,234,6,3908627,5540000,226,7,7618766,1829861,-3710139,3710139
2017-03-18,15,16,15,15,12007202,504,5,8982824,3024378,167,4,11072714,934488,-2089890,2089890
2017-03-25,15,16,15,16,6836796,111,5,4886796,1950000,302,4,6449296,387500,-1562500,1562500
2017-03-26,16,17,16,16,6315207,236,4,3685957,2629250,249,3,5608455,706752,-1922498,1922498
2017-03-27,16,16,16,16,5435335,107,5,1549421,3885914,253,4,5008764,426571,-3459343,3459343
2017-03-28,16,16,16,16,5369728,168,5,1885935,3483793,197,3,4433383,936345,-2547448,2547448
2017-03-29,16,16,16,16,6404212,144,5,2245822,4158390,271,1,6311109,93103,-4065287,4065287
2017-04-03,16,17,16,16,4548187,146,5,2566401,1981786,229,2,4328187,220000,-1761786,1761786
2017-04-04,16,17,16,16,6617032,135,3,1918032,4699000,326,2,6507032,110000,-4589000,4589000
2017-04-05,16,17,16,16,12415878,313,8,5676175,6739703,348,4,10018671,2397207,-4342496,4342496
2017-04-08,17,17,16,17,22042688,550,9,19082688,2960000,684,7,17060688,4982000,2022000,-2022000
2017-04-09,17,18,17,17,19832042,683,6,18016453,1815589,624,11,15928218,3903824,2088235,-2088235
2017-04-10,17,18,17,17,22328376,786,4,20951452,1376924,752,7,20667787,1660589,283665,-283665
2017-04-12,17,18,17,17,20104783,662,8,14750101,5354682,517,4,19335678,769105,-4585577,4585577
2017-04-15,17,18,17,17,29986418,891,6,26905148,3081270,761,11,24717455,5268963,2187693,-2187693
2017-04-16,18,18,17,17,32468530,717,7,25199145,7269385,667,18,25949693,6518837,-750548,750548
2017-04-17,17,17,17,17,24002903,886,7,17803859,6199044,353,2,19607934,4394969,-1804075,1804075
2017-04-18,17,17,16,17,11039009,437,5,8909295,2129714,270,2,10629009,410000,-1719714,1719714
2017-04-19,17,17,16,17,12835315,478,5,10416498,2418817,259,4,11028690,1806625,-612192,612192
2017-04-22,17,17,17,17,19282663,347,3,18282663,1000000,511,8,13722873,5559790,4559790,-4559790
2017-04-23,18,18,17,17,18222480,577,4,16472480,1750000,490,4,14838327,3384153,1634153,-1634153
2017-04-24,17,17,17,17,10182510,458,1,9982510,200000,299,2,8562163,1620347,1420347,-1420347
2017-04-26,17,17,17,17,12461189,579,6,11590529,870660,271,4,8945288,3515901,2645241,-2645241
2017-04-29,17,17,16,16,13183575,571,5,11710500,1473075,286,2,13150800,32775,-1440300,1440300
2017-04-30,17,17,17,17,15349022,391,6,13747021,1602001,314,8,9153764,6195258,4593257,-4593257
2017-05-01,17,17,16,17,17053970,332,8,8456290,8597680,268,2,11953970,5100000,-3497680,3497680
2017-05-02,17,17,17,17,10529538,332,4,9669538,860000,288,1,10487689,41849,-818151,818151
2017-05-03,17,17,16,16,7549010,299,2,5949010,1600000,233,5,6684617,864393,-735607,735607
2017-05-06,17,17,16,16,13654050,544,6,7322763,6331287,231,0,13654050,0,-6331287,6331287
2017-05-07,16,17,16,16,11287783,542,7,8018632,3269151,292,5,10678722,609061,-2660090,2660090
2017-05-08,16,16,16,16,12432605,408,10,8634406,4125658,190,2,10443240,2316824,-1808834,1808834
2017-05-09,16,17,16,17,15447423,301,5,5971720,9475703,426,7,11726865,3720558,-5755145,5755145
2017-05-10,17,17,16,17,18779040,511,7,12517039,6262001,374,9,10845014,7934026,1672025,-1672025
2017-05-13,17,17,16,16,9197364,221,4,3398734,5798630,216,4,5938748,3258616,-2540014,2540014
2017-05-14,16,17,16,17,16017807,214,5,3213707,12804100,329,5,11676682,4341125,-8462975,8462975
2017-05-15,17,17,16,16,6200228,92,4,1348135,4852093,235,4,6056914,143314,-4708779,4708779
2017-05-16,17,17,16,16,8634274,171,3,4819238,3815036,275,3,7156338,1477936,-2337100,2337100
2017-05-17,17,17,16,17,14583204,253,6,10759168,3824036,363,3,14227778,355426,-3468610,3468610
2017-05-20,17,17,17,17,27257244,490,10,19417244,7840000,687,17,20616236,6641008,-1198992,1198992
2017-05-21,17,17,17,17,13375497,360,6,10745497,2630000,409,5,11594256,1781241,-848759,848759
2017-05-22,17,17,16,16,7038702,252,9,3592961,3445741,229,1,5441139,1597563,-1848178,1848178
2017-05-23,17,17,16,17,6470936,165,7,1936908,4534028,202,5,6301857,169079,-4364949,4364949
2017-05-24,16,17,16,17,6533187,139,6,2148319,4384868,304,2,6403187,130000,-4254868,4254868
2017-05-27,17,17,16,16,6302382,275,6,3381162,2921220,187,1,5796149,506233,-2414987,2414987
2017-05-28,16,16,16,16,7616019,433,6,5032387,2583632,219,1,7377779,238240,-2345392,2345392
2017-05-29,16,16,16,16,7582335,229,7,3723054,3859281,221,0,7582335,0,-3859281,3859281
2017-05-30,16,16,16,16,8682688,311,5,4689893,3992795,235,4,6642187,2040501,-1952294,1952294
2017-05-31,16,16,16,16,8215815,392,4,6140402,2075413,166,4,5665815,2550000,474587,-474587
2017-06-13,16,16,16,16,9212381,153,3,2063490,7148891,134,1,7271852,1940529,-5208362,5208362
2017-06-14,16,16,16,16,8036917,333,8,6588678,1448239,250,1,7813917,223000,-1225239,1225239
2017-06-17,16,16,15,16,8333928,307,3,3981953,4351975,247,5,6177898,2156030,-2195945,2195945
2017-06-18,16,16,15,16,8363600,122,5,3166371,5197229,292,3,8159600,204000,-4993229,4993229
2017-06-19,16,16,15,16,4548623,109,3,1868603,2680020,200,3,4248623,300000,-2380020,2380020
2017-06-20,15,16,15,16,5377086,162,4,2010877,3366209,193,2,4962086,415000,-2951209,2951209
2017-06-21,15,16,15,16,4308929,147,4,2291789,2017140,181,1,3708929,600000,-1417140,1417140
2017-06-24,16,16,16,16,6651784,228,4,5099942,1551842,216,1,5474784,1177000,-374842,374842
2017-06-25,16,16,15,15,8413389,310,4,5140079,3283310,116,4,5233389,3190000,-93310,93310
2017-06-28,16,16,15,15,4697350,270,2,2898987,1798363,170,0,4697350,0,-1798363,1798363
2017-07-01,15,16,15,16,8093757,180,4,5083584,3010173,180,6,3916155,4177602,1167429,-1167429
2017-07-02,15,16,15,15,4231213,162,5,2002087,2229126,187,3,3625838,605375,-1623751,1623751
2017-07-03,15,15,15,15,16338433,274,8,4271642,12066791,179,6,5289023,11049410,-1017381,1017381
2017-07-04,15,16,15,15,7561699,164,6,1973651,5588048,227,1,7461699,100000,-5488048,5488048
2017-07-05,16,16,15,15,7488639,313,9,3781068,3707571,150,5,6495728,992911,-2714660,2714660
2017-07-08,15,15,15,15,7510326,204,6,3499360,4010966,232,0,7510326,0,-4010966,4010966
2017-07-09,15,16,15,16,12458440,313,7,7621793,4836647,298,5,7904543,4553897,-282750,282750
2017-07-10,16,16,15,16,15307871,331,11,8143917,7163954,458,6,12250297,3057574,-4106380,4106380
2017-07-11,16,16,16,16,6908033,149,8,1369688,5538345,267,3,6658993,249040,-5289305,5289305
2017-07-12,16,16,16,16,4955733,117,7,1427370,3528363,172,3,4168256,787477,-2740886,2740886
2017-07-15,16,16,15,15,7545689,243,7,3102607,4443082,208,2,6295687,1250002,-3193080,3193080
2017-07-16,15,15,15,15,7655664,260,7,3348385,4307279,213,4,5300410,2355254,-1952025,1952025
2017-07-17,15,16,15,16,26095164,119,9,1512620,24582544,574,12,14264334,11830830,-12751714,12751714
2017-07-18,16,16,15,16,29264489,311,10,6207667,23056822,755,21,18337363,10927126,-12129696,12129696
2017-07-25,16,16,16,16,6992771,83,2,992771,6000000,102,9,4238972,2753799,-3246201,3246201
2017-07-26,16,16,15,15,15853336,754,8,12761457,3091879,252,8,12665253,3188083,96204,-96204
2017-07-29,15,15,15,15,5291936,331,6,3041370,2250566,173,2,5154936,137000,-2113566,2113566
2017-07-30,15,15,15,15,5749973,287,6,3174187,2575786,169,2,4749973,1000000,-1575786,1575786
2017-07-31,15,15,15,15,6980457,309,7,3523173,3457284,167,6,6415204,565253,-2892031,2892031
2017-08-01,15,15,15,15,4474127,170,5,1492452,2981675,163,4,4041135,432992,-2548683,2548683
2017-08-02,15,15,15,15,6916858,214,6,2210319,4706539,148,4,2657678,4259180,-447359,447359
2017-08-06,15,16,15,15,8223327,360,11,5971971,2251356,290,8,5782243,2441084,189728,-189728
2017-08-07,15,15,15,15,8153611,238,3,3255553,4898058,233,4,7069561,1084050,-3814008,3814008
2017-08-08,15,15,15,15,5816397,243,6,4207288,1660674,152,4,4353068,1514894,-145780,145780
2017-08-09,15,15,15,15,8128912,392,6,5895912,2233000,256,3,7773584,355328,-1877672,1877672
2017-08-12,15,15,15,15,6070093,389,7,4120093,1950000,194,1,5970093,100000,-1850000,1850000
2017-08-13,15,15,15,15,5211333,198,6,2736133,2475200,167,3,4009510,1201823,-1273377,1273377
2017-08-14,15,15,14,14,4682683,263,6,3256618,1466300,173,2,4555918,167000,-1299300,1299300
2017-08-15,14,15,14,15,6068873,198,6,3153707,2915166,170,4,5265873,803000,-2112166,2112166
2017-08-16,14,15,14,15,20199327,322,8,7654167,12545160,311,6,13997327,6202000,-6343160,6343160
2017-08-19,15,15,14,15,5039647,206,2,2711635,2328012,164,6,4231746,807901,-1520111,1520111
2017-08-20,15,15,14,15,5378330,174,5,1541624,3836706,205,3,4843022,535308,-3301398,3301398
2017-08-21,15,15,14,15,5009046,147,6,1221490,3787556,178,3,3978046,1031000,-2756556,2756556
2017-08-22,15,15,14,15,5863786,167,7,1674996,4188790,198,4,5340064,523722,-3665068,3665068
2017-08-23,15,15,14,15,3508473,154,5,2508727,999746,106,4,3205944,302529,-697217,697217
2017-08-26,15,15,14,14,7973645,218,7,2485736,5487909,154,7,4417917,3555728,-1932181,1932181
2017-08-27,14,15,14,14,7045146,212,5,4123556,2921590,188,3,6345146,700000,-2221590,2221590
2017-08-28,14,15,14,15,3534219,172,3,2456101,1078118,146,3,2775443,758776,-319342,319342
2017-08-30,14,15,14,14,6207877,177,8,2847885,3359992,159,3,5497217,710660,-2649332,2649332
2017-09-02,15,15,14,14,2142751,128,4,2040313,102438,137,1,2131080,11671,-90767,90767
2017-09-03,15,15,14,14,6285818,178,4,3507425,2778393,311,4,6094818,191000,-2587393,2587393
2017-09-04,14,14,14,14,5138520,158,5,2058520,3080000,174,2,5028520,110000,-2970000,2970000
2017-09-05,14,15,14,14,3247262,147,2,2382262,865000,135,5,2389639,857623,-7377,7377
2017-09-06,14,14,14,14,5410281,154,6,1646145,3764136,150,3,5010181,400100,-3364036,3364036
2017-09-10,14,14,14,14,8422171,360,4,4416841,4005330,196,2,8071338,350833,-3654497,3654497
2017-09-11,14,14,14,14,7613882,116,5,1193399,6420483,228,3,6764715,849167,-5571316,5571316
2017-09-12,14,14,14,14,4474063,126,4,1515368,2958695,358,3,4198867,275196,-2683499,2683499
2017-09-13,14,15,14,14,5404717,175,3,4516955,887762,375,3,5270844,133873,-753889,753889
2017-09-16,14,15,14,14,4158857,109,2,3215851,943006,183,2,4056857,102000,-841006,841006
2017-09-17,14,15,14,15,5364413,66,4,2006898,3357515,209,5,5096213,268200,-3089315,3089315
2017-09-18,15,15,14,15,3654494,67,6,1085391,2569103,181,1,3632099,22395,-2546708,2546708
2017-09-19,15,15,15,15,6274568,120,7,2411189,3863379,305,8,5181511,1093057,-2770322,2770322
2017-09-20,15,16,15,16,29869752,175,6,27603466,2266286,532,10,11073461,18796291,16530005,-16530005
2017-09-23,16,16,16,16,21375942,460,6,19929861,1446081,728,8,14956650,6419292,4973211,-4973211
2017-09-24,16,16,16,16,13509414,395,8,10798434,2710980,545,7,11417016,2092398,-618582,618582
2017-09-25,16,16,16,16,4758908,197,3,3357908,1401000,215,2,4619916,138992,-1262008,1262008
2017-09-26,16,16,16,16,5170591,213,2,4203351,967240,203,2,3559470,1611121,643881,-643881
2017-09-27,16,16,16,16,3690354,143,4,2380054,1310300,190,1,3497313,193041,-1117259,1117259
2017-10-02,16,16,15,15,8222229,267,6,4809229,3413000,209,0,8222229,0,-3413000,3413000
2017-10-03,15,15,15,15,6869951,214,8,3031648,3838303,251,2,6669547,200404,-3637899,3637899
2017-10-04,15,15,15,15,4654255,107,7,2024177,2630078,216,0,4654255,0,-2630078,2630078
2017-10-07,15,15,15,15,13489639,219,7,7474573,6015066,312,1,13289639,200000,-5815066,5815066
2017-10-08,15,15,14,15,12292687,202,9,7692116,4630918,349,2,12123034,200000,-4430918,4430918
2017-10-09,15,15,14,15,5554626,120,4,1662451,3892175,224,3,4765626,789000,-3103175,3103175
2017-10-10,15,15,14,15,4253868,88,5,1174246,3079622,159,3,3751148,502720,-2576902,2576902
2017-10-11,15,15,14,14,7262355,94,5,2447360,4814995,160,3,6559807,702548,-4112447,4112447
2017-10-14,15,15,15,15,5381172,118,3,5111172,270000,201,2,4831172,550000,280000,-280000
2017-10-15,15,15,15,15,8583878,67,3,1446216,7137662,166,5,7125292,1458586,-5679076,5679076
2017-10-16,15,15,15,15,9637254,76,5,2537823,7099431,263,4,8511697,1125557,-5973874,5973874
2017-10-17,15,15,15,15,3164340,70,5,930161,2234179,210,1,2954340,210000,-2024179,2024179
2017-10-18,15,15,15,15,4447119,64,4,1097776,3349343,423,3,4227472,219647,-3129696,3129696
2017-10-21,15,15,15,15,4765525,181,5,1976294,2789231,159,7,4051240,714285,-2074946,2074946
2017-10-22,15,15,14,15,2237243,103,4,1223436,1013807,107,1,2200173,37070,-976737,976737
2017-10-23,15,15,14,14,7542994,188,5,1926988,5616006,189,1,7512994,30000,-5586006,5586006
2017-10-24,14,14,14,14,5946711,201,4,2855929,3090782,162,6,5231711,715000,-2375782,2375782
2017-10-25,14,14,14,14,6832280,252,4,2602131,4230149,163,5,6446580,385700,-3844449,3844449
2017-10-28,14,14,14,14,3616817,182,5,1596712,2020105,127,5,3023817,593000,-1427105,1427105
2017-10-29,14,15,14,15,15455281,144,3,7407617,8047664,300,9,8726281,6729000,-1318664,1318664
2017-10-30,15,15,15,15,6341003,166,2,6200987,140016,333,7,5499652,841351,701335,-701335
2017-10-31,15,16,15,16,31796615,260,4,26845160,4951455,589,15,8459157,23337458,18386003,-18386003
2017-11-01,16,16,15,16,20219456,328,4,10832566,9386890,590,7,17607838,2611618,-6775272,6775272
2017-11-04,15,16,15,15,6300087,148,4,2010267,4289820,250,6,4005128,2294959,-1994861,1994861
2017-11-05,16,16,15,16,69926932,404,9,67389145,3002000,974,15,27917896,42473249,39471249,-39471249
2017-11-06,16,17,16,16,16107730,551,5,12966100,3141630,431,11,13524923,2582807,-558823,558823
2017-11-07,16,16,16,16,12785677,273,4,7742434,5043243,330,4,9647677,3138000,-1905243,1905243
2017-11-08,16,16,16,16,6518470,222,6,4854605,1663865,228,5,5130601,1387869,-275996,275996
2017-11-11,16,16,16,16,4773702,88,4,1638576,3135126,207,3,4405075,368627,-2766499,2766499
2017-11-12,16,16,16,16,12147787,92,3,1636886,10510901,198,5,10890364,1257423,-9253478,9253478
2017-11-13,16,16,16,16,6104418,102,6,3541248,2679496,252,2,5840750,379994,-2299502,2299502
2017-11-14,16,16,16,16,6285978,157,4,4217295,2068683,195,2,5585978,700000,-1368683,1368683
2017-11-15,16,16,16,16,4504699,69,4,734988,3769711,158,1,4494699,10000,-3759711,3759711
2017-11-18,16,16,16,16,7266246,78,3,1082167,6184079,132,4,6948246,318000,-5866079,5866079
2017-11-20,15,16,15,15,6788820,88,2,4014475,2774345,170,2,6088820,700000,-2074345,2074345
2017-11-21,15,16,15,15,6853826,94,1,3657532,3404455,185,7,5367219,1694768,-1709687,1709687
2017-11-22,15,16,15,15,5509947,115,2,3400632,2109315,169,5,5039241,470706,-1638609,1638609
2017-11-25,16,16,15,15,3370329,140,2,2799460,570869,175,3,3246675,123654,-447215,447215
2017-11-26,16,16,15,16,5448033,110,3,3923032,1525001,205,4,3154665,2293368,768367,-768367
2017-11-28,16,16,15,15,4442111,125,2,2536916,1905195,124,2,3329564,1112547,-792648,792648
2017-11-29,15,16,15,15,5418266,118,3,2761507,2656759,135,3,4706457,711809,-1944950,1944950
2017-12-02,15,16,15,15,7696602,101,7,4122634,3573968,161,3,6732125,964477,-2609491,2609491
2017-12-03,16,16,15,16,5850804,129,4,3272889,2577915,266,4,4996243,854561,-1723354,1723354
2017-12-04,16,16,16,16,8227753,104,10,4664155,3563598,326,2,6146887,2080866,-1482732,1482732
2017-12-05,16,17,16,16,18254877,343,7,16558348,1771639,606,8,11815384,6514603,4742964,-4742964
2017-12-09,17,17,16,17,16476070,440,8,14907128,1568942,529,9,10500495,5975575,4406633,-4406633
2017-12-10,17,17,16,17,14760356,296,9,6898480,7861876,330,4,13645356,1115000,-6746876,6746876
2017-12-11,17,17,17,17,52181496,457,9,33795432,18386064,760,20,15604444,36577052,18190988,-18190988
2017-12-12,18,18,18,18,54144244,1065,27,41831047,12313197,1035,18,32393983,21750261,9437064,-9437064
2017-12-13,17,18,17,17,23400462,523,14,18390184,5010278,597,5,19936791,3463671,-1546607,1546607
2017-12-16,18,18,17,17,15611859,342,11,10592377,5019482,299,5,11117053,4494806,-524676,524676
2017-12-17,17,18,17,17,23647583,470,11,16765586,6881997,404,6,13483322,10164261,3282264,-3282264
2017-12-18,17,18,17,18,78279051,1075,22,64106828,14172223,1014,22,33219691,45059360,30887137,-30887137
2017-12-19,19,19,19,19,33016590,773,9,30110090,2906500,831,17,26567590,6449000,3542500,-3542500
2017-12-20,18,19,18,18,47436996,586,3,20218498,3500000,553,12,16183809,7534689,4034689,-4034689
2017-12-23,18,19,18,19,16585153,560,7,13801153,2784000,575,7,14641685,1943468,-840532,840532
2017-12-24,19,19,19,19,16722700,458,9,14412684,2310016,560,12,10830989,5891711,3581695,-3581695
2017-12-25,19,19,18,18,44608083,282,7,8121978,2016690,205,10,7488429,2650239,633549,-633549
2017-12-26,18,19,17,18,38335770,1014,20,24787008,13717767,482,6,16702924,21801851,8084084,-8084084
2017-12-27,17,18,17,17,15413413,638,7,13484640,1928773,444,3,14065428,1347985,-580788,580788
2017-12-30,17,17,16,17,23144442,561,13,13288602,10286101,502,1,22174703,1400000,-8886101,8886101
2017-12-31,16,16,16,16,41131753,508,16,9977946,31165907,858,6,36647214,4496639,-26669268,26669268
2018-01-01,16,17,16,16,12918946,466,4,12387246,531700,255,6,10379673,2539273,2007573,-2007573
2018-01-02,17,17,16,16,11366788,198,6,3565648,7801140,257,1,11066788,300000,-7501140,7501140
2018-01-03,16,16,16,16,21585880,198,5,3556195,7236745,294,2,10740440,52500,-7184245,7184245
2018-01-06,16,17,16,16,5420539,201,2,5100539,320000,183,1,5408189,12350,-307650,307650
2018-01-07,16,17,16,17,5481197,160,2,3141456,2339741,211,2,4943547,537650,-1802091,1802091
2018-01-08,17,17,16,16,5241334,129,3,2342209,2899125,162,2,4496334,745000,-2154125,2154125
2018-01-09,16,17,16,16,6561940,228,10,4102930,2459010,158,3,5572030,989910,-1469100,1469100
2018-01-10,16,17,16,17,28778771,357,7,26779304,1999467,624,17,18967491,9811280,7811813,-7811813
2018-01-13,17,17,17,17,18614330,378,2,15314330,3300000,369,7,13604330,5010000,1710000,-1710000
2018-01-14,17,18,17,17,11314438,210,3,7851711,3462727,335,6,7707040,3607398,144671,-144671
2018-01-15,17,17,17,17,9853690,180,6,4689890,5163800,325,3,8401481,1452209,-3711591,3711591
2018-01-16,17,18,17,17,11621074,151,2,6215286,5405788,277,5,5438374,6182700,776912,-776912
2018-01-17,17,18,17,18,31553846,468,12,24426950,7126896,736,12,25629921,5923925,-1202971,1202971
2018-01-20,18,19,18,18,19984618,541,5,19933468,51150,640,12,18354612,1630006,1578856,-1578856
2018-01-21,18,18,17,17,27180558,391,6,17335524,9845034,312,14,19364837,7815721,-2029313,2029313
2018-01-22,17,18,17,17,14638601,332,14,9193240,5445361,356,8,11218840,3419761,-2025600,2025600
2018-01-23,17,18,17,17,9445942,208,3,9143238,302704,214,6,8183237,1262705,960001,-960001
2018-01-24,18,18,17,17,11232124,262,5,6802095,4430029,209,7,10447650,784474,-3645555,3645555
2018-01-27,17,18,17,18,8506983,207,9,4731631,3775352,333,8,6410228,2096755,-1678597,1678597
2018-01-28,17,18,17,17,6216474,117,5,2324401,3892073,217,5,5164966,1051508,-2840565,2840565
2018-01-29,17,17,17,17,7655015,179,4,2946530,4708485,143,7,6382181,1272834,-3435651,3435651
2018-01-30,17,18,17,17,10798407,123,5,6609320,4189087,196,11,6336262,4462145,273058,-273058
2018-01-31,17,17,16,16,40968671,1339,10,37013506,3955165,193,15,23728488,17240183,13285018,-13285018
2018-02-03,16,16,16,16,16582806,554,9,10061808,6520998,259,5,8630086,7952720,1431722,-1431722
2018-02-04,16,16,16,16,10832922,380,6,8687058,2145864,184,5,3584545,7248377,5102513,-5102513
2018-02-05,16,17,16,16,11175322,394,4,10625322,550000,417,7,9384291,1791031,1241031,-1241031
2018-02-06,17,17,16,16,7690682,171,3,2357958,5332724,327,2,7199424,491258,-4841466,4841466
2018-02-07,17,17,16,16,2354823,422,8,9627242,2025000,259,11,6313481,5338761,3313761,-3313761
2018-02-10,17,17,16,17,3913230,75,4,1173230,2740000,128,1,3413230,500000,-2240000,2240000
2018-02-12,17,17,17,17,12488298,312,3,8428298,4060000,392,4,8302896,4185402,125402,-125402
2018-02-13,17,17,17,17,8168381,166,4,3730971,4437410,255,2,6002863,2165518,-2271892,2271892
2018-02-14,17,17,16,17,5023708,128,4,2533614,2490094,202,5,3956134,1067574,-1422520,1422520
2018-02-17,17,18,17,17,35903625,623,12,22820159,13083466,611,13,27204884,8698741,-4384725,4384725
2018-02-18,17,17,17,17,5843104,163,3,2341449,3501655,169,2,5641104,202000,-3299655,3299655
2018-02-19,17,17,16,16,8506557,284,5,3787557,4719000,173,2,6339232,2167325,-2551675,2551675
2018-02-21,16,17,16,17,7412865,186,4,4051683,3361182,247,4,7153420,259445,-3101737,3101737
2018-02-24,17,17,17,17,3643255,155,2,2143255,1500000,96,4,3492006,151249,-1348751,1348751
2018-02-25,16,17,16,16,4649313,201,4,2691831,1957482,188,1,4647313,2000,-1955482,1955482
2018-02-26,16,17,16,16,6820597,228,4,2845783,3974814,192,1,6819597,1000,-3973814,3973814
2018-02-27,17,17,16,16,7903983,250,4,3149412,4754571,166,1,7716295,187688,-4566883,4566883
2018-02-28,16,17,16,16,8376220,333,4,6913290,1462930,258,4,6738726,1637494,174564,-174564
2018-03-03,17,17,16,16,9430266,333,4,8632397,797869,246,1,7830266,1600000,802131,-802131
2018-03-04,17,17,16,17,7408392,200,6,4563388,2845004,286,4,6733956,674436,-2170568,2170568
2018-03-05,16,17,16,16,13931198,427,5,7848598,6082600,244,3,7846684,6084514,1914,-1914
2018-03-10,16,16,16,16,3890488,117,5,804027,3086461,118,1,3040488,850000,-2236461,2236461
2018-03-11,15,16,15,16,14913248,279,8,6276272,8636976,297,8,10211901,4701347,-3935629,3935629
2018-03-12,15,16,15,15,7907527,179,8,2916753,4990774,203,3,4884215,3023312,-1967462,1967462
2018-03-13,15,16,15,16,32257690,203,9,1989053,30268637,419,9,22937795,9319895,-20948742,20948742
2018-03-14,16,17,16,16,7767962,180,3,2693678,5074284,259,7,5125109,2642853,-2431431,2431431
2018-03-17,16,16,16,16,2648137,167,2,2109329,538808,111,2,2138137,510000,-28808,28808
2018-03-18,16,16,16,16,4079446,97,3,2966070,1113376,156,2,3988846,90600,-1022776,1022776
2018-03-19,16,16,16,16,4484020,88,3,885155,3600000,220,4,4280405,204750,-3395250,3395250
2018-03-25,16,16,16,16,1246952,67,2,526952,720000,69,0,1246952,0,-720000,720000
2018-03-26,16,16,16,16,903637,90,1,794751,108886,62,1,903557,80,-108806,108806
2018-03-27,16,16,16,16,3231848,107,3,1810734,1421114,97,2,3190363,41485,-1379629,1379629
2018-03-28,16,16,16,16,2418665,133,3,2255665,163000,95,3,2368665,50000,-113000,113000
2018-04-03,16,16,16,16,1393221,84,2,1056341,336880,63,0,1393221,0,-336880,336880
2018-04-04,16,16,15,15,3263078,165,6,1326242,1936836,105,2,2987597,275481,-1661355,1661355
2018-04-07,15,16,15,15,5721723,124,7,1449943,4271780,189,1,5691723,30000,-4241780,4241780
2018-04-08,15,15,15,15,11427717,243,8,3005131,8422586,227,7,9943753,1483964,-6938622,6938622
2018-04-09,15,15,14,14,21643058,363,8,5028038,16615020,317,8,18796287,2846771,-13768249,13768249
2018-04-10,15,15,15,15,5178079,207,4,3371579,1806500,207,7,4579901,598178,-1208322,1208322
2018-04-11,15,15,14,15,22251909,286,6,6348909,15903000,337,5,19898117,2353792,-13549208,13549208
2018-04-15,15,15,14,14,4393935,167,4,3174630,1219305,150,1,4383935,10000,-1209305,1209305
2018-04-16,14,15,14,14,6136450,103,1,2511649,3624801,174,3,5630642,505808,-3118993,3118993
2018-04-17,15,15,14,15,2380399,74,3,630408,1749991,96,1,1889377,491022,-1258969,1258969
2018-04-18,15,15,14,15,3498115,114,3,1105344,2392771,127,2,1770167,1727948,-664823,664823
2018-04-21,15,15,14,15,4787366,109,1,1527366,3260000,165,2,4667366,120000,-3140000,3140000
2018-04-22,15,15,14,14,2671680,68,2,1133976,1537704,100,1,2471680,200000,-1337704,1337704
2018-04-23,14,15,14,15,5558815,61,4,3068733,2490082,174,0,5558815,0,-2490082,2490082
2018-04-24,15,15,14,15,12900809,140,4,4984809,7916000,171,7,4877440,8023369,107369,-107369
2018-04-25,15,15,15,15,1279459,50,3,501962,777497,100,0,1279459,0,-777497,777497
2018-04-28,15,15,14,14,5648399,62,5,714329,4934070,160,0,5648399,0,-4934070,4934070
2018-04-29,14,15,14,15,3745524,34,6,191156,3554368,219,0,3745524,0,-3554368,3554368
2018-04-30,15,15,15,15,2515478,29,7,464418,2051060,108,1,2515475,3,-2051057,2051057
2018-05-01,15,15,14,15,2555059,36,6,328925,2226134,104,1,2505059,50000,-2176134,2176134
2018-05-05,15,15,14,14,8516016,68,4,943949,7572067,131,1,6204584,2311432,-5260635,5260635
2018-05-06,14,15,14,14,4317388,116,5,1111453,3205935,152,2,3671180,646208,-2559727,2559727
2018-05-07,14,14,14,14,4230434,106,5,1811566,2418868,142,1,4130434,100000,-2318868,2318868
2018-05-08,15,15,14,14,4293083,172,3,3319392,973691,142,6,2981274,1311809,338118,-338118
2018-05-09,15,15,14,14,34682691,81,5,2604695,32077996,400,7,28876970,5805721,-26272275,26272275
2018-05-12,14,15,14,14,7292500,51,5,723300,6569200,158,3,5893033,1399467,-5169733,5169733
2018-05-13,14,15,14,15,15307746,341,7,12216354,3091392,224,5,13867746,1440000,-1651392,1651392
2018-05-14,15,15,15,15,33873066,559,4,32583538,1289528,319,10,13344550,20528516,19238988,-19238988
2018-05-15,15,16,15,15,15797770,323,3,7165258,8632512,420,4,15371246,426524,-8205988,8205988
2018-05-16,15,15,15,15,6202064,162,6,3495363,2706701,246,2,6116063,86001,-2620700,2620700
2018-05-19,15,15,15,15,11488131,358,5,10832131,656000,192,1,11317231,170900,-485100,485100
2018-05-20,15,15,14,14,5238864,329,3,4957656,281208,135,1,4958864,280000,-1208,1208
2018-05-21,14,15,14,14,11923776,290,4,4111013,7812763,207,3,10144177,1779599,-6033164,6033164
2018-05-22,14,15,14,14,8516503,182,5,2126257,6390246,190,2,8010503,506000,-5884246,5884246
2018-05-23,14,15,14,14,7531198,200,9,3685921,3845277,187,3,6153458,1377740,-2467537,2467537
2018-05-26,15,15,14,14,5273607,170,5,2508882,2764725,207,2,5090107,183500,-2581225,2581225
2018-05-27,14,15,14,14,6847031,103,6,1288844,5558187,242,4,5815928,1031103,-4527084,4527084
2018-05-28,14,15,14,14,4149900,93,3,1556376,2593524,160,3,3178064,971836,-1621688,1621688
2018-05-29,14,15,14,14,4914621,105,3,1254903,3659718,157,3,4121076,793545,-2866173,2866173
2018-05-30,14,15,14,14,4760549,85,3,1247345,3513204,133,5,2276096,2484453,-1028751,1028751
2018-06-02,14,14,14,14,3129762,0,0,0,0,0,0,0,0,0,0
2018-06-03,14,14,14,14,4347268,102,4,2550810,1796458,305,3,3552268,795000,-1001458,1001458
2018-06-10,14,14,13,14,12714888,269,8,3400149,9350737,275,7,11699013,1051873,-8298864,8298864
2018-06-11,14,14,13,14,6730798,263,4,3562608,3168190,240,3,6519308,211490,-2956700,2956700
2018-06-12,14,14,13,14,4419316,156,6,2837037,1582279,164,6,3618251,801065,-781214,781214
2018-06-13,14,14,14,14,13089334,450,1,12089334,1000000,316,10,9570566,3518768,2518768,-2518768
2018-06-17,15,15,15,15,25337395,537,1,24337395,1000000,333,9,9170284,16167111,15167111,-15167111
2018-06-18,15,15,14,14,14816955,604,3,13766870,1050085,410,7,11827083,2989872,1939787,-1939787
2018-06-19,14,15,14,14,16876900,578,5,12926899,3950001,297,9,13274398,3602502,-347499,347499
2018-06-20,14,15,14,15,26311761,646,11,20542734,5769027,405,12,18625580,7686181,1917154,-1917154
2018-06-23,15,15,15,15,27345543,590,1,26845543,500000,437,8,15298662,12046881,11546881,-11546881
2018-06-24,16,16,15,15,23614646,816,4,22582932,1030983,603,11,20158458,3455457,2424474,-2424474
2018-06-25,15,15,14,14,26438559,831,6,24371959,2066600,507,13,24562705,1875854,-190746,190746
2018-06-26,14,15,14,14,16322252,639,3,13392252,2930000,293,5,13274077,3048175,118175,-118175
2018-06-27,14,14,13,14,11809285,430,6,6795384,5013901,306,2,11494996,314289,-4699612,4699612
2018-06-30,14,14,14,14,7894764,0,0,0,0,0,0,0,0,0,0
2018-07-01,14,14,14,14,11002355,209,6,4228926,6773429,238,4,9193626,1808729,-4964700,4964700
2018-07-02,14,14,14,14,4147519,180,4,2014080,2133439,177,1,4047519,100000,-2033439,2033439
2018-07-03,14,14,14,14,5644147,244,7,3856466,1787681,187,2,5030918,613229,-1174452,1174452
2018-07-04,14,14,14,14,14699167,408,7,12637754,2058880,622,6,12381630,2315004,256124,-256124
2018-07-07,14,15,14,14,6453537,187,1,4628316,1825221,296,3,6220509,233028,-1592193,1592193
2018-07-08,14,14,14,14,4542261,149,3,3462366,1079895,194,1,4342261,200000,-879895,879895
2018-07-10,14,14,14,14,7972038,95,5,1252038,6720000,346,3,7120327,851711,-5868289,5868289
2018-07-11,14,14,14,14,12402369,158,6,2384901,10017468,756,3,12269765,132604,-9884864,9884864
2018-07-14,14,14,14,14,7452659,244,4,5047428,2405231,268,5,5539991,1912668,-492563,492563
2018-07-15,14,14,14,14,7372505,346,2,7132505,240000,189,3,5756952,1615553,1375553,-1375553
2018-07-16,14,14,14,14,3966083,265,3,3765883,200200,230,1,3936083,30000,-170200,170200
2018-07-17,14,14,13,13,5963092,346,2,4763092,1200000,171,2,5232020,731072,-468928,468928
2018-07-18,13,14,13,13,16552523,688,6,12002523,4550000,352,3,10609363,5943160,1393160,-1393160
2018-07-23,14,14,13,13,4116670,0,0,0,0,0,0,0,0,0,0
2018-07-24,13,14,13,13,9829216,383,4,5544914,4284302,272,2,9468263,360953,-3923349,3923349
2018-07-25,13,13,12,13,11848278,425,8,7178774,4669504,261,4,10216613,1631665,-3037839,3037839
2018-07-28,13,13,12,12,27983744,872,10,18421543,9562201,378,7,22986631,4997113,-4565088,4565088
2018-07-29,12,13,12,12,12944452,317,4,7216013,5728439,357,5,11625469,1318983,-4409456,4409456
2018-07-30,12,12,12,12,24417450,442,7,8353677,16063773,393,5,21017356,3400094,-12663679,12663679
2018-07-31,12,13,12,13,6319419,184,1,6265375,54044,259,5,4993872,1325547,1271503,-1271503
2018-08-01,13,13,12,12,12420192,348,4,6920192,5500000,408,2,12150192,270000,-5230000,5230000
2018-08-04,13,13,12,12,9945991,355,5,8125991,1820000,246,3,9570775,375216,-1444784,1444784
2018-08-05,12,12,12,12,12103469,413,4,9856760,2246709,310,2,9603469,2500000,253291,-253291
2018-08-06,12,12,12,12,20468671,359,4,9238818,11229853,500,4,19028763,1439908,-9789945,9789945
2018-08-07,12,13,12,13,24793204,369,6,15257411,9535793,528,4,15844050,8949154,-586639,586639
2018-08-08,13,13,12,13,14028370,381,5,6698370,7330000,361,2,12822219,1206151,-6123849,6123849
2018-08-11,12,13,12,13,6865720,247,2,6737941,127779,307,0,6865720,0,-127779,127779
2018-08-12,13,13,13,13,25284189,403,7,23406188,1878001,715,11,18612580,6671609,4793608,-4793608
2018-08-13,13,14,13,13,9835242,415,3,9113084,722158,290,8,9251990,583252,-138906,138906
2018-08-14,13,13,13,13,7791155,224,7,4247417,3543738,309,4,7298052,493103,-3050635,3050635
2018-08-15,13,13,13,13,4852453,250,4,4202918,649535,190,2,4616852,235601,-413934,413934
2018-08-20,13,13,13,13,3207688,122,2,2157688,1050000,149,2,3118745,88943,-961057,961057
2018-08-21,13,13,13,13,22530864,535,4,17900472,4630392,510,7,14472720,8058144,3427752,-3427752
2018-08-25,14,14,14,14,23888291,545,7,18540042,5348249,382,11,7433177,16455114,11106865,-11106865
2018-08-26,15,15,15,15,34365486,898,3,33205486,1160000,471,12,12613409,21752077,20592077,-20592077
2018-08-27,15,15,14,14,26335141,395,2,14073460,201600,333,2,10687402,3589658,3386058,-3388058
2018-08-28,14,15,14,14,20646500,597,5,19446000,1200500,573,5,16731505,3914995,2714495,-2714495
2018-08-29,14,15,14,14,9660314,386,3,9037118,623196,350,3,8959354,700960,77764,-77764
2018-09-01,14,14,14,14,11046048,549,2,10526048,520000,302,1,11046038,10,-519990,519990
2018-09-02,13,14,13,13,9331673,405,3,8216673,1115000,256,0,9331673,0,-1115000,1115000
2018-09-03,13,14,13,14,15274920,462,5,11624920,3650000,398,5,13350920,1924000,-1726000,1726000
2018-09-04,14,14,14,14,16996387,458,6,13576498,3419889,478,2,16596387,400000,-3019889,3019889
2018-09-05,14,14,14,14,9774472,340,3,9338613,435859,242,3,8594472,1180000,744141,-744141
2018-09-08,14,15,14,15,17542442,485,3,16724227,818215,614,0,17542442,0,-818215,818215
2018-09-09,15,15,15,15,19159719,617,3,18999863,159856,539,7,17869026,1290693,1130837,-1130837
2018-09-10,15,15,14,15,19240706,494,3,16840706,2400000,614,4,18205220,1035486,-1364514,1364514
2018-09-11,15,15,15,15,15121567,438,1,15021567,100000,488,5,12284288,2837279,2737279,-2737279
2018-09-12,15,15,15,15,36682575,894,5,32962867,3719708,691,4,32305176,4377399,657691,-657691
2018-09-15,16,16,16,16,21260756,330,0,21260756,0,379,4,11837898,9422858,9422858,-9422858
2018-09-16,16,17,16,17,46867610,987,4,45449380,1418230,1016,5,31767610,15100000,13681770,-13681770
2018-09-17,17,17,17,17,24317098,268,0,24317098,0,307,7,12982950,11334148,11334148,-11334148
2018-09-18,18,18,18,18,14524432,257,0,14524432,0,76,3,4738093,9786339,9786339,-9786339
2018-09-22,19,20,19,20,59162227,1568,5,58744227,418000,660,11,23895363,35266864,34848864,-34848864
2018-09-23,20,20,18,18,52697124,1797,5,50855124,1842000,1034,21,39881733,12815391,10973391,-10973391
2018-09-24,19,19,18,19,32566316,1108,4,31804200,762116,820,19,23756287,8810029,8047913,-8047913
2018-09-25,19,20,19,19,46752776,1741,6,43801986,2950790,660,7,20858671,25894105,22943315,-22943315
2018-09-26,19,20,19,19,45068740,1276,5,43714170,1354570,954,13,34993162,10075578,8721008,-8721008
2018-09-29,19,20,19,20,77229289,1498,7,72235561,4993728,1299,12,42014051,35215238,30221510,-30221510
2018-09-30,21,21,20,21,69307912,1284,10,61138285,8169627,545,10,22207912,47100000,38930373,-38930373
2018-10-01,22,22,21,21,7042468,165,2,3942468,3100000,106,1,4642468,2400000,-700000,700000
2018-10-03,21,21,20,20,36060890,836,4,31740890,4320000,839,6,31402729,4658161,338161,-338161
2018-10-06,20,20,19,19,22356328,664,2,21106328,1250000,471,6,19068353,3287975,2037975,-2037975
2018-10-07,18,18,18,18,2756715,109,0,2756715,0,30,0,2756715,0,0,0
2018-10-08,17,17,17,17,4116657,98,1,1916657,2200000,66,1,3916657,200000,-2000000,2000000
2018-10-09,17,18,16,16,54782843,1186,5,47040713,7742130,1233,5,54125753,657090,-7085040,7085040
2018-10-10,16,16,16,16,11243819,309,2,8206621,3037198,238,0,11243819,0,-3037198,3037198
2018-10-13,15,15,15,15,3792089,76,0,3792089,0,21,1,2989564,802525,802525,-802525
2018-10-15,16,17,16,17,25683438,714,0,25683438,0,710,6,23873438,1810000,1810000,-1810000
2018-10-16,17,17,16,17,48523271,1095,3,46824821,1698450,734,8,28809917,19713354,18014904,-18014904
2018-10-17,16,17,16,16,28217997,742,0,28217997,0,630,1,27967997,250000,250000,-250000
2018-10-20,17,17,17,17,40326790,810,2,38910575,1416215,568,9,22375142,17951648,16535433,-16535433
2018-10-21,17,17,16,17,19476476,684,0,19476476,0,476,5,18426565,1049911,1049911,-1049911
2018-10-22,16,17,16,16,15714135,472,3,12317621,3394644,282,1,15112265,600000,-2794644,2794644
2018-10-23,15,15,15,15,2686974,176,0,2686974,0,14,2,2505000,181974,181974,-181974
2018-10-24,15,15,15,15,1738492,146,0,1738492,0,15,4,1536008,202484,202484,-202484
2018-10-27,14,15,14,14,47028156,1032,3,45728156,1300000,969,4,45874608,1153548,-146452,146452
2018-10-28,14,15,14,15,25676218,728,2,25373217,303001,691,2,25146976,529242,226241,-226241
2018-10-29,15,15,15,15,19574195,586,0,19574195,0,562,1,19572295,1900,1900,-1900
2018-10-31,16,16,15,16,21622872,535,4,20347882,1274990,649,3,19321726,2301146,1026156,-1026156
2018-11-03,16,16,15,15,10215393,334,3,9552786,662607,375,1,10215392,1,-662606,662606
2018-11-04,15,16,15,15,13667937,498,4,10767933,2900004,336,1,13667933,4,-2900000,2900000
2018-11-05,15,16,15,16,17606469,363,3,16506469,1100000,551,5,12735669,4870800,3770800,-3770800
2018-11-06,16,16,16,16,10300276,375,3,9493286,806990,554,0,10300276,0,-806990,806990
2018-11-10,16,17,16,17,16737273,557,7,14337911,2399362,613,4,15337272,1400001,-999361,999361
2018-11-11,17,17,16,16,11903113,467,4,10153113,1750000,385,0,11903113,0,-1750000,1750000
2018-11-12,17,17,17,17,34842337,534,5,30242337,4600000,719,2,21742337,13100000,8500000,-8500000
2018-11-13,18,18,16,17,24179614,677,4,21629614,2550000,499,6,21429072,2750542,200542,-200542
2018-11-14,17,17,16,17,15947233,320,3,10967394,4979839,395,1,14812342,1134891,-3844948,3844948
2018-11-17,17,17,16,16,13094355,467,2,12564093,530262,621,0,13094355,0,-530262,530262
2018-11-18,16,17,16,16,15647146,525,3,10479498,5167648,231,4,14146063,1501083,-3666565,3666565
2018-11-19,16,16,15,15,14349615,548,1,14239097,110518,259,2,12449140,1900475,1789957,-1789957
2018-11-20,16,16,15,15,9745621,497,1,9575621,170000,270,0,9745621,0,-170000,170000
2018-11-21,15,16,15,16,16063493,433,3,15062396,1001097,393,5,11970966,4092527,3091430,-3091430
2018-11-24,17,17,16,17,24073694,899,0,24073694,0,482,4,15214413,8859281,8859281,-8859281
2018-11-26,17,17,16,16,6924705,463,1,6801917,122788,379,0,6924705,0,-122788,122788
2018-11-27,16,16,15,16,6872064,477,2,6551949,320115,206,0,6872064,0,-320115,320115
2018-11-28,15,16,15,15,11319144,682,1,10519144,800000,258,1,11019144,300000,-500000,500000
2018-12-01,15,15,14,14,10701941,602,0,10701941,0,284,2,10633069,68872,68872,-68872
2018-12-02,14,15,14,15,12599857,347,1,8948001,3651856,395,1,12582493,17364,-3634492,3634492
2018-12-03,15,15,14,15,11207695,600,1,11206695,1000,354,1,11057695,150000,149000,-149000
2018-12-04,15,15,14,15,6172284,304,1,4782184,1390100,347,0,6172284,0,-1390100,1390100
2018-12-05,15,16,15,16,31356601,655,6,25256601,6100000,392,5,9252673,22103928,16003928,-16003928
2018-12-08,16,16,16,16,49201283,908,2,48651283,550000,185,7,2351283,46850000,46300000,-46300000
2018-12-09,17,17,16,16,73072103,1745,9,64670034,8402069,1235,10,57047101,16025002,7622933,-7622933
2018-12-10,16,17,16,16,18187123,719,4,15577265,2609858,640,0,18187123,0,-2609858,2609858
2018-12-11,17,17,16,16,16220719,521,3,13610587,2610132,533,0,16220719,0,-2610132,2610132
2018-12-12,16,17,16,16,10251738,486,1,9624856,626882,457,1,10234138,17600,-609282,609282
2018-12-15,16,16,16,16,10149627,603,2,9564939,584688,342,0,10149627,0,-584688,584688
2018-12-16,15,16,15,15,6759165,394,1,6159165,600000,314,1,6709165,50000,-550000,550000
2018-12-17,16,16,15,16,20986934,756,1,20983224,3710,480,7,17915663,3071271,3067561,-3067561
2018-12-18,15,16,15,15,13026038,803,1,12826038,200000,245,1,12661321,364717,164717,-164717
2018-12-19,15,15,15,15,16067216,570,2,15867216,200000,297,3,11291180,4776036,4576036,-4576036
2018-12-22,15,15,15,15,11213502,418,1,11023502,190000,223,3,5377208,5836294,5646294,-5646294
2018-12-23,15,16,15,15,10565127,323,0,10565127,0,345,1,10541582,23545,23545,-23545
2018-12-24,16,16,15,15,7907008,326,1,7507008,400000,333,1,7807008,100000,-300000,300000
2018-12-25,15,15,15,15,7879621,345,0,7879621,0,247,0,7879621,0,0,0
2018-12-26,15,16,15,16,29542737,585,4,28441406,1101331,878,6,23576857,5965880,4864549,-4864549
2018-12-29,16,16,15,16,12099705,538,1,11799705,300000,311,3,10949705,1150000,850000,-850000
2018-12-30,16,16,15,16,11271177,413,3,10730032,541145,422,2,11151177,120000,-421145,421145
2018-12-31,16,16,16,16,14373558,461,2,13158911,1214647,556,2,13323558,1050000,-164647,164647
2019-01-01,16,16,15,15,16218755,541,2,12038507,4180248,361,1,16210018,8737,-4171511,4171511
2019-01-02,16,17,16,17,103339275,1168,15,93598629,9740646,1521,9,62964275,40375000,30634354,-30634354
2019-01-05,17,17,17,17,83857874,1217,5,79757874,4100000,1307,12,62318375,21539499,17439499,-17439499
2019-01-06,18,18,17,17,56499281,1637,3,54438932,2060349,1152,10,52998932,3500349,1440000,-1440000
2019-01-07,17,18,17,18,53200462,711,2,51200462,2000000,1367,9,38947102,14253360,12253360,-12253360
2019-01-08,18,19,18,18,80298874,1626,18,71297845,9001029,1603,11,77057568,3241306,-5759723,5759723
2019-01-09,19,19,18,18,50809781,1413,5,49570167,1239614,1110,13,41939633,8870148,7630534,-7630534
2019-01-14,18,18,17,17,38462466,1157,7,36544206,1918260,774,3,37112466,1350000,-568260,568260
2019-01-15,17,18,17,17,39353385,1212,5,38017395,1335990,944,7,36175140,3178245,1842255,-1842255
2019-01-16,17,17,17,17,37032263,1169,6,35022458,2009805,758,4,36196953,835310,-1174495,1174495
2019-01-19,17,17,16,17,30905455,1097,2,30809998,94457,715,3,30464520,439935,345478,-345478
2019-01-20,17,17,16,16,31604692,995,5,30989691,615001,650,1,31541093,63599,-551402,551402
2019-01-21,15,16,15,15,36727515,790,5,23584115,13143400,554,2,33227515,3500000,-9643400,9643400
2019-01-22,15,16,15,16,34819107,606,4,32702108,2106999,746,4,27723305,7085802,4978803,-4978803
2019-01-23,16,16,16,16,16830837,697,1,16630837,200000,676,2,16652534,178303,-21697,21697
2019-01-26,16,16,15,15,17850830,842,3,17106945,743885,468,2,17641694,209136,-534749,534749
2019-01-27,16,16,15,16,61015839,449,7,54570989,6444850,895,7,37939764,23076075,16631225,-16631225
2019-01-28,16,17,16,17,64301799,432,11,59149799,5152000,848,7,37944062,26357737,21205737,-21205737
2019-01-30,18,18,17,17,72473531,1275,5,70991031,1482500,1504,13,66113599,6359932,4877432,-4877432
2019-02-02,17,18,17,17,27674266,571,5,23949466,3724800,879,3,27366173,308093,-3416707,3416707
2019-02-03,17,17,16,17,37358047,743,7,31614146,5743901,407,3,36008046,1350001,-4393900,4393900
2019-02-04,17,17,16,16,16763060,483,4,14533040,2230020,402,0,16763060,0,-2230020,2230020
2019-02-05,16,17,16,16,14378266,469,4,11281441,3096825,404,2,14347221,31045,-3065780,3065780
2019-02-06,16,17,16,17,22166905,621,3,20601120,1565785,671,3,21246664,920241,-645544,645544
2019-02-10,17,17,17,17,13831634,475,3,13010695,820939,486,2,13669950,161684,-659255,659255
2019-02-12,17,17,16,16,10328235,305,3,7124020,3204215,375,2,10118566,209669,-2994546,2994546
2019-02-13,16,17,16,16,13361329,377,3,9901329,3460000,539,4,12125780,1235549,-2224451,2224451
2019-02-16,16,17,16,16,12092235,398,3,11486547,605688,444,3,11744326,347909,-257779,257779
2019-02-17,16,16,16,16,14539059,506,11,12510296,2028763,276,1,14518921,20138,-2008625,2008625
2019-02-18,16,16,16,16,8476592,453,2,8332419,144173,242,2,7791338,685254,541081,-541081
2019-02-19,16,17,16,16,14189691,419,3,9955858,4233833,466,4,12907399,1282292,-2951541,2951541
2019-02-20,17,17,16,16,16378604,699,6,14134591,2244013,270,4,11428604,4950000,2705987,-2705987
2019-02-23,17,17,16,17,24201891,633,1,21954661,2247230,731,6,22281240,1920651,-326579,326579
2019-02-24,17,17,17,17,19232442,675,3,18390536,841906,550,3,19034037,198405,-643501,643501
2019-02-25,17,17,16,17,14043226,595,0,14043226,0,485,4,13112816,930410,930410,-930410
2019-02-26,16,17,16,16,10709550,517,0,10709550,0,309,2,10032558,676992,676992,-676992
2019-02-27,16,16,16,16,10939567,477,1,10049895,889672,292,3,9998421,941146,51474,-51474
2019-03-02,16,16,16,16,12015875,587,2,11505547,510328,296,4,10655026,1360849,850521,-850521
2019-03-03,16,16,16,16,9563987,447,3,8893340,670647,310,3,8306041,1257946,587299,-587299
2019-03-04,16,16,16,16,14654458,442,2,13644458,1010000,370,3,13035032,1619426,609426,-609426
2019-03-05,16,16,16,16,9501681,461,2,9151865,349816,260,1,8819021,682660,332844,-332844
2019-03-06,16,16,16,16,13870133,449,28,10352900,3517233,346,3,13612875,257258,-3259975,3259975
2019-03-09,16,16,16,16,13503048,423,2,13331808,171240,392,2,11403048,2100000,1928760,-1928760
2019-03-10,16,16,16,16,12803356,407,6,11673356,1130000,324,6,11576081,1227275,97275,-97275
2019-03-11,16,16,16,16,12198070,537,4,10704269,1493801,278,2,10528071,1669999,176198,-176198
2019-03-12,16,16,16,16,8412001,366,3,7581001,831000,286,2,8384885,27116,-803884,803884
2019-03-13,16,16,16,16,14621336,404,3,11984096,2637240,715,3,13510077,1111259,-1525981,1525981
2019-03-16,16,16,16,16,19875476,361,3,16252949,3622527,625,8,16774929,3100547,-521980,521980
2019-03-17,16,17,16,17,39761656,780,7,37813375,1933281,1193,8,29890345,9856311,7923030,-7923030
2019-03-18,17,17,17,17,18554971,596,6,15730635,2824336,602,3,17942684,612287,-2212049,2212049
2019-03-19,17,17,17,17,15800313,543,4,14194933,1605380,430,12,13523975,2276338,670958,-670958
2019-03-25,18,18,17,18,20196331,403,3,17898999,2297332,656,23,16742971,3453360,1156028,-1156028
2019-03-26,19,19,19,19,7537267,18,2,5824035,1713232,274,2,4537267,3000000,1286768,-1286768
2019-03-27,19,19,19,19,113375662,1672,12,85458092,27917570,1722,15,96314075,17061587,-10855983,10855983
2019-03-30,19,20,19,20,65069058,805,14,51699367,13369691,1357,8,41828005,23241053,9871362,-9871362
2019-03-31,21,21,20,21,159025838,1682,22,132928994,26096844,1912,18,112400901,46624937,20528093,-20528093
2019-04-06,20,22,20,22,59983483,525,6,58063483,1920000,815,8,27059598,32923885,31003885,-31003885
2019-04-07,23,23,22,23,179284676,1729,24,130483838,48800838,1545,22,131243308,48041368,-759470,759470
2019-04-08,22,24,22,23,141925460,2701,32,118737727,23187733,2049,23,116497925,25427535,2239802,-2239802
2019-04-09,22,23,22,23,77913817,1371,21,59786495,18127322,1590,13,73201348,4712469,-13414853,13414853
2019-04-10,23,24,23,23,70785936,1380,14,57402334,13383602,1059,15,43002098,27783838,14400236,-14400236
2019-04-13,23,23,22,22,77280219,1798,17,63800881,13479338,1301,14,61029167,16251052,2771714,-2771714
2019-04-14,22,23,22,23,55119307,1349,7,53328487,1790820,1432,8,47998502,7120805,5329985,-5329985
2019-04-15,23,24,22,23,61150800,1475,19,42093425,19057375,916,11,48852614,12298186,-6759189,6759189
2019-04-16,23,23,22,22,60523622,1168,7,49123622,11400000,838,9,51539246,8984376,-2415624,2415624
2019-04-17,22,23,22,23,38214044,956,9,30714487,7499557,994,4,36334044,1880000,-5619557,5619557
2019-04-20,24,24,24,24,12715755,90,0,12715755,0,366,3,6791227,5924528,5924528,-5924528
2019-04-22,25,25,24,24,233061960,2655,34,192925230,40136730,2442,37,139251033,93810927,53674197,-53674197
2019-04-23,24,26,24,25,62061887,1175,8,57779337,4282550,1224,12,48285034,13776853,9494303,-9494303
2019-04-24,25,26,25,26,61189017,1265,9,57181999,4007018,1155,13,54897727,6291290,2284272,-2284272
2019-04-27,26,27,25,25,55414891,1264,13,47164947,8249944,1058,8,52534891,2880000,-5369944,5369944
2019-04-28,25,26,25,25,50330550,1455,15,42740696,7589854,1114,7,48016927,2313623,-5276231,5276231
2019-04-29,25,26,25,26,133907585,1236,15,114787678,19119907,1774,15,74971471,58936114,39816207,-39816207
2019-04-30,27,27,26,27,81988094,1529,15,60231245,21756849,1279,9,68669415,13318679,-8438170,8438170
2019-05-01,27,28,27,28,55452546,1026,13,36770118,18682428,1057,15,44839078,10613468,-8068960,8068960
2019-05-04,28,29,28,29,99340573,1592,15,64540573,34800000,906,12,45177073,54163500,19363500,-19363500
2019-05-05,30,31,29,29,148691199,2546,31,122724690,25966509,1651,17,112711249,35979950,10013441,-10013441
2019-05-06,29,31,29,29,42297485,1327,5,37696985,4600500,691,9,39246207,3051278,-1549222,1549222
2019-05-07,28,28,28,28,14272733,424,1,13272733,1000000,291,1,14252733,20000,-980000,980000
2019-05-08,27,27,27,27,141907217,2682,20,99459217,42448000,1838,14,127395748,14511469,-27936531,27936531
2019-05-11,26,27,25,25,62476430,1343,13,44636429,17840001,963,5,61347276,1129154,-16710847,16710847
2019-05-12,26,26,25,25,16347787,526,7,12297785,4050002,302,3,13680087,2667700,-1382302,1382302
2019-05-13,24,25,24,25,132774457,2378,23,115003839,17770618,2003,25,113025734,19748723,1978105,-1978105
2019-05-14,25,25,25,25,71749829,919,12,47949829,23800000,838,13,40113733,31636096,7836096,-7836096
2019-05-15,25,26,25,26,63704220,993,8,40554132,23150088,1034,10,54317466,9386754,-13763334,13763334
2019-05-18,26,27,26,27,67363965,965,12,59591842,7772123,1132,11,49631430,17732535,9960412,-9960412
2019-05-19,27,27,25,26,55285085,1514,17,41474034,13811051,958,3,54959962,325123,-13485928,13485928
2019-05-20,25,25,24,25,51338901,1183,12,29726901,21612000,989,1,50838901,500000,-21112000,21112000
2019-05-21,25,26,25,26,26969465,444,14,22809439,4160026,1122,5,24699465,2270000,-1890026,1890026
2019-05-22,26,27,25,26,36589179,778,12,29606465,6982714,854,5,33876548,2712631,-4270083,4270083
2019-05-25,25,26,25,26,25235813,654,6,17664525,7571288,682,2,24531979,703834,-6867454,6867454
2019-05-26,26,26,25,25,22894453,642,8,16922786,5971667,758,4,21889453,1005000,-4966667,4966667
2019-05-28,26,27,25,26,44483316,803,13,34583979,9899337,1165,8,42631975,1851341,-8047996,8047996
2019-05-29,27,28,27,28,19167722,109,2,16567722,2600000,828,8,16020049,3147673,547673,-547673
2019-06-01,28,29,27,27,58553608,1215,7,49219704,9333904,1306,11,51018648,7534960,-1798944,1798944
2019-06-02,27,29,27,28,28415065,921,16,22474488,5940577,768,5,27444210,970855,-4969722,4969722
2019-06-03,28,29,28,28,44616619,871,5,40519160,4097459,951,10,34172565,10444054,6346595,-6346595
2019-06-08,28,29,28,28,38920330,625,8,26989637,11930693,711,6,25833178,13087152,1156459,-1156459
2019-06-09,29,29,29,29,53740557,290,8,30402998,23337559,758,13,21399575,32340982,9003423,-9003423
2019-06-10,31,31,29,29,98503089,1259,31,71058278,27444811,1270,12,53699751,44803338,17358527,-17358527
2019-06-11,29,32,29,32,61868911,451,20,40437678,21431233,1369,15,48490679,13378232,-8053001,8053001
2019-06-12,32,33,32,32,127529083,1293,30,83411427,44117656,1368,23,98468011,29061072,-15056584,15056584
2019-06-15,31,34,31,34,121795644,1316,26,98987645,22807999,1623,25,77775552,44020092,21212093,-21212093
2019-06-16,34,34,31,32,77978903,2080,16,62203126,15775777,1167,10,73443797,4535106,-11240671,11240671
2019-06-17,31,33,31,31,46046945,1054,14,29189159,16857786,1102,7,42065892,3981053,-12876733,12876733
2019-06-18,31,33,31,31,37336737,876,7,35819639,1517098,732,10,31521843,5814894,4297796,-4297796
2019-06-19,32,32,31,31,40214872,762,6,37274449,2940423,730,10,36556243,3658629,718206,-718206
2019-06-22,30,31,30,30,59442090,1282,9,48891442,10550648,735,6,44199631,15242459,4691811,-4691811
2019-06-23,30,32,30,32,16508946,138,3,14608946,1900000,661,7,12422222,4086724,2186724,-2186724
2019-06-24,33,33,33,33,4576094,18,7,3290000,1286094,347,4,3911094,665000,-621094,621094
2019-06-25,34,34,33,34,75987336,1309,21,65904350,10082986,1457,12,61146103,14841233,4758247,-4758247
2019-06-26,36,36,34,34,50689521,1187,13,46409406,4280115,822,9,41095428,9594093,5313978,-5313978
2019-06-30,34,34,33,33,32948465,1034,12,21000563,11947902,689,3,29006308,3942157,-8005745,8005745
2019-07-01,33,34,32,33,25961871,979,9,22108942,3852929,603,4,25239971,721900,-3131029,3131029
2019-07-02,32,33,32,33,19206054,868,5,16930240,2275814,532,8,17741977,1464077,-811737,811737
2019-07-03,33,34,32,32,27467002,1061,14,21662002,5805000,594,5,20863807,6603195,798195,-798195
2019-07-06,32,32,31,31,38914872,1796,8,30060876,8853996,682,8,34838330,4076542,-4777454,4777454
2019-07-07,31,32,31,32,19022149,785,11,16092283,2929866,680,6,18267561,754588,-2175278,2175278
2019-07-08,32,33,32,33,24576198,667,10,17821663,6801538,666,4,18003201,6620000,-181538,181538
2019-07-09,33,33,31,32,17821754,448,6,16183364,1638390,752,6,16670849,1150905,-487485,487485
2019-07-10,32,34,31,34,28465471,338,15,25778800,2686671,1300,9,25339451,3126020,439349,-439349
2019-07-13,34,35,34,35,56506120,693,68,42421823,14084297,1587,12,40164120,16342000,2257703,-2257703
2019-07-14,35,35,33,33,30051080,1262,13,25295879,4755201,711,4,28718705,1332375,-3422826,3422826
2019-07-15,34,34,31,32,27863538,820,15,18854468,9009070,459,7,21507803,6355735,-2653335,2653335
2019-07-16,33,33,31,31,37735449,1175,11,21174355,16561094,503,7,32925114,4810335,-11750759,11750759
2019-07-17,30,32,30,31,20270597,1039,7,14174315,6096282,575,10,19579078,691519,-5404763,5404763
2019-07-20,32,32,31,31,17918460,1059,15,12975661,4942799,588,6,16568658,1349802,-3592997,3592997
2019-07-23,30,31,29,31,12636806,422,17,7495687,5141119,233,2,12627517,9289,-5131830,5131830
2019-07-24,31,31,30,31,20094847,871,9,15435003,4659844,525,5,17086674,3008173,-1651671,1651671
2019-07-27,31,31,30,30,17914099,1166,5,16064099,1850000,415,3,16824219,1089880,-760120,760120
2019-07-28,30,31,30,30,12502935,749,6,10872101,1630834,422,7,9199483,3303452,1672618,-1672618
2019-07-29,30,31,30,30,12028321,571,4,9045039,2983282,392,6,10282575,1745746,-1237536,1237536
2019-07-30,30,31,29,30,15589886,677,5,14025237,1564649,559,10,13105612,2484274,919625,-919625
2019-07-31,30,31,30,30,12561574,541,3,10215819,2345755,354,1,10154955,2406619,60864,-60864
2019-08-03,31,31,30,31,11089554,497,4,9917475,1172079,527,6,9470571,1618983,446904,-446904
2019-08-04,31,32,30,32,31485557,660,14,24249796,7235761,989,16,21129901,10355656,3119895,-3119895
2019-08-05,33,33,32,32,20173421,709,8,13267933,6905488,683,7,17752057,2421364,-4484124,4484124
2019-08-06,32,32,31,31,12530894,529,3,10458841,2072053,392,4,11791585,739309,-1332744,1332744
2019-08-07,32,32,31,31,13750339,377,7,10231685,3518654,507,5,12552502,1197837,-2320817,2320817
2019-08-10,31,32,31,32,12213920,357,4,9017497,3196423,660,5,10457901,1756019,-1440404,1440404
2019-08-11,32,33,32,32,16410070,630,4,13058842,3351228,533,7,14809182,1600888,-1750340,1750340
2019-08-13,32,32,31,32,17995858,762,10,13565258,4430600,562,4,17495858,500000,-3930600,3930600
2019-08-14,32,33,32,32,20143923,613,6,16068373,4075550,825,6,18983303,1160620,-2914930,2914930
2019-08-17,32,34,32,34,68921468,988,24,49849074,19072394,1262,13,35648177,33273291,14200897,-14200897
2019-08-18,34,34,33,34,23748289,994,8,19416130,4332159,835,9,20559739,3188550,-1143609,1143609
2019-08-19,34,35,34,35,53622276,1399,12,43746568,9875708,1222,10,33338410,20283866,10408158,-10408158
2019-08-21,35,37,35,36,37371904,1639,13,28799690,8572214,993,24,22936403,14435501,5863287,-5863287
2019-08-24,37,37,36,37,36706549,1939,18,26906307,9800242,784,12,29419815,7286734,-2513508,2513508
2019-08-25,37,37,35,36,70841318,2625,22,46428483,24412835,989,13,68423590,2417728,-21995107,21995107
2019-08-26,36,37,36,36,33217211,1513,13,23142092,10075119,753,8,27874904,5342307,-4732812,4732812
2019-08-27,36,37,35,35,34569177,1594,13,25379430,9189747,846,15,31212323,3356854,-5832893,5832893
2019-08-28,34,36,34,35,31819089,1351,14,22816771,9002318,802,12,25529683,6289406,-2712912,2712912
2019-08-31,36,36,34,35,29021009,1362,17,22237537,6783472,829,5,24882311,4138698,-2644774,2644774
2019-09-01,35,37,35,36,39623441,1319,4,35483441,4140000,1059,42,24293844,15329597,11189597,-11189597
2019-09-02,36,37,35,35,37439040,1708,19,26808262,10630778,891,14,32491092,4947948,-5682830,5682830
2019-09-03,35,36,35,36,19144792,645,7,13537648,5607144,691,12,15068557,4076235,-1530909,1530909
2019-09-04,36,36,35,36,14428161,789,8,9962814,4465347,725,12,12850574,1577587,-2887760,2887760
2019-09-07,36,36,36,36,50851170,969,12,22087604,28763566,827,9,18205287,32645883,3882317,-3882317
2019-09-08,36,38,36,38,80594038,1198,27,58831000,21763038,1839,76,41496071,39097967,17334929,-17334929
2019-09-11,39,40,38,40,30858872,842,11,23031569,7827303,795,6,17084709,13774163,5946860,-5946860
2019-09-14,41,41,41,41,9290985,51,7,7790985,1500000,298,2,7790985,1500000,0,0
2019-09-15,42,43,41,43,129308030,3126,34,98386878,30921152,1669,14,69027170,60280860,29359708,-29359708
2019-09-16,44,44,41,41,60293671,3181,17,48507644,11786027,1409,12,51841627,8452044,-3333983,3333983
2019-09-17,41,43,41,41,39449418,2010,14,33379381,6070037,1144,8,34552864,4896554,-1173483,1173483
2019-09-18,40,42,39,41,51342324,2028,17,36950229,14392095,1244,15,43271260,8071064,-6321031,6321031
2019-09-21,41,42,40,41,23977478,1194,5,20614535,3362943,623,3,22572808,1404670,-1958273,1958273
2019-09-22,41,43,41,41,18791496,1262,8,17351910,1439586,654,3,18481889,309607,-1129979,1129979
2019-09-23,41,43,41,41,19060219,926,10,14102431,4957788,971,6,17884502,1175717,-3782071,3782071
2019-09-24,42,44,41,42,44714431,1346,9,35899810,8814621,1579,14,35933004,8781427,-33194,33194
2019-09-25,42,44,42,43,30455217,1250,9,26341439,4113778,1151,11,22269444,8185773,4071995,-4071995
2019-09-28,43,45,43,44,36771511,1734,22,27378555,9392956,971,7,24065331,12706180,3313224,-3313224
2019-09-29,44,44,42,43,35430892,1574,9,29583492,5847400,1013,6,32379072,3051820,-2795580,2795580
2019-09-30,42,45,42,45,30236868,520,6,24854776,5382092,1274,13,24451587,5785281,403189,-403189
2019-10-01,46,46,44,45,93424696,1198,23,59595365,33829331,1322,21,63803093,29621603,-4207728,4207728
2019-10-02,45,48,45,48,84968499,1408,22,60465162,24503337,1800,29,51755603,33212896,8709559,-8709559
2019-10-05,49,50,47,47,39620808,1626,10,31700808,7920000,1012,15,31573154,8047654,127654,-127654
2019-10-06,47,48,46,47,25125170,1003,9,19852130,5273040,877,9,23116156,2009014,-3264026,3264026
2019-10-07,48,48,46,47,27618208,844,15,23537779,4080429,1108,12,23496829,4121379,40950,-40950
2019-10-08,47,48,45,45,24707862,810,12,17721121,6986741,570,6,21244247,3463615,-3523126,3523126
2019-10-09,44,45,43,44,40414321,1049,20,26023127,14391194,1170,9,31321945,9092376,-5298818,5298818
2019-10-12,44,45,43,44,15708007,879,11,14795478,912529,670,7,14368287,1339720,427191,-427191
2019-10-13,44,45,42,42,27932093,1182,12,23135911,4796182,659,10,22325471,5606622,810440,-810440
2019-10-14,42,42,41,41,27584301,1367,6,21680351,5903950,711,5,25131260,2453041,-3450909,3450909
2019-10-15,41,43,39,39,60423473,1498,39,36521945,23901528,993,9,45075748,15347725,-8553803,8553803
2019-10-16,39,41,38,40,29629989,1054,11,11926923,17703066,765,17,26215334,3414655,-14288411,14288411
2019-10-20,39,41,37,37,69664365,1088,7,20424086,49240279,836,17,52388496,17275869,-31964410,31964410
2019-10-21,38,39,37,39,27209445,712,11,22713703,4495742,1042,7,25526543,1682902,-2812840,2812840
2019-10-22,40,40,40,40,50497732,1215,6,43990232,6507500,549,21,39222582,11275150,4767650,-4767650
2019-10-23,42,42,41,42,30095914,1877,5,28172692,1923222,845,27,18851573,11244341,9321119,-9321119
2019-10-26,42,42,40,41,18176789,948,5,15182907,2993882,659,4,11506761,6670028,3676146,-3676146
2019-10-28,42,43,41,43,22213053,1037,4,20503053,1710000,691,20,14719892,7493161,5783161,-5783161
2019-10-30,43,45,43,44,21122151,1426,3,20120663,1001488,689,27,16832748,4289403,3287915,-3287915
2019-11-02,44,45,42,43,24304468,1598,6,21585709,2718759,877,23,20025717,4278751,1559992,-1559992
2019-11-03,43,45,43,45,114758398,1222,11,103589723,11168675,1452,17,56363323,58395075,47226400,-47226400
2019-11-04,46,46,44,44,50431279,2004,7,43474047,6957232,950,9,41745344,8685935,1728703,-1728703
2019-11-05,44,48,44,46,36416040,1094,7,26143192,10272848,1195,7,34663886,1752154,-8520694,8520694
2019-11-09,48,49,47,48,68187483,1687,17,46365717,21821766,1874,26,45375025,22812458,990692,-990692
2019-11-10,47,48,46,47,27628034,1168,11,15578557,12049477,1229,12,25858065,1769969,-10279508,10279508
2019-11-11,48,50,47,50,66663287,1793,14,54071687,12591600,2022,23,42733222,23930065,11338465,-11338465
2019-11-12,50,51,49,49,28826652,1944,6,24109063,4717589,1160,5,27541188,1285464,-3432125,3432125
2019-11-13,49,51,49,49,30456415,1408,13,22998130,7458285,1105,6,24304893,6151522,-1306763,1306763
2019-11-16,48,49,47,47,61547579,2125,14,38665447,22881832,1269,6,49029843,12517436,-10364396,10364396
2019-11-17,45,47,45,45,110590732,1379,22,28332111,82258621,1497,14,103748742,6841990,-75416631,75416631
2019-11-18,45,47,45,46,18287363,948,6,15941665,2346902,747,7,16127493,2161074,-185828,185828
2019-11-19,47,48,47,47,11433952,770,5,10577969,855983,492,9,10340198,1093754,237771,-237771
2019-11-20,47,48,46,47,10195409,831,4,8795409,1400000,572,6,8491675,1703734,303734,-303734
2019-11-23,48,48,46,47,12535243,686,4,11935243,600000,687,5,11050306,1484937,884937,-884937
2019-11-24,47,48,45,48,23176940,820,24,14599464,8577476,1016,12,15446064,7730876,-846600,846600
2019-11-25,48,50,48,50,55077290,1204,29,44584401,10492889,1622,17,23356567,31720723,21227834,-21227834
2019-11-26,50,51,49,49,14935494,927,6,11945708,2989786,987,4,14155494,780000,-2209786,2209786
2019-11-27,51,51,49,49,14212970,905,6,10329643,3883327,717,4,12975970,1237000,-2646327,2646327
2019-11-30,50,50,49,49,14693663,1066,6,12898826,1794837,815,2,14093663,600000,-1194837,1194837
2019-12-01,49,51,49,50,27316916,1494,10,25315274,2001642,1326,9,23618887,3698029,1696387,-1696387
2019-12-02,50,51,49,49,26541705,1002,9,14688176,11853529,950,4,24994867,1546838,-10306691,10306691
2019-12-03,50,50,49,49,19146034,918,8,13788867,5357167,787,4,16642602,2503432,-2853735,2853735
2019-12-04,50,50,49,49,14828488,987,8,12158440,2670048,759,5,14131944,696544,-1973504,1973504
2019-12-07,49,51,49,50,35091703,1551,11,28615764,6475939,1356,7,31429614,3662089,-2813850,2813850
2019-12-08,50,52,49,51,29454661,1234,9,17467946,11986715,1329,8,21377292,8077369,-3909346,3909346
2019-12-09,52,54,52,54,53001372,1450,15,40307889,12693483,1423,16,24740987,28260385,15566902,-15566902
2019-12-10,55,56,54,54,55465481,2559,12,33292074,22173407,1271,12,47705866,7759615,-14413792,14413792
2019-12-11,54,58,54,57,53287146,1655,16,28177142,25109019,1477,23,28537403,24748758,-360261,360261
2019-12-14,57,58,56,57,23516806,1490,10,14088180,9428626,1209,13,15982193,7534613,-1894013,1894013
2019-12-15,58,58,55,56,30330875,1469,10,19152823,11178052,1134,9,27690874,2640001,-8538051,8538051
2019-12-16,56,56,55,55,19109066,1107,9,11995300,7113766,927,8,15587330,3521736,-3592030,3592030
2019-12-17,58,58,55,55,26452062,1500,6,17671090,8780972,892,7,22735198,3716864,-5064108,5064108
2019-12-18,55,55,53,54,22424127,1954,9,19583520,2840607,982,6,20461164,1962963,-877644,877644
2019-12-21,54,55,54,54,17432646,1255,9,13450748,3981898,899,11,13913408,3519238,-462660,462660
2019-12-22,54,55,53,54,18733682,1466,9,17021682,1712000,886,4,17142520,1591162,-120838,120838
2019-12-23,54,56,53,54,30337385,1678,10,27184635,3152750,1218,17,26417340,3920045,767295,-767295
2019-12-24,54,55,54,54,16587075,1242,5,15540749,1046326,714,5,15009108,1577967,531641,-531641
2019-12-25,54,57,54,57,37308135,1625,10,27714087,9594048,1983,10,28046455,9261680,-332368,332368
2019-12-28,58,58,56,56,29441866,2323,9,26035164,3406702,1016,7,25419164,4022702,616000,-616000
2019-12-29,56,57,56,56,20850138,1602,4,19422888,1427250,1011,2,20749138,101000,-1326250,1326250
2019-12-30,56,57,56,56,19277061,1672,5,17783739,1461861,1026,3,19145070,100530,-1361331,1361331
2019-12-31,56,57,54,55,24335608,1793,10,22163467,2172141,992,5,21674539,2661069,488928,-488928
2020-01-01,55,56,54,54,28343479,1876,7,24327031,4016448,904,6,18936576,9406903,5390455,-5390455
2020-01-04,52,52,52,52,81487665,659,5,2742665,78745000,722,5,65158799,16328866,-62416134,62416134
2020-01-05,52,52,49,50,85403287,2715,11,37112278,48291009,1700,15,70245743,15157544,-33133465,33133465
2020-01-07,50,51,48,48,35797657,1436,5,16848184,18949473,507,8,33661349,2136308,-16813165,16813165
2020-01-08,48,50,48,50,134557771,1535,14,38473388,96084383,2221,15,123972848,10584923,-85499460,85499460
2020-01-11,49,49,49,49,1398350,0,1,0,1398350,75,4,223257,1175093,-223257,223257
2020-01-12,52,52,52,52,16779320,121,6,15206025,1573295,118,4,1005044,15774276,14200981,-14200981
2020-01-13,54,54,54,54,83350679,1457,12,68391540,14959139,385,8,13397144,69953535,54994396,-54994396
2020-01-14,57,57,56,57,150645969,3848,27,109631810,41014159,1841,21,44490603,106155366,65141207,-65141207
2020-01-15,57,60,56,60,93079508,2739,18,69538762,23540746,1948,12,44762508,48317000,24776254,-24776254
2020-01-18,62,62,61,61,89049625,4755,16,79900677,9148948,1907,14,44082158,44967467,35818519,-35818519
2020-01-19,61,64,60,63,44343843,3276,13,39608923,4734920,1961,4,42513843,1830000,-2904920,2904920
2020-01-20,62,63,60,61,33534209,2517,7,32391209,1143000,1499,5,26145021,7389188,6246188,-6246188
2020-01-21,61,62,59,59,33327372,2669,2,32403372,900000,1512,5,26603419,6699953,5799953,-5799953
2020-01-22,60,63,59,62,32200052,2019,4,31672052,528000,1466,7,24510903,7689149,7161149,-7161149
2020-01-25,63,65,63,65,64971702,3134,11,55252923,9718779,2046,10,34243936,30727766,21008987,-21008987
2020-01-26,67,67,63,64,50938578,4305,9,48891802,2046776,1614,14,36712022,14226556,12179780,-12179780
2020-01-27,65,67,63,65,30277717,2076,6,26805329,3472388,1691,9,27216688,3061029,-411359,411359
2020-01-28,67,69,67,69,100940100,2746,19,82914342,18025758,2104,19,32775006,68165094,50139336,-50139336
2020-02-01,71,72,71,72,101051062,3750,11,81362195,19688867,1793,20,56095062,44956000,25267133,-25267133
2020-02-02,75,75,72,73,3655760,622,1,3235273,420487,105,0,3655760,0,-420487,420487
2020-02-05,78,80,74,76,76058069,4986,9,73282569,2775500,2504,14,55292599,20765470,17989970,-17989970
2020-02-08,77,77,73,73,54206684,3896,6,36104184,18102500,2206,5,48765684,5441000,-12661500,12661500
2020-02-09,73,76,72,73,44575548,3297,5,43675459,900089,2644,11,35195643,9379905,8479816,-8479816
2020-02-10,75,75,70,70,217487713,14796,11,205778263,11709450,1664,32,147723763,69763950,58054500,-58054500
2020-02-12,71,72,68,68,119590268,11120,8,117189248,2401020,3732,26,91398269,28191999,25790979,-25790979
2020-02-15,69,69,66,66,32975293,4431,4,29655293,3320000,527,8,19738785,13236508,9916508,-9916508
2020-02-16,66,68,63,64,78333171,7771,8,75987581,2345590,3317,11,65964187,12368984,10023394,-10023394
2020-02-17,66,66,62,62,97121688,9210,13,90197442,6924246,3840,16,82173649,14948039,8023793,-8023793
2020-02-18,63,66,61,65,73289152,7765,12,64766281,8522871,2937,16,48808506,24480646,15957775,-15957775
2020-02-19,66,66,63,63,42750230,6853,6,42100539,649691,2511,8,33282252,9467978,8818287,-8818287
2020-02-22,61,66,61,63,64209906,6545,13,47038081,17171825,3306,5,60133327,4076579,-13095246,13095246
2020-02-23,64,66,64,65,52952864,5851,4,52920358,32506,2757,8,40163991,12788873,12756367,-12756367
2020-02-24,66,66,63,64,53307092,6208,7,48722110,4502795,2858,6,46504291,6720614,2217819,-2217819
2020-02-25,65,67,64,67,65800490,6201,9,60225356,5575134,3667,7,48606772,17193718,11618584,-11618584
2020-02-26,67,67,63,63,49563825,6037,5,47981325,1582500,2249,14,40756926,8806899,7224399,-7224399
2020-02-29,64,67,62,67,77705142,8605,2,77360435,170200,4569,8,72046833,5483802,5313602,-5313602
2020-03-01,68,69,67,69,40653599,3403,2,39303599,1350000,2068,10,22128431,18525168,17175168,-17175168
2020-03-02,72,75,69,75,59969244,5385,6,58863602,1105642,2864,11,43192533,16776711,15671069,-15671069
2020-03-03,78,78,74,75,60391838,8929,5,59803978,587860,5061,9,57395046,2996792,2408932,-2408932
2020-03-04,75,75,72,73,66000549,7283,5,65672653,327896,5559,4,65134037,866512,538616,-538616
2020-03-07,73,75,70,71,47960190,5099,4,47742332,217858,6197,5,46775481,1184709,966851,-966851
2020-03-09,72,72,68,68,42401203,4906,7,41881079,520124,2395,8,40300818,2100385,1580261,-1580261
2020-03-10,67,72,67,68,53887774,5022,10,48902503,4985271,3551,9,43881989,10005785,5020514,-5020514
2020-03-11,72,73,70,73,71921462,4678,6,67342979,4578483,3648,7,44487624,27433838,22855355,-22855355
2020-03-14,73,73,69,69,73705726,6411,8,69131957,4573769,2063,5,60660440,13045286,8471517,-8471517
2020-03-15,68,72,66,69,99135784,9691,11,91655374,7480410,4153,9,85448067,13687717,6207307,-6207307
2020-05-16,138,138,138,138,97199726,1554,6,96599838,599888,102,2,3099726,94100000,93500112,-93500112
2020-05-17,145,145,145,145,103255861,1377,8,102455861,800000,265,4,15287018,87968843,87168843,-87168843
2020-05-18,152,152,152,152,102404033,1300,8,101604033,800000,192,3,8204033,94200000,93400000,-93400000
2020-05-19,160,160,160,160,103335550,1760,4,102935550,400000,228,2,10635550,92700000,92300000,-92300000
2020-05-20,168,168,168,168,95725270,1322,5,95225270,500000,271,3,10740776,84984494,84484494,-84484494
2020-05-23,159,175,159,175,2429106868,34910,31,2178891523,250215345,10505,30,2215907384,213199484,-37015861,37015861
2020-05-26,162,169,162,162,3051759056,33755,38,2835986335,215772721,10784,25,2838674326,213084730,-2687991,2687991
2020-05-27,170,170,167,170,691041787,5404,7,647257591,43784196,4925,11,516014249,175027538,131243342,-131243342
2020-05-30,179,179,179,179,155425142,1523,0,155425142,0,1206,3,93425142,62000000,62000000,-62000000
2020-05-31,188,188,170,186,3002410982,40775,21,2974942365,27468617,8400,19,2591733451,410677531,383208914,-383208914
2020-06-01,185,194,179,183,2043955926,35934,17,2026237178,17718748,11175,22,1791698022,252257904,234539156,-234539156
2020-06-02,188,196,187,196,1735655006,18030,15,1563961433,171693573,9161,17,1279749905,455905101,284211528,-284211528
2020-06-06,204,204,196,204,707050453,10341,12,624171142,82879311,4112,7,637172039,69878414,-13000897,13000897
2020-06-07,214,214,214,214,61756552,602,1,56756552,5000000,370,5,52752029,9004523,4004523,-4004523
2020-06-10,277,282,263,277,2278573495,32950,25,2180154488,98419007,15101,27,2197208738,81364757,-17054250,17054250
2020-06-13,284,284,284,284,387054037,17413,9,856390139,39537222,5586,14,693031381,202895980,163358758,-163358758
2020-06-14,298,298,286,298,1643534181,32793,19,1616808247,26731444,7583,29,1351975762,291563929,264832485,-264832485
2020-06-15,312,312,312,312,91439694,1159,1,91389694,50000,1819,27,79480510,11959184,11909184,-11909184
2020-06-16,327,327,327,327,73924641,347,1,73524641,400000,1504,17,66337078,7587563,7187563,-7187563
2020-06-20,342,342,342,342,122367538,479,5,106667538,15700000,1937,11,73381776,48985762,33285762,-33285762
2020-06-21,359,359,359,359,205240561,1148,15,181230561,24010000,2079,7,127047707,78192854,54182854,-54182854
2020-06-22,377,377,377,377,177196996,882,2,174996996,2200000,1822,7,172999256,4197740,1997740,-1997740
2020-06-23,395,395,395,395,93223532,718,3,88971811,4251721,1687,5,83209334,10014198,5762477,-5762477
2020-06-24,414,414,414,414,289944697,1773,5,273544697,16400000,2124,8,274026511,15918186,-481814,481814
2020-06-27,434,434,434,434,99461165,1222,2,97861165,1600000,1570,7,80428865,19032300,17432300,-17432300
2020-06-28,455,455,434,455,1914535657,39461,25,1884270353,30265304,6962,18,1691470202,223065455,192800151,-192800151
2020-06-29,466,477,432,477,1037306260,35005,15,1026753269,10552991,8252,12,954647036,82659224,72106233,-72106233
2020-06-30,491,491,491,491,53682034,350,8,49682034,4000000,1865,1,43682034,10000000,6000000,-6000000
2020-07-01,514,514,514,514,42288449,250,4,41031449,1257000,1905,3,31801355,10487094,9230094,-9230094
2020-07-04,539,539,539,539,91996639,1107,6,87596639,4400000,1041,5,53496074,38500565,34100565,-34100565
2020-07-05,565,565,565,565,311297545,2506,13,297029545,14268000,589,5,36039903,275257642,260989642,-260989642
2020-07-06,593,593,593,593,65285061,812,4,60483433,4801628,678,3,49046615,16238446,11436818,-11436818
2020-07-07,622,622,622,622,27514807,219,4,25895807,1619000,285,1,17514807,10000000,8381000,-8381000
2020-07-12,653,653,653,653,1433348730,43399,23,1423792753,9555977,2959,18,589038110,844310620,834754643,-834754643
2020-07-13,685,685,685,685,346244984,7358,5,342769057,3475927,3055,15,195314088,150930896,147454969,-147454969
2020-07-14,719,719,719,719,110461140,1656,6,106761190,3699950,1500,26,86779275,23681865,19981915,-19981915
2020-07-15,754,754,684,684,1604572158,103044,32,1348249513,256322645,7713,28,1328866305,275705853,19383208,-19383208
2020-07-18,677,677,677,677,977468875,58663,19,708232083,269236792,6571,7,966087375,11381500,-257855292,257855292
2020-07-19,710,710,710,710,283317696,2899,10,275908215,7409481,4208,9,236362774,46954922,39545441,-39545441
2020-07-20,745,745,706,745,1216294676,40396,23,1170128413,46166263,4964,17,924776049,291518627,245352364,-245352364
2020-07-27,882,926,839,882,1957398988,83369,25,1625278839,7190156,10989,66,960945390,671523605,664333449,-664333449
2020-07-28,888,946,857,857,784862469,75451,23,781414612,3447857,5327,28,619665958,165196511,161748654,-161748654
2020-07-29,826,826,826,826,345723450,36827,6,345607389,116061,4297,5,345248337,475113,359052,-359052
2020-08-01,785,867,785,866,750459823,78821,33,1286787434,9180819,24828,26,1280400843,15567410,6386591,-6386591
2020-08-01,865,867,828,834,545508430,78821,33,1286787434,9180819,24828,26,1280400843,15567410,6386591,-6386591
2020-08-02,867,868,787,827,583324775,84021,27,1308143912,9920313,15822,17,996546758,321517467,311597154,-311597154
2020-08-02,827,827,786,786,734739450,84021,27,1308143912,9920313,15822,17,996546758,321517467,311597154,-311597154
2020-08-03,780,780,780,780,153540604,23683,6,193033632,393132,1323,3,193332437,94327,-298805,298805
2020-08-03,780,780,780,780,39886160,23683,6,193033632,393132,1323,3,193332437,94327,-298805,298805
2020-08-04,741,741,741,741,100304210,16660,2,122916220,1615,1180,5,119317835,3600000,3598385,-3598385
2020-08-04,741,741,741,741,22613625,16660,2,122916220,1615,1180,5,119317835,3600000,3598385,-3598385
2020-08-05,731,778,705,746,879720224,66104,30,1430324052,7429203,22058,23,1267658603,170094652,162665449,-162665449
2020-08-05,755,778,705,720,558033031,66104,30,1430324052,7429203,22058,23,1267658603,170094652,162665449,-162665449
2020-08-09,707,707,707,707,181720629,28160,13,251329702,759146,1738,4,227078848,25010000,24250854,-24250854
2020-08-09,707,707,707,707,70368219,28160,13,251329702,759146,1738,4,227078848,25010000,24250854,-24250854
2020-08-10,672,672,672,672,67378987,13368,2,85818865,23490,842,2,83842355,2000000,1976510,-1976510
2020-08-10,672,672,672,672,18463368,13368,2,85818865,23490,842,2,83842355,2000000,1976510,-1976510
2020-08-11,639,639,639,639,42758618,8805,1,63476604,200000,624,1,63276604,400000,200000,-200000
2020-08-11,639,639,639,639,20917986,8805,1,63476604,200000,624,1,63276604,400000,200000,-200000
2020-08-12,661,671,607,607,664075645,40607,28,660419608,3656037,7875,28,497299954,166775691,163119654,-163119654
2020-08-15,602,602,602,602,102548269,13025,2,102547272,997,664,1,100548269,2000000,1999003,-1999003
2020-08-16,573,573,573,573,115551638,9379,3,65544448,50007190,571,3,115089193,462445,-49544745,49544745
2020-08-17,545,588,545,545,2450771640,54964,55,1992193530,458578110,34560,78,2189852209,260919431,-197658679,197658679
2020-08-18,577,577,549,552,1736187752,75687,29,1669951318,66236434,22163,70,1366216867,369970885,303734451,-303734451
2020-08-19,542,552,542,542,135427597,11319,6,134182764,1244833,2371,3,135106841,320756,-924077,924077
2020-08-22,542,565,515,515,627052325,20219,14,561878693,65173632,10816,31,616807603,10244722,-54928910,54928910
2020-08-23,498,498,498,498,111670852,6618,3,81489130,30163000,1366,2,111640097,12033,-30150967,30150967
2020-08-24,473,473,473,473,34993225,4518,4,31376246,3616979,188,2,34530350,462875,-3154104,3154104
2020-08-25,449,497,449,497,1763473140,40058,20,1748585377,14887763,22612,37,1733622062,29851078,14963315,-14963315
2020-08-26,501,501,497,501,393783085,16045,2,393249212,533873,5466,13,308108268,85674817,85140944,-85140944
2020-08-31,526,526,477,477,1226939742,39964,20,1225567651,1372091,12157,18,1161575916,65363826,63991735,-63991735
2020-09-01,469,469,469,469,49079361,5061,1,39179361,9900000,410,1,49069503,9858,-9890142,9890142
2020-09-02,447,447,447,447,25243812,3844,1,25235947,7865,133,0,25243812,0,-7865,7865
2020-09-05,431,453,427,452,2201302038,30257,33,1477780733,723521305,33043,18,2188978534,12323504,-711197801,711197801
2020-09-06,437,449,411,411,1807376782,34666,32,1388938706,418438076,21734,18,1764330552,43046230,-375391846,375391846
2020-09-07,398,398,398,398,21413868,2695,1,20413868,1000000,82,1,20913868,500000,-500000,500000
2020-09-15,400,420,400,419,1166889741,12833,21,1047837014,119278091,1256,9,120598454,1046516651,927238560,-927238560
2020-09-15,419,419,419,419,37409,12833,21,1047837014,119278091,1256,9,120598454,1046516651,927238560,-927238560
2020-09-16,421,421,384,394,2593261543,55814,40,2491239709,102021834,28593,31,2266565252,326696291,224674457,-224674457
2020-09-19,405,408,393,393,1183742632,19592,19,1152471836,31270796,19419,18,1175586734,8155898,-23114898,23114898
2020-09-20,377,385,375,375,290821456,7918,6,290575264,246192,5171,5,287206456,3615000,3368808,-3368808
2020-09-21,358,358,358,358,499565303,5756,11,126267603,373297700,2999,1,499060946,504357,-372793343,372793343
2020-09-22,354,367,340,345,2216695297,34711,33,2042201679,174493618,26406,9,2182474146,34221151,-140272467,140272467
2020-09-23,346,359,329,348,1894374408,33452,19,1853805503,40568905,24536,14,1877424878,16949530,-23619375,23619375
2020-09-26,354,365,333,333,970102394,25186,13,889287642,80814752,11272,8,969349741,752653,-80062099,80062099
2020-09-27,326,326,326,326,44632756,3674,1,44614805,17951,70,0,44632756,0,-17951,17951
2020-09-28,311,311,311,311,94669465,2286,3,18610252,76059213,300,2,93069465,1600000,-74459213,74459213
2020-09-29,295,311,295,306,2264331507,29415,38,1349893182,913881534,25544,25,2192365297,71409419,-842472115,842472115
2020-09-30,305,311,292,311,1168247911,19372,14,1121616423,46631488,16736,23,1038323155,129924756,83293268,-83293268
2020-10-03,322,322,322,322,80772183,179,5,77092183,3680000,2495,5,60879700,19892483,16212483,-16212483
2020-10-04,338,338,325,338,2026804897,24446,31,1911717251,115087646,14252,23,1852182368,174622529,59534883,-59534883
2020-10-05,329,354,329,354,967991001,8941,6,953537855,14453146,10503,27,788549568,179441433,164988287,-164988287
2020-10-06,365,365,365,365,183681677,427,3,172981677,10700000,1994,12,79480302,104201375,93501375,-93501375
2020-10-07,382,382,382,382,182381376,759,9,178731376,3650000,2498,8,74970176,107411200,103761200,-103761200
2020-10-10,401,401,401,401,117671289,441,4,115671289,2000000,2572,13,43879520,73791769,71791769,-71791769
2020-10-11,421,421,402,421,1648794992,22428,22,1539783610,109011382,9702,32,1301648899,347146093,238134711,-238134711
2020-10-12,438,441,421,441,3315229973,57868,32,3196790640,118439333,36065,63,3003015711,312214262,193774929,-193774929
2020-10-13,447,460,439,460,2009727499,39235,23,1988628730,21098769,25412,38,1863326716,146400783,125302014,-125302014
2020-10-14,434,434,434,434,182383213,12698,7,180870125,1513088,330,2,181398213,985000,-528088,528088
2020-10-18,413,413,413,413,29534479,2676,1,29532979,1500,161,1,29134479,400000,398500,-398500
2020-10-19,395,395,395,395,39427301,1711,1,15427301,24000000,188,2,38627301,800000,-23200000,23200000
2020-10-20,377,377,377,377,639433941,5249,4,530583941,108850000,2628,13,624739338,14694603,-94155397,94155397
2020-10-21,389,395,362,384,2494817097,30888,29,2358403776,136413321,33333,21,2407835776,86981321,-49432000,49432000
2020-10-24,372,384,372,372,572628898,6914,10,439386452,133242446,5508,2,572304367,324531,-132917915,132917915
2020-10-26,354,384,354,372,1414877390,13933,15,997945337,416932053,21637,18,1367709279,47168111,-369763942,369763942
2020-10-27,372,379,344,358,1441026839,22029,24,1358010821,83016018,19895,13,1413178515,27848324,-55167694,55167694
2020-10-28,361,375,347,375,1461179994,11584,19,1406033253,55146741,20710,19,1378587431,82592563,27445822,-27445822
2020-10-31,386,388,379,388,414253505,3190,8,398640754,15612751,6736,11,378938579,35314926,19702175,-19702175
2020-11-02,408,421,392,398,1476000023,21423,23,1268031757,207968266,17368,27,1443804625,32195398,-175772868,175772868
2020-11-04,382,411,382,382,988241148,18503,13,979317602,8923546,8148,18,942388311,45852837,36929291,-36929291
2020-11-07,404,405,369,388,1896370345,20867,29,1806827835,89542510,21957,20,1806083366,90286979,744469,-744469
2020-11-08,375,375,375,375,80965827,2979,4,66285827,14680000,229,0,80965827,0,-14680000,14680000
2020-11-09,371,385,358,372,1713409749,18392,21,1672865020,62691868,19212,19,1698866793,36690095,-26001773,26001773
2020-11-10,377,382,358,374,1615066749,16577,21,1553053240,62013509,17831,13,1591687962,23378787,-38634722,38634722
2020-11-11,375,389,366,389,1620136602,12186,21,1534136765,85999837,21114,16,1568427958,51708644,-34291193,34291193
2020-11-14,401,401,395,401,397035225,2717,2,363035225,34000000,5268,9,313630459,83404766,49404766,-49404766
2020-11-15,421,421,391,414,3695050259,38576,31,3217489008,477561251,31312,29,3602906824,92143435,-385417816,385417816
2020-11-16,409,433,399,433,1796911113,18154,17,1746548669,50362444,20690,30,1720958891,75952222,25589778,-25589778
2020-11-17,438,451,432,451,1621289949,21688,23,1567163303,54126646,17202,29,1502197074,119092875,64966229,-64966229
2020-11-18,466,471,458,471,959411339,15995,12,948329815,11081524,14124,21,790453476,168957863,157876339,-157876339
2020-11-21,481,489,447,447,3160937292,57918,36,3027773313,133163979,31365,32,3105302580,55634712,-77529267,77529267
2020-11-22,448,479,445,453,3248080441,40688,34,2930177843,317902598,34254,30,3153937083,94143358,-223759240,223759240
2020-11-23,454,477,447,471,1888946132,28968,21,1858116857,30829275,23613,27,1793028224,95917908,65088633,-65088633
2020-11-24,471,486,447,466,3506053982,42434,32,3442206635,63847347,40295,28,3272998161,233055821,169208474,-169208474
2020-11-25,468,488,458,466,1834900138,31168,32,1721763577,113113915,24436,21,1774019343,60858149,-52255766,52255766
2020-11-28,453,468,451,452,2664906914,50679,37,2114000432,550906482,30552,22,2640358624,24548290,-526358192,526358192
2020-11-29,458,475,453,475,2363975006,27251,29,2295392208,68582798,31637,26,1930984389,432990617,364407819,-364407819
2020-11-30,484,494,478,484,2399161743,41630,50,2269580116,129581627,30037,32,2175832370,223329373,93747746,-93747746
2020-12-01,479,494,471,471,1811404719,34427,43,1608734216,202670503,23242,23,1732364455,79040264,-123630239,123630239
2020-12-02,473,488,457,461,1571232108,31968,37,1405053068,166179040,21830,18,1527027440,44204668,-121974372,121974372
2020-12-05,460,492,460,492,1988364501,20899,27,1860734532,127629969,27070,28,1607891977,380472524,252842555,-252842555
2020-12-06,502,507,498,507,2537553220,37337,50,2349215619,188337601,28144,40,2090635706,446917514,258579913,-258579913
2020-12-07,508,514,481,484,2895139358,51967,42,2511449709,383689649,33999,25,2824706102,70433256,-313256393,313256393
2020-12-08,489,511,469,494,1662519082,28337,28,1352539497,309988585,28577,19,1592468737,70059345,-239929240,239929240
2020-12-09,495,506,478,492,996182647,20373,20,865246326,130936321,23926,15,938104011,58078636,-72857685,72857685
2020-12-12,494,499,466,471,1593890231,40607,33,1487138620,106751611,25171,23,1548437314,45452917,-61298694,61298694
2020-12-13,467,479,455,457,1312021282,33475,28,1133604760,178416522,18830,11,1291516900,20504382,-157912140,157912140
2020-12-14,460,475,438,438,1468736610,25731,29,1068439505,400297105,18394,14,1379199327,89537283,-310759822,310759822
2020-12-15,429,442,426,429,1768181344,18570,20,865124955,903056389,20251,22,1719270122,48911222,-854145167,854145167
2020-12-16,426,441,412,433,1279409249,27928,27,1172130007,107279242,20564,19,1262569759,16839490,-90439752,90439752
2020-12-19,439,445,418,428,781890161,18853,17,733999728,47890433,12841,18,754912835,26977326,-20913107,20913107
2020-12-20,432,433,409,409,992705258,20127,26,736678203,256027055,13265,9,959317378,33387880,-222639175,222639175
2020-12-21,404,417,393,393,1059440381,20979,35,828368016,231072365,16231,15,1052854879,6585502,-224486863,224486863
2020-12-22,392,417,386,417,1207705349,16771,27,1158304160,49401189,19452,20,992147488,215557861,166156672,-166156672
2020-12-23,424,426,394,404,972435252,22663,21,896719299,75715953,15307,19,941055030,31380222,-44335731,44335731
2020-12-26,402,406,387,387,566923668,14991,21,409623744,157299924,8155,8,535314668,31609000,-125690924,125690924
2020-12-27,377,400,371,381,1021949191,21213,24,869712245,152236946,18383,12,976789610,45159581,-107077365,107077365
2020-12-28,382,399,374,394,1188517259,20519,11,1128675454,59841805,17644,20,1057585731,130931528,71089723,-71089723
2020-12-29,393,393,374,374,867029147,17257,20,672698502,194330645,10597,16,847408930,19620217,-174710428,174710428
2020-12-30,379,384,358,361,908791566,20785,24,815776084,93015482,13866,16,855013278,53778288,-39237194,39237194
2021-01-02,357,362,348,348,754936784,15950,15,439060110,315876674,10730,11,749789693,5147091,-310729583,310729583
2021-01-03,341,361,335,359,1104370171,16866,19,785876498,318493673,16499,10,1084519575,19850596,-298643077,298643077
2021-01-04,360,367,351,364,1046244915,14771,10,998426375,47818540,15612,15,915866078,130378837,82560297,-82560297
2021-01-05,360,361,345,345,851598528,15815,14,653679578,197918950,8020,9,818191235,33407293,-164511657,164511657
2021-01-06,337,345,329,329,661353880,10594,10,400278067,261075813,8202,7,635281540,26072340,-235003473,235003473
2021-01-09,322,339,314,326,1077447855,16066,19,849389530,228058325,17893,9,1062090020,15357835,-212700490,212700490
2021-01-10,333,338,326,338,774810281,11874,14,738870856,35939425,12430,10,714392281,60418000,24478575,-24478575
2021-01-11,339,341,319,321,974171290,15864,15,673768688,300402602,11373,4,973667672,503618,-299898984,299898984
2021-01-12,317,318,308,308,475827555,6278,12,195613116,280214439,5555,5,403017554,72810001,-207404438,207404438
2021-01-13,299,312,294,311,1344091585,15544,21,796165824,547925761,15758,16,1281270711,62820874,-485104887,485104887
2021-01-16,306,308,285,288,1403391066,11119,17,736452462,666938604,12810,17,1310587214,92803852,-574134752,574134752
2021-01-18,287,287,274,274,372127212,4764,8,205807212,166320000,5153,5,340898662,31228550,-135091450,135091450
2021-01-19,268,291,268,291,584507181,6225,6,511431807,73075374,6792,14,527811378,56695803,-16379571,16379571
2021-01-20,293,302,292,302,381672346,3347,4,354072346,27600000,4162,11,339363846,42308500,14708500,-14708500
2021-01-23,315,315,315,315,120727715,1363,1,100727715,20000000,2046,6,107216215,13511500,-6488500,6488500
2021-01-24,331,331,302,309,1469759589,20932,15,1412483364,57276225,16177,22,1377001035,92758554,35482329,-35482329
2021-01-25,318,335,306,326,1059127890,12612,11,759043591,300084299,12467,9,1043211555,15916335,-284167964,284167964
2021-01-26,328,333,308,308,690341038,9111,6,490126038,200215000,7118,7,682005332,8335706,-191879294,191879294
2021-01-27,308,320,299,311,743555656,8640,11,560332073,183223583,9650,4,742163092,1392564,-181831019,181831019
2021-01-30,311,322,311,322,348405253,1663,6,340805253,7600000,5822,8,279271031,69134222,61534222,-61534222
2021-01-31,337,337,312,318,1105299367,14280,15,1051497178,53802189,11277,9,1051059367,54240000,437811,-437811
2021-02-01,315,331,311,311,588463504,8318,8,541654722,46808782,6291,9,545902204,42561300,-4247482,4247482
2021-02-02,304,327,300,312,1168691734,11706,15,1082587746,86103988,11248,13,1098281252,70410482,-15693506,15693506
2021-02-03,318,321,297,297,626893156,8065,9,566432316,60460840,7023,7,606069856,20823300,-39637540,39637540
2021-02-06,302,302,288,288,476502822,5083,15,319503206,156999616,5027,4,458902822,17600000,-139399616,139399616
2021-02-07,297,304,293,304,347874581,1145,4,259074581,88800000,5244,10,274325003,73549578,-15250422,15250422
2021-02-08,317,317,298,314,1192787774,11996,12,929417648,263370126,12092,19,1107343891,85443883,-177926243,177926243
2021-02-09,309,325,306,325,1007085333,6401,12,944657054,62428279,12720,13,915632233,91453100,29024821,-29024821
2021-02-13,342,342,337,342,574382900,4678,8,525144571,49244329,6272,11,410378846,164010054,114765725,-114765725
2021-02-14,353,353,337,337,1101184686,14244,18,976015459,125169227,9210,9,1078595330,22589356,-102579871,102579871
2021-02-15,337,341,334,334,349086495,5728,6,331064495,18022000,4490,5,344771495,4315000,-13707000,13707000
2021-02-16,329,332,329,329,119046057,1486,4,48950279,70095778,770,4,117326139,1719918,-68375860,68375860
2021-02-17,324,324,324,324,33429211,1374,4,25074666,8354545,148,1,33309104,120107,-8234438,8234438
2021-02-20,319,319,319,319,21541962,987,1,17241962,4300000,75,0,21541962,0,-4300000,4300000
2021-02-21,317,317,317,317,6408927,487,0,6408927,0,25,1,6008927,400000,400000,-400000
2021-02-22,315,315,315,315,10249997,375,1,10207852,42145,37,1,10200164,49833,7688,-7688
2021-02-23,314,320,314,314,504496862,5680,8,420202638,84294224,7708,2,496526862,7970000,-76324224,76324224
2021-02-24,312,319,308,308,113834945,2740,2,113034945,800000,1580,2,109517494,4317451,3517451,-3517451
2021-02-27,305,305,305,305,103082827,889,3,11740113,91342714,455,1,103080827,2000,-91340714,91340714
2021-02-28,299,299,299,299,6485723,461,0,6485723,0,25,2,5685723,800000,800000,-800000
2021-03-01,298,298,298,298,55586986,1018,4,15184986,40402000,175,4,53557966,2029020,-38372980,38372980
2021-03-02,292,302,292,292,511161169,9212,9,448225869,62935300,7229,10,502342316,8818853,-54116447,54116447
2021-03-03,288,292,288,288,72384232,1793,1,72367232,17000,716,1,71228446,1155786,1138786,-1138786
2021-03-06,284,284,284,284,11429926,843,0,11429926,0,47,2,10600248,829678,829678,-829678
2021-03-07,282,286,282,282,357238450,4792,8,322855444,34383006,3848,0,357238450,0,-34383006,34383006
2021-03-08,280,292,278,289,972728461,13918,14,882029727,90698734,15330,14,949221385,23507076,-67191658,67191658
2021-03-09,293,299,279,280,656499884,9064,15,603507702,52992182,10878,12,620160320,36339564,-16652618,16652618
2021-03-10,284,284,284,284,50839714,1836,0,50839714,0,460,0,50839714,0,0,0
2021-03-13,279,287,279,282,806979323,11483,15,767916812,39062511,9379,10,774049468,32929855,-6132656,6132656
2021-03-14,288,297,285,294,1577658368,11777,14,1516043529,61614839,15590,21,1337040324,240618044,179003205,-179003205
2021-03-15,293,298,288,288,790889165,11248,18,737011165,53878000,8232,8,774284665,16604500,-37273500,37273500
2021-03-16,289,307,288,306,719459978,7719,12,646037163,73422815,8676,13,657385043,62074935,-11347880,11347880
2021-03-17,308,309,295,297,648871386,10128,14,625767515,23105832,5537,11,586688282,62185065,39079233,-39079233
2021-03-27,297,317,293,314,878226906,9497,5,855400896,22826010,10505,12,787008406,91218500,68392490,-68392490
2021-03-28,314,321,305,307,343600591,6386,5,338770591,4830000,4283,5,328703185,14897406,10067406,-10067406
2021-03-30,311,311,306,306,123895903,3241,5,117503597,6392306,1156,0,123895903,0,-6392306,6392306
2021-03-31,301,304,301,301,78264146,1729,6,62799146,15465000,560,1,78121849,142297,-15322703,15322703
2021-04-03,295,295,295,295,22306197,806,2,17271197,5035000,55,0,22306197,0,-5035000,5035000
2021-04-04,293,293,293,293,21634453,659,1,11634453,10000000,87,0,21634453,0,-10000000,10000000
2021-04-05,291,291,291,291,61027532,1689,2,46027532,15000000,167,1,60227532,800000,-14200000,14200000
2021-04-06,288,297,286,286,379566063,6765,11,355624833,23941230,4338,1,379366063,200000,-23741230,23741230
2021-04-07,282,286,282,282,56038847,1799,4,55806747,232100,739,1,55638847,400000,167900,-167900
2021-04-10,278,278,278,278,20540882,1179,0,20540882,0,40,0,20540882,0,0,0
2021-04-11,275,275,275,275,94142350,1939,3,59275107,34867243,394,3,89735672,4406678,-30460565,30460565
2021-04-12,272,277,271,273,594386551,7637,9,572364941,22021610,7233,10,565140464,29246087,7224477,-7224477
2021-04-13,279,286,272,277,544207657,7965,8,537843782,6363875,8030,8,518304150,25903507,19539632,-19539632
2021-04-14,277,279,273,273,350945824,4559,9,263608729,87337095,4352,7,344038871,6906953,-80430142,80430142
2021-04-17,269,272,269,269,69042105,1286,2,68954134,87971,557,2,68912748,129357,41386,-41386
2021-04-18,265,265,265,265,9610242,606,1,8724642,885600,29,0,9610242,0,-885600,885600
2021-04-19,264,267,264,266,275315500,2537,9,153111036,122204464,3483,2,275301585,13915,-122190549,122190549
2021-04-20,262,268,259,259,698146095,9434,18,658661239,39484856,6940,11,681255497,16890598,-22594258,22594258
2021-04-21,258,260,254,254,214824503,3484,7,183073189,31751314,2024,3,213624503,1200000,-30551314,30551314
2021-04-24,247,252,247,247,318688740,4236,6,283886360,34802380,2584,4,306243740,12445000,-22357380,22357380
2021-04-25,240,240,240,240,19186276,982,1,19146276,40000,47,1,18386276,800000,760000,-760000
2021-04-26,238,242,238,239,766152856,8723,11,665070537,101082319,5066,12,720468570,45684286,-55398033,55398033
2021-04-27,241,249,237,239,661773678,7172,11,616160923,45612755,6658,13,589255360,72518318,26905563,-26905563
2021-04-28,242,257,238,254,807459265,6097,17,663599224,143860041,7793,16,695868637,111590628,-32269413,32269413
2021-05-01,251,258,242,242,590218523,6087,15,512503844,77714679,2655,5,585408523,4810000,-72904679,72904679
2021-05-02,240,240,240,240,19594911,864,0,19594911,0,58,3,18394911,1200000,1200000,-1200000
2021-05-03,237,237,237,237,19545141,817,0,19545141,0,45,4,17945141,1600000,1600000,-1600000
2021-05-05,235,239,235,235,769114887,8948,17,696889334,72225553,4700,24,721827383,47287504,-24938049,24938049
2021-05-08,235,238,228,228,149119762,2309,4,112598736,36521026,1504,2,146469762,2650000,-33871026,33871026
2021-05-09,223,223,223,223,61487751,826,2,16277751,45210000,114,2,60487751,1000000,-44210000,44210000
2021-05-10,216,226,216,223,784428921,7236,10,717763953,66664968,7162,11,767054855,17374066,-49290902,49290902
2021-05-11,225,232,216,232,635037324,5897,8,614837490,20199834,6690,10,570269079,64768245,44568411,-44568411
2021-05-12,237,239,222,222,601320806,7712,11,498611054,102709752,5306,4,598810026,2510780,-100198972,100198972
2021-05-15,221,236,221,226,355840919,4014,7,332890919,22950000,4545,10,347689605,8151314,-14798686,14798686
2021-05-16,227,241,226,241,1000997689,2598,5,988548294,12449395,8414,13,854997078,146000611,133551216,-133551216
2021-05-17,245,248,228,228,709214458,6999,10,694368262,14846196,3826,5,703908978,5305480,-9540716,9540716
2021-05-18,227,232,225,225,783602778,7076,8,653102778,130500000,3516,8,769887477,13715301,-116784699,116784699
2021-05-19,222,226,215,215,261264767,4568,8,241655281,19609486,1962,4,256607782,4656985,-14952501,14952501
2021-05-22,206,211,206,206,564902266,5018,9,350746639,214155627,3122,3,563502198,1400068,-212755559,212755559
2021-05-23,200,205,196,196,413418982,4514,9,364640882,48778100,3162,7,396096848,17322134,-31455966,31455966
2021-05-24,189,197,189,194,75980956,713,4,65365956,10615000,897,3,75734699,246257,-10368743,10368743
2021-05-25,200,200,198,200,51893654,909,0,51893654,0,603,2,42493654,9400000,9400000,-9400000
2021-05-26,201,204,194,197,329776979,4367,11,290340201,39436778,6976,8,314555492,15221487,-24215291,24215291
2021-05-29,201,208,199,208,437004822,2549,5,422804822,14200000,4050,9,375945241,61059581,46859581,-46859581
2021-05-30,217,218,204,208,621306060,8479,8,609624892,11681168,5379,10,591184942,30121118,18439950,-18439950
2021-05-31,207,213,203,203,495087332,5171,6,370456675,124630657,3232,5,492761963,2325369,-122305288,122305288
2021-06-01,198,206,195,197,290490707,4491,8,252597129,37893578,2751,2,290270707,220000,-37673578,37673578
2021-06-02,198,208,195,208,367809664,3601,5,348766754,19042910,4344,9,353210171,14599493,-4443417,4443417
2021-06-07,209,215,206,215,474768172,2853,3,471968172,2800000,5022,7,391892425,82875747,80075747,-80075747
2021-06-08,219,223,218,223,1095307396,4837,16,892322024,202985372,7706,14,1013974893,81332503,-121652869,121652869
2021-06-09,224,234,218,229,897470170,6834,15,770850439,126619731,7657,10,860109020,37361150,-89258581,89258581
2021-06-12,231,235,218,221,420054960,5077,9,373625984,46428976,4056,4,411182087,8872873,-37556103,37556103
2021-06-13,221,235,218,233,543131642,4192,12,471874039,71257603,5336,12,517760834,25370808,-45886795,45886795
2021-06-14,234,240,234,240,959178880,2855,12,851682410,107496470,6469,22,789125786,170053094,62556624,-62556624
2021-06-15,247,252,235,237,1106546626,8996,14,1029886435,76660191,8166,22,1064945143,41601483,-35058708,35058708
2021-06-16,237,249,235,239,600003850,5468,15,571209793,28794057,5487,10,583427510,16576340,-12217717,12217717
2021-06-19,239,246,231,236,563270598,6447,13,504593907,58676691,4368,8,554300471,8970127,-49706564,49706564
2021-06-20,238,242,226,226,620400598,8455,11,549789942,70610656,3159,6,597177314,23223284,-47387372,47387372
2021-06-21,219,240,219,240,760400987,4673,6,738897476,21503511,7456,14,656661677,103739310,82235799,-82235799
2021-06-22,241,246,240,246,1114100519,6404,23,960697847,153402672,6833,15,953005783,161094736,7692064,-7692064
2021-06-23,248,257,242,246,919563670,11360,20,831220268,88343402,7236,21,855282801,64280869,-24062533,24062533
2021-06-26,247,255,243,246,722082093,10011,13,671890359,50191734,6429,14,693428688,28653405,-21538329,21538329
2021-06-27,245,261,244,259,1145837717,10315,20,1047606739,98293872,10835,24,1087486345,58414266,-39879606,39879606
2021-06-28,257,261,250,253,532164484,8139,11,501108704,31055780,5566,5,528771083,3393401,-27662379,27662379
2021-06-29,252,264,252,254,483266906,6511,8,470566216,12700690,5306,12,478560910,4705996,-7994694,7994694
2021-06-30,254,262,252,253,499708692,6265,7,491488692,8230000,5241,13,486890720,12827972,4597972,-4597972
2021-07-03,253,256,243,243,579706080,7144,12,456690505,123015575,4430,7,573176207,6529873,-116485702,116485702
2021-07-04,239,251,235,242,343253686,5156,7,313488640,29765046,4366,7,328053686,15200000,-14565046,14565046
2021-07-05,243,250,240,247,304581664,4273,4,296322179,8259485,3763,7,293026846,11554818,3295333,-3295333
2021-07-06,249,254,245,245,358708701,5497,2,352920514,5788187,4028,6,342820124,15888577,10100390,-10100390
2021-07-07,247,250,240,243,276970044,4227,6,231970044,45000000,3450,5,252167395,24802649,-20197351,20197351
2021-07-10,241,245,234,237,296138087,4582,10,242037663,54100424,3836,4,291068693,5069394,-49031030,49031030
2021-07-11,236,250,235,249,496798035,4786,21,341273538,155524497,6043,5,478313104,18484931,-137039566,137039566
2021-07-12,248,252,242,242,315068306,4772,10,295025019,20043287,4355,10,307809057,7259249,-12784038,12784038
2021-07-13,242,248,238,240,323511997,4324,13,269165439,54346558,4073,4,320311845,3200152,-51146406,51146406
2021-07-14,241,250,239,248,421719088,4765,7,412442639,9276449,5876,11,406929073,14790015,5513566,-5513566
2021-07-17,250,251,241,242,445324854,6213,6,408208824,37116030,4842,5,443276836,2048018,-35068012,35068012
2021-07-18,246,247,238,238,542502856,6214,11,445362609,97140247,5133,6,535969974,6532882,-90607365,90607365
2021-07-31,239,246,233,236,449178311,6828,3,444041909,5136402,3751,11,418136225,31042086,25905684,-25905684
2021-08-01,235,243,233,234,478794976,7087,13,438675559,40119417,5766,8,472124694,6670282,-33449135,33449135
2021-08-02,241,248,239,242,526439650,6072,11,506576957,19862693,6686,10,508361896,18077754,-1784939,1784939
2021-08-03,241,242,233,235,397514690,6778,8,386482415,11032275,4667,4,373352721,24161969,13129694,-13129694
2021-08-04,235,238,230,231,408172024,6745,15,378498480,29673544,4661,8,389630021,18542003,-11131541,11131541
2021-08-07,234,241,234,236,332572824,4823,10,303961384,28611440,4634,3,324533080,8039744,-20571696,20571696
2021-08-08,235,240,232,233,281489324,4848,7,276201731,5287593,3862,9,272494050,8995274,3707681,-3707681
2021-08-09,231,243,231,239,474797771,5281,12,449674156,25123615,6150,6,462058215,12739556,-12384059,12384059
2021-08-10,240,242,237,238,361611689,4413,9,348568318,13043371,4646,6,347740559,13871130,827759,-827759
2021-08-11,241,244,237,242,476978144,6751,11,451200833,25777311,6500,11,452073730,24904414,-872897,872897
2021-08-14,245,252,245,252,1267875780,9626,20,1165204143,102801637,11120,15,1107106893,160898887,58097250,-58097250
2021-08-14,252,252,252,252,115000,9626,20,1165204143,102801637,11120,15,1107106893,160898887,58097250,-58097250
2021-08-15,255,264,252,260,751074175,9253,25,624944465,126129710,7073,19,724745826,26328349,-99801361,99801361
2021-08-22,269,271,266,271,1088269627,6687,17,1035689593,52580034,9368,23,849941590,238328037,185748003,-185748003
2021-08-23,276,276,265,267,724953081,10554,16,677230235,47722846,7720,16,684977842,39975239,-7747607,7747607
2021-08-24,267,282,267,277,589767123,7277,22,527945016,61840607,6465,12,555791347,33994276,-27846331,27846331
2021-08-25,279,286,268,281,521810894,7334,18,487917872,33893022,7324,11,512434806,9376088,-24516934,24516934
2021-08-28,283,292,282,292,622213023,3164,16,550180376,72032647,5852,17,442087188,180125835,108093188,-108093188
2021-08-29,296,299,277,277,1031487572,14319,23,873892927,157594645,9780,13,1013044196,18443376,-139151269,139151269
2021-08-30,273,279,272,272,466287647,5423,9,309344878,156942769,3945,10,435455829,30831818,-126110951,126110951
2021-08-31,260,271,259,260,768809329,9448,19,547234140,221575189,7047,15,751850519,16958810,-204616379,204616379
2021-09-01,259,268,253,267,411681514,6810,17,383654544,28026970,4663,5,392569267,19112247,-8914723,8914723
2021-09-04,270,273,261,263,399876306,6260,6,378226304,21650002,5157,9,387015927,12860379,-8789623,8789623
2021-09-05,261,274,256,270,529526026,5370,11,483460907,46065119,6364,14,461737655,67788371,21723252,-21723252
2021-09-06,269,274,257,259,443119585,6005,11,410093067,33026518,7026,10,421569974,21549611,-11476907,11476907
2021-09-07,258,259,252,252,517964021,6713,13,485231899,32732122,7966,8,491592597,26371424,-6360698,6360698
2021-09-08,254,261,252,257,331638818,4095,11,318944650,12694168,11696,15,298591418,33047400,20353232,-20353232
2021-09-11,259,266,248,249,272742264,5144,5,260463264,12279000,3662,11,259967929,12774335,495335,-495335
2021-09-12,251,253,241,241,389901970,8905,13,324658296,65243674,3220,3,385900612,4001358,-61242316,61242316
2021-09-13,251,251,233,245,513769623,7041,13,488637542,25132081,6341,9,418567059,95202564,70070483,-70070483
2021-09-14,247,254,245,250,272301177,4210,9,259424609,12877318,6049,5,253379880,18922047,6044729,-6044729
2021-09-15,255,255,242,245,275604247,4241,7,253085182,22519065,9148,7,262458895,13145352,-9373713,9373713
2021-09-18,241,245,235,235,405765975,8316,12,325377815,80388160,3130,3,394145975,11620000,-68768160,68768160
2021-09-19,231,241,224,230,419546032,6132,13,344189428,75356604,5265,5,415633784,3912248,-71444356,71444356
2021-09-20,232,233,224,226,300781914,4936,9,220633130,80148784,3582,4,293687393,7094521,-73054263,73054263
2021-09-21,225,228,217,219,389768230,7401,11,297325742,92442488,3612,8,375151395,14616835,-77825653,77825653
2021-09-22,218,220,208,218,375280645,7727,6,303376760,71903885,5027,17,370087141,5193504,-66710381,66710381
2021-09-25,224,224,216,224,331653590,5823,7,283250640,48402950,4253,10,250914875,80738715,32335765,-32335765
2021-09-26,225,225,215,217,179253417,4402,5,172326362,6927055,2836,5,164500648,14752769,7825714,-7825714
2021-09-28,219,221,212,214,204119284,4651,7,189216234,14903050,3061,2,202615432,1503852,-13399198,13399198
2021-09-29,218,220,212,216,248077772,3988,4,215710126,32367646,3027,7,236146575,11931197,-20436449,20436449
2021-10-02,218,221,214,214,462281079,7221,8,449867696,12413383,3966,7,452048045,10233034,-2180349,2180349
2021-10-03,215,227,211,227,632704827,5312,12,604072625,28632202,6732,11,556708873,75995954,47363752,-47363752
2021-10-04,228,230,224,227,372926185,5209,13,351346260,21579925,4265,9,347292551,25633634,4053709,-4053709
2021-10-06,227,232,225,228,326550410,3409,10,274313245,52237165,3793,7,306704507,19845903,-32391262,32391262
2021-10-09,229,229,217,218,246309483,4794,7,209478610,36830873,2559,3,246289064,20419,-36810454,36810454
2021-10-10,212,221,212,221,202202655,2505,8,139301363,62901292,2618,4,200241506,1961149,-60940143,60940143
2021-10-11,220,221,212,213,177081163,2983,4,170826396,6254767,2503,4,176150608,930555,-5324212,5324212
2021-10-12,211,213,205,205,411410456,6193,7,309208931,102201525,2841,6,391819237,19591219,-82610306,82610306
2021-10-13,201,208,196,204,296818674,3953,12,216146552,80672122,2945,3,289763395,7055279,-73616843,73616843
2021-10-16,205,210,204,209,190108612,3242,7,183931290,6177322,2878,8,171027728,19080884,12903562,-12903562
2021-10-17,209,209,198,199,280797871,4322,5,231966589,48831282,2868,4,259128590,21669281,-27162001,27162001
2021-10-18,197,206,194,204,281428154,2908,11,200494470,80933684,3280,8,264388180,17039974,-63893710,63893710
2021-10-19,207,211,204,211,425344518,2434,10,363124060,62220458,4404,8,397856195,27488323,-34732135,34732135
2021-10-20,210,213,203,204,203667935,2889,7,194054100,9613835,2350,4,201980138,1687797,-7926038,7926038
2021-10-23,204,204,197,197,370691245,6506,12,355350806,15340439,2758,4,369123507,1567738,-13772701,13772701
2021-10-25,194,204,192,197,310265793,3742,6,298136487,12129306,3987,9,299808118,10457675,-1671631,1671631
2021-10-26,197,203,196,198,231812369,2976,3,220412369,11400000,3096,4,223914824,7897545,-3502455,3502455
2021-10-27,200,204,198,200,219905018,2854,5,214023652,5881366,3023,6,204615079,15289939,9408573,-9408573
2021-10-30,203,203,191,196,402885513,4405,8,277331505,125554008,4113,9,394081688,8803825,-116750183,116750183
2021-10-31,193,193,184,185,449967168,4474,9,251811931,198155237,3098,8,416121718,33845450,-164309787,164309787
2021-11-01,191,194,188,194,152632403,444,0,152632403,0,2246,6,142700145,9932258,9932258,-9932258
2021-11-02,200,204,198,204,318838776,1245,9,276507450,42331326,2897,8,303939463,14899313,-27432013,27432013
2021-11-03,212,212,208,212,447813942,1411,6,426735419,21078523,3254,5,439706042,8107900,-12970623,12970623
2021-11-06,223,223,223,223,45605168,135,8,42405192,3199976,1428,6,44088041,1517127,-1682849,1682849
2021-11-07,230,230,224,230,2016353606,7641,30,1904794107,111559499,14092,33,1824617198,191736408,80176909,-80176909
2021-11-08,232,241,232,241,1856803942,8812,17,1776297104,80506838,11861,38,1641716098,215087844,134581006,-134581006
2021-11-09,241,252,231,241,1532746439,9284,22,1456358594,76387845,11296,28,1358006317,174740122,98352277,-98352277
2021-12-08,262,265,257,258,673000683,3487,15,593170509,79830174,3953,30,549287218,123713465,43883291,-43883291
2021-12-11,263,271,248,249,1299565455,8916,27,1195114382,104451073,11965,24,1228428099,71137356,-33313717,33313717
2021-12-12,247,250,244,244,784137031,4446,16,476569046,307567985,3639,4,781320031,2817000,-304750985,304750985
2021-12-13,241,247,232,232,515929437,4432,13,476561353,39368084,3856,15,487329319,28600118,-10767966,10767966
2021-12-14,226,232,226,226,809024025,5689,13,648613530,160410495,3963,7,798209659,10814366,-149596129,149596129
2021-12-15,222,229,215,218,733471286,5350,14,615211387,118270899,4771,10,714417033,19065253,-99205646,99205646
2021-12-18,224,231,222,231,701269890,4265,11,691509486,9760404,6178,14,634541797,66728093,56967689,-56967689
2021-12-19,231,232,218,218,438255155,4560,8,408017081,30238074,2343,7,436128651,2126504,-28111570,28111570
2021-12-20,217,225,212,221,370934374,3170,10,303724975,67209399,3563,8,363723144,7211230,-59998169,59998169
2021-12-21,222,226,218,219,241912083,2436,8,220782117,21129966,2293,4,240941012,971071,-20158895,20158895
2021-12-22,222,233,221,233,503112829,3109,6,498389250,4723579,4729,12,479043645,24069184,19345605,-19345605
2021-12-25,235,238,223,224,477969324,4923,17,456853377,21115947,3993,15,471519672,6449652,-14666295,14666295
2021-12-26,225,227,219,226,278809739,3235,13,262404974,16404765,2853,2,275204739,3605000,-12799765,12799765
2021-12-27,227,235,226,231,647168553,3559,12,632890802,14277751,6180,14,616973067,30195486,15917735,-15917735
2021-12-28,233,243,230,238,473588868,3589,10,424410665,49178203,4275,11,455015526,18573342,-30604861,30604861
2021-12-29,237,242,229,232,433094222,3982,10,419810901,13283321,3330,6,398806612,34287610,21004289,-21004289
2022-01-01,227,229,223,223,483417009,6226,17,435639939,47777070,2331,8,475205048,8211961,-39565109,39565109
2022-01-02,221,227,219,222,312005308,4015,9,291324853,20680455,2671,5,306270904,5734404,-14946051,14946051
2022-01-03,223,227,216,218,243415136,3009,8,222541103,20874033,2242,4,235943147,7471989,-13402044,13402044
2022-01-04,218,221,210,215,313410783,4188,15,273823491,39587292,2496,1,313404624,6159,-39581133,39581133
2022-01-05,212,220,212,216,206261695,2220,3,194518471,11743224,2242,4,202538733,3722962,-8020262,8020262
2022-01-08,218,226,216,226,823489624,2592,14,703246413,120243211,7215,12,789398631,34090993,-86152218,86152218
2022-01-09,229,233,221,226,546084675,3638,20,508314758,37769917,4396,12,513690827,32393848,-5376069,5376069
2022-01-10,226,239,224,239,734256431,2735,18,705011595,29244836,7204,16,693210708,41045723,11800887,-11800887
2022-01-11,241,247,237,241,694270995,4431,22,638156008,56114987,6218,18,665368062,28902933,-27212054,27212054
2022-01-12,240,248,236,239,423615268,3184,9,380775831,42839437,4105,15,409963061,13652207,-29187230,29187230
2022-01-15,234,235,230,230,413306584,3387,14,270040031,143266553,2583,8,405786932,7519652,-135746901,135746901
2022-01-16,227,237,221,234,314510393,2685,13,288863786,25646607,3493,9,298474314,16036079,-9610528,9610528
2022-01-17,234,242,234,235,548835115,2816,12,393603802,155231313,5809,16,523843729,24991386,-130239927,130239927
2022-01-18,234,236,227,227,234613428,2389,10,175421114,59192314,1167,0,234613428,0,-59192314,59192314
2022-01-19,226,234,222,229,259186005,2220,9,218041913,41144092,2439,2,259036753,149252,-40994840,40994840
2022-01-22,231,235,218,220,267244612,2584,8,223611962,43632650,2520,8,265540497,1704115,-41928535,41928535
2022-01-23,218,226,214,224,293501295,2494,12,228411867,65089428,2807,3,291151295,2350000,-62739428,62739428
2022-01-24,226,229,220,223,219103478,1855,8,202748336,16355142,2467,10,180286828,38816650,22461508,-22461508
2022-01-25,213,219,213,216,345618870,2782,13,308537690,37081180,1417,9,321153539,24465331,-12615849,12615849
2022-01-26,221,224,215,224,463598451,2500,12,414858241,48740210,3530,11,432816248,30782203,-17958007,17958007
2022-01-29,229,234,226,234,357191539,1217,9,304614233,52577306,3166,9,330323514,26868025,-25709281,25709281
2022-01-30,239,243,230,232,450022759,3654,11,384028825,65993973,3734,9,429928890,20093908,-45900065,45900065
2022-01-31,228,247,228,247,559313274,1693,13,496728567,62584707,5231,16,458758863,100554411,37969704,-37969704
2022-02-01,255,255,245,246,1194512914,6475,37,1058333788,136179126,7481,31,1101811735,92701179,-43477947,43477947
2022-02-02,247,255,243,248,537977376,4430,22,447471498,90512961,5185,13,511093898,26890561,-63622400,63622400
2022-02-05,255,258,246,247,412430336,3535,15,350500187,61933549,3903,6,404567691,7866045,-54067504,54067504
2022-02-06,246,249,239,239,266448977,2690,11,211601403,54847574,1692,0,266448977,0,-54847574,54847574
2022-02-07,231,240,229,231,586555002,4523,19,430412447,156142555,3645,12,559252011,27302991,-128839564,128839564
2022-02-08,232,244,232,240,431824844,2858,10,388848406,42976438,4850,18,408947503,22877341,-20099097,20099097
2022-02-09,242,253,238,246,540064199,3155,18,469926843,70137356,6146,21,470779620,69284579,-852777,852777
2022-02-12,245,248,235,236,362279455,3274,20,310186964,52092491,3193,2,359022588,3256867,-48835624,48835624
2022-02-13,234,238,233,234,195537795,2200,8,186013585,9524210,2171,3,194924295,613500,-8910710,8910710
2022-02-14,234,241,234,237,208622122,1546,8,189501956,19120166,2298,10,194197426,14424696,-4695470,4695470
2022-02-16,237,239,232,233,232710900,2607,10,176142802,56568098,2162,3,230607924,2102976,-54465122,54465122
2022-02-19,237,246,237,240,351818563,2386,18,263196311,88622252,4110,14,326158329,25660234,-62962018,62962018
2022-02-20,240,248,238,247,275065485,2023,10,226080015,48985470,3141,9,252712941,22352544,-26632926,26632926
2022-02-21,249,255,249,255,820746120,1710,14,677964432,142781688,5852,23,617950985,202795135,60013447,-60013447
2022-02-22,259,261,251,253,575758881,3918,17,526984170,48774711,5087,11,547364458,28394423,-20380288,20380288
2022-02-23,255,266,253,261,520348181,3194,18,468471531,51876650,4604,15,452877157,67471024,15594374,-15594374
2022-02-26,252,257,248,248,562764795,4517,20,471813178,90951617,2995,9,468038491,94726304,3774687,-3774687
2022-02-27,245,254,242,251,355978350,2797,11,290409027,65569323,3141,8,340472873,15505477,-50063846,50063846
2022-02-28,252,256,249,252,298637364,2190,11,202614419,96022945,2521,16,230683171,67954193,-28068752,28068752
2022-03-02,250,252,239,242,398292706,4512,12,356865992,41426714,2807,8,390430352,7862354,-33564360,33564360
2022-03-05,253,255,250,255,553300580,1042,9,480969982,72330598,3976,19,306394997,246905583,174574985,-174574985
2022-03-06,259,266,253,260,766195997,4378,24,658315182,107880815,5894,21,599564472,166631525,58750710,-58750710
2022-03-07,260,263,252,252,514962523,4240,20,421405031,93557492,3854,10,488063126,26899397,-66658095,66658095
2022-03-08,247,255,245,247,349014769,3716,10,319020325,29994444,2478,7,346128682,2886087,-27108357,27108357
2022-03-09,251,261,251,261,684192797,2619,16,622793732,61399065,6243,25,556201006,127991791,66592726,-66592726
2022-03-12,245,249,245,246,1005308423,7786,14,643836628,361471795,3733,19,939055283,66253140,-295218655,295218655
2022-03-13,242,249,241,245,333203849,2909,14,240782225,92421624,2257,9,302828980,30374869,-62046755,62046755
2022-03-14,246,251,245,247,226019444,1598,14,176692026,49327418,2710,8,200688444,25331000,-23996418,23996418
2022-03-15,248,260,247,255,672275867,2513,23,516336460,155939407,5643,18,562516529,109759338,-46180069,46180069
2022-03-16,267,269,267,269,479191031,527,11,389116205,90074826,4541,12,337093475,142097556,52022730,-52022730
2022-03-19,282,282,282,282,310791432,364,10,270745432,40046000,2936,14,178508360,132283072,92237072,-92237072
2022-03-26,296,296,282,285,1216916657,7814,46,1041427142,175489515,7657,20,1155127746,61788911,-113700604,113700604
2022-03-27,285,304,281,296,1189151897,7985,28,1099657463,89494434,7954,28,1132074983,57076914,-32417520,32417520
2022-03-28,288,308,287,302,1172187240,8880,31,1085701380,86485860,7223,26,1066318276,105868964,19383104,-19383104
2022-03-29,305,306,286,286,1158765837,11033,28,1077510247,81255590,6041,16,1132302589,26463248,-54792342,54792342
2022-03-30,282,300,279,296,962901083,7100,20,917351642,45549441,7132,18,915594249,47306834,1757393,-1757393
2022-04-03,297,305,297,305,1581037953,6179,38,1458443380,122594573,8978,39,1117034612,464003341,341408768,-341408768
2022-04-04,308,320,294,298,1764309575,12308,49,1595138563,169171012,10391,35,1600650486,163659089,-5511923,5511923
2022-04-05,299,318,297,311,1183322006,8901,23,1068856086,114465920,7905,38,1058764957,124557049,10091129,-10091129
2022-04-06,315,315,295,295,1246435605,11383,30,1100060580,146375025,5988,21,1197056973,49378632,-96996393,96996393
2022-04-09,288,297,286,289,1161664780,11253,30,988291932,173372848,6690,16,1121867876,39796904,-133575944,133575944
2022-04-10,289,304,289,304,1609652049,5883,26,1383972949,225679100,10657,37,1286150811,323501238,97822138,-97822138
2022-04-11,308,308,295,295,666769062,5792,20,552646139,114122923,4513,16,581462989,85306073,-28816850,28816850
2022-04-12,295,298,286,286,339370762,4598,10,294984222,44386540,1304,4,324654589,14716173,-29670367,29670367
2022-04-13,274,290,274,285,556316605,5349,23,506546048,49770557,4427,8,550635591,5681014,-44089543,44089543
2022-04-16,288,293,280,283,444204433,4394,17,396456532,47747901,3678,10,434443241,9761192,-37986709,37986709
2022-04-17,284,287,271,282,498306507,5737,17,455013695,43292812,4327,10,475111065,23195442,-20097370,20097370
2022-04-18,283,291,276,277,435983545,5096,13,412982346,23001199,3813,16,418933407,17050138,-5951061,5951061
2022-04-19,277,287,276,283,405171916,4494,16,381518160,23653756,3284,8,401223978,3947938,-19705818,19705818
2022-04-20,286,292,278,285,657626011,5572,20,610694156,57100244,4737,19,629006669,38787731,-18312513,18312513
2022-04-24,290,293,282,282,473930782,4648,18,442798635,31132147,3985,14,446593131,27337651,-3794496,3794496
2022-04-25,285,288,280,285,465717214,3546,27,367953677,97763537,2685,11,361321214,104396000,6632463,-6632463
2022-04-26,288,299,286,295,862832399,5870,24,766744873,96087526,6531,31,714486245,148346154,52258628,-52258628
2022-04-27,298,303,286,287,680333278,5752,23,577338866,102994412,6002,13,656244407,24088871,-78905541,78905541
2022-04-30,288,292,280,281,706515517,6684,21,656392855,50122662,4723,14,688833893,17681624,-32441038,32441038
2022-05-01,282,290,278,278,487473048,5813,16,442041579,45431469,3617,19,391300022,96173026,50741557,-50741557
2022-05-02,282,290,278,285,385671344,3420,14,313403519,72366459,3744,10,346826079,38943899,-33422560,33422560
2022-05-02,280,280,280,280,98634,3420,14,313403519,72366459,3744,10,346826079,38943899,-33422560,33422560
2022-05-07,286,290,281,284,492851215,4366,11,430065662,62785553,4392,10,444993431,47857784,-14927769,14927769
2022-05-08,287,295,286,289,453590502,3793,15,401990940,51599562,4680,19,405103156,48487346,-3112216,3112216
2022-05-09,292,295,281,282,433516516,4059,15,369870071,63646445,4295,12,418065855,15450661,-48195784,48195784
2022-05-10,283,291,282,288,282130340,2959,11,225904336,56226004,3194,4,279232541,2897799,-53328205,53328205
2022-05-11,291,294,287,289,438800319,3729,15,409745073,29055246,4294,11,431049661,7750658,-21304588,21304588
2022-05-14,288,292,276,278,1078017907,12156,28,1022311120,55706787,8117,18,1022823979,55193928,-512859,512859
2022-05-15,275,286,268,284,647773287,6316,15,607718202,40055085,6954,18,620113592,27659695,-12395390,12395390
2022-05-16,288,292,281,283,462839338,4680,25,419673366,43165972,6400,19,423403896,39435442,-3730530,3730530
2022-05-17,286,290,276,278,380050890,4711,9,340282167,39768723,4222,20,342307888,37743002,-2025721,2025721
2022-05-18,282,289,278,279,353612344,3829,11,311114098,42548037,3844,15,337607012,16055123,-26492914,26492914
2022-05-18,281,281,281,281,49791,3829,11,311114098,42548037,3844,15,337607012,16055123,-26492914,26492914
2022-05-21,278,283,274,276,310230165,3046,13,230194148,80036017,2782,6,267867829,42362336,-37673681,37673681
2022-05-22,277,281,274,278,307525970,3248,14,244067584,63458386,2664,13,236348869,71177101,7718715,-7718715
2022-05-23,277,277,264,264,720657574,7672,15,580177282,140480292,3625,14,579573207,141084367,604075,-604075
2022-05-24,266,269,263,264,409717996,3698,7,301092683,108625313,2899,7,400584925,9133071,-99492242,99492242
2022-05-25,268,270,263,268,372740237,3595,7,312128169,60612068,2777,7,351393640,21346597,-39265471,39265471
2022-05-28,265,267,253,253,626364203,7038,17,464404632,161959571,2921,17,487827565,138536638,-23422933,23422933
2022-05-29,248,258,242,257,581594248,5415,17,490074269,91519979,4915,11,554253363,27340885,-64179094,64179094
2022-05-30,253,256,243,245,357285242,4279,9,318374807,38910435,3038,13,321806771,35478471,-3431964,3431964
2022-05-31,245,251,243,246,263705340,2859,8,240213303,23492037,2426,12,238157747,25547593,2055556,-2055556
2022-06-01,246,253,243,248,287344426,3174,8,259711705,27632721,2773,9,274942598,12401828,-15230893,15230893
2022-06-06,248,248,236,236,572986285,5797,19,391996008,180990277,3465,16,525222621,47763664,-133226613,133226613
2022-06-07,238,242,235,238,262634715,2868,12,198610770,64023945,2477,5,261574191,1060524,-62963421,62963421
2022-06-08,241,245,238,241,184022895,2076,7,163740916,20281979,2165,3,183920169,102726,-20179253,20179253
2022-06-11,239,241,229,231,257184739,3047,7,185165818,72018921,2523,6,210072127,47112612,-24906309,24906309
2022-06-12,233,244,229,239,298720182,2983,13,266500301,32219881,2891,6,267975366,30744816,-1475065,1475065
2022-06-13,241,250,241,250,447867774,3651,11,393823555,54044219,4436,12,375038259,72829515,18785296,-18785296
2022-06-14,252,256,244,247,461696991,3453,10,402176748,59520243,3190,4,460936172,760819,-58759424,58759424
2022-06-15,250,250,241,245,188360894,2101,9,159534367,28826527,1995,2,186360894,2000000,-26826527,26826527
2022-06-19,245,247,238,238,232196221,2436,5,193950403,38245818,1943,4,229610452,2585769,-35660049,35660049
2022-06-20,241,251,241,245,290672207,2610,9,254321515,36350692,3015,15,267688841,22983366,-13367326,13367326
2022-06-21,245,249,240,241,197577817,1936,5,170208607,27369210,2003,8,192262747,5315070,-22054140,22054140
2022-06-22,242,250,240,250,327209011,2404,3,301189160,26019851,3128,10,312194529,15014482,-11005369,11005369
2022-06-25,254,259,254,259,588415711,2926,12,539759850,48655861,5613,20,559415907,28999804,-19656057,19656057
2022-06-26,262,268,251,256,383347853,2858,20,311383333,71964520,3518,20,360304037,23043816,-48920704,48920704
2022-06-27,255,265,251,260,285569203,1686,10,208220696,77348507,3074,12,269100441,16468762,-60879745,60879745
2022-06-28,263,269,259,261,220826174,1825,7,207176373,13649801,2465,11,201164889,19661285,6011484,-6011484
2022-06-29,262,264,257,263,238239808,1337,6,144167720,94072088,2324,5,229284659,8955149,-85116939,85116939
2022-07-02,257,257,248,248,393394620,3377,16,233491778,159902842,2426,4,373554620,19840000,-140062842,140062842
2022-07-03,248,251,244,251,199603283,1668,5,145473739,54129544,1935,10,189523503,10079780,-44049764,44049764
2022-07-04,254,258,250,251,210424717,1622,5,154674717,55750000,2081,12,189012153,21412564,-34337436,34337436
2022-07-05,251,254,246,248,199180783,1784,8,102479703,96701080,1730,2,196380783,2800000,-93901080,93901080
2022-07-06,246,250,240,243,215444597,1938,10,171283902,44160695,1649,10,193882988,21561609,-22599086,22599086
2022-07-09,243,249,239,241,203063361,1633,9,100198052,102865309,1912,6,185548042,17515319,-85349990,85349990
2022-07-11,240,244,231,231,332423679,3477,16,239342120,93081559,2212,9,296560268,35863411,-57218148,57218148
2022-07-12,232,241,229,235,277518915,2415,12,262100675,15418240,2234,8,239414002,38104913,22686673,-22686673
2022-07-13,241,246,237,239,180446258,1723,10,152997498,27448760,1913,16,142305285,38140973,10692213,-10692213
2022-07-16,239,240,230,235,309682992,2591,9,218765883,90917109,2579,8,291858463,17824529,-73092580,73092580
2022-07-23,237,237,235,236,21255816,210,2,15255816,6000000,155,2,12444276,8811540,2811540,-2811540
2022-07-24,238,243,227,229,183548541,2393,4,177528541,6020000,2135,7,170075906,13472635,7452635,-7452635
2022-07-25,222,225,222,222,275289570,2958,9,154275004,121014566,1702,4,265282538,10007032,-111007534,111007534
2022-07-26,224,226,220,222,176883538,1653,8,110535674,66347864,1645,5,167054518,9829020,-56518844,56518844
2022-07-27,224,226,221,224,81490702,1083,2,68976343,12514359,1152,4,80578830,911872,-11602487,11602487
2022-07-30,226,226,213,214,154575743,2589,3,154267750,307993,1758,6,147519646,7056097,6748104,-6748104
2022-07-31,214,216,206,209,240516933,2895,12,215980757,24536176,1892,11,203419818,37097115,12560939,-12560939
2022-08-01,210,214,208,209,120200913,1716,8,109292191,10908722,1414,6,119197095,1003818,-9904904,9904904
2022-08-02,211,217,203,216,208528594,1913,5,178476639,30051955,1983,6,203782104,4746490,-25305465,25305465
2022-08-03,215,221,215,221,286276991,2059,7,263309780,22967211,2539,11,269266404,17010587,-5956624,5956624
2022-08-06,226,231,224,231,268675906,1197,6,227375906,41300000,2071,10,218625483,50050423,8750423,-8750423
2022-08-09,232,240,221,229,480358912,3875,14,428459033,51899879,3520,19,464112936,16245976,-35653903,35653903
2022-08-10,225,231,222,230,187369900,1709,4,175369900,12000000,1644,2,186943321,426579,-11573421,11573421
2022-08-13,234,237,234,237,166042982,433,1,159542982,6500000,1550,8,76092800,89950182,83450182,-83450182
2022-08-14,248,248,237,238,557537738,4286,12,509803580,47734158,3621,11,546290089,11247649,-36486509,36486509
2022-08-15,238,254,235,254,740679948,3755,20,682770889,57909059,5483,18,662610726,78069222,20160163,-20160163
2022-08-16,254,261,247,247,525065847,4511,17,482642086,42423761,3837,15,490509703,34556144,-7867617,7867617
2022-08-17,255,266,254,264,800125580,4424,23,679217807,120907773,5605,28,665197899,134927681,14019908,-14019908
2022-08-20,253,262,251,251,384616022,3126,8,361959279,22656743,3382,9,380961469,3654553,-19002190,19002190
2022-08-21,258,259,248,252,258437699,2274,11,236645604,21792095,1934,6,249975171,8462528,-13329567,13329567
2022-08-22,253,266,252,257,437135303,2536,17,376552772,60582531,3446,16,390674971,46460332,-14122199,14122199
2022-08-23,262,268,260,262,341745931,2171,10,325831785,15914146,2219,12,307528216,34217715,18303569,-18303569
2022-08-24,262,270,255,265,378888693,3002,12,359749319,19139374,3561,10,366499002,12389691,-6749683,6749683
2022-08-27,260,267,253,254,352621751,3187,16,317228402,35393349,3071,12,344378175,8243576,-27149773,27149773
2022-08-28,257,265,249,257,415451518,2998,16,332972480,82479038,2879,8,408745137,6706381,-75772657,75772657
2022-08-29,254,259,252,252,162759304,1703,8,138051586,24707718,1757,8,153069165,9690139,-15017579,15017579
2022-08-30,252,254,245,245,246762860,2128,12,195065915,51696945,1934,1,246362860,400000,-51296945,51296945
2022-08-31,245,252,243,251,173611441,1640,12,143334988,30276453,1879,4,171195441,2416000,-27860453,27860453
2022-09-03,245,247,237,237,280645925,2222,10,236253863,44392062,1917,6,260367714,20278211,-24113851,24113851
2022-09-04,239,247,237,242,154627340,1523,4,128921871,25705469,1699,8,152089481,2537859,-23167610,23167610
2022-09-05,243,246,241,242,115723200,1218,6,104923200,10800000,1266,2,115617200,106000,-10694000,10694000
2022-09-06,240,246,238,245,141429910,1174,5,89999264,51430646,1256,6,124625421,16804489,-34626157,34626157
2022-09-07,244,246,239,240,135184364,1054,7,93179883,42004481,1474,5,131419205,3765159,-38239322,38239322
2022-09-10,238,239,232,233,174826854,2187,12,156730283,18096571,1724,2,174666854,160000,-17936571,17936571
2022-09-11,233,237,230,231,170173101,1867,11,143254309,26918792,1382,7,154528769,15644332,-11274460,11274460
2022-09-12,231,240,230,238,197988102,1809,8,135506022,62482080,1693,7,171197507,26790595,-35691485,35691485
2022-09-13,240,246,237,246,314241772,1228,15,303061773,11179999,2251,11,198001914,116239858,105059859,-105059859
2022-09-14,249,252,245,245,261611356,1953,7,244283910,17327446,2492,10,247537046,14074310,-3253136,3253136
2022-09-18,243,247,238,239,172828459,1476,8,121030697,51797762,1703,3,169630635,3197824,-48599938,48599938
2022-09-19,240,244,236,237,150708863,1375,8,128113533,22595330,1378,7,141050709,9658154,-12937176,12937176
2022-09-20,237,240,231,233,161613718,1797,8,128556213,33057505,1187,3,160939699,674019,-32383486,32383486
2022-09-21,231,239,231,234,185015642,1570,7,130271690,54743952,1367,5,182497016,2518626,-52225326,52225326
2022-09-24,232,233,223,223,284340567,2548,5,218894768,65445799,1846,9,277286206,7054361,-58391438,58391438
2022-09-26,226,237,226,237,264414645,1294,7,182749053,81665592,2348,10,246978424,17436221,-64229371,64229371
2022-09-28,239,247,239,241,308292743,1512,5,178994793,129297950,2611,13,285629289,22663454,-106634496,106634496
2022-10-01,240,240,232,232,340165253,2152,6,170148735,170016518,1905,8,328267108,11898145,-158118373,158118373
2022-10-02,235,241,227,236,202901624,1286,7,118796663,84104961,2035,7,187543263,15358361,-68746600,68746600
2022-10-03,238,240,231,235,146917802,1140,7,92947624,53970178,1348,6,142349908,4567894,-49402284,49402284
2022-10-04,236,239,232,236,87199229,823,4,67875029,19324200,1163,5,81481246,5717983,-13606217,13606217
2022-10-08,237,241,232,233,177522869,1215,5,148552723,28970146,1567,9,158674376,18848493,-10121653,10121653
2022-10-09,237,240,231,232,174856370,1110,7,77294939,97561431,1563,3,166946446,7909924,-89651507,89651507
2022-10-10,234,236,230,233,115829495,973,8,79924050,35905445,1240,3,105964612,9864883,-26040562,26040562
2022-10-11,237,237,233,233,97769946,950,8,81445708,16324238,1171,10,93656667,4113279,-12210959,12210959
2022-10-12,235,236,233,234,109421259,730,3,61533871,47887388,1144,4,103011259,6410000,-41477388,41477388
2022-10-15,234,235,229,229,120958688,1243,11,94921463,26037225,1141,6,112718791,8239897,-17797328,17797328
2022-10-16,228,231,222,222,197764977,2005,6,134336749,63428228,1407,4,186278842,11486135,-51942093,51942093
2022-10-17,223,227,220,227,113644587,1121,1,84978959,28665628,1240,2,106344587,7300000,-21365628,21365628
2022-10-18,227,229,223,223,135772350,1300,4,112908869,22863481,992,2,135579288,193062,-22670419,22670419
2022-10-19,222,227,222,222,108836844,1124,5,57817216,51019628,1094,4,108426833,410011,-50609617,50609617
2022-10-22,223,225,220,221,145108436,1431,4,82577264,62531172,1206,3,134095636,11012800,-51518372,51518372
2022-10-23,224,227,221,223,134187595,1122,4,103672223,30515372,1416,9,108858706,25328889,-5186483,5186483
2022-10-24,222,224,218,220,113432530,1559,4,106702530,6730000,1307,3,112530155,902375,-5827625,5827625
2022-10-25,220,224,215,216,159077619,1507,4,106179307,52898312,1663,9,141237375,17840244,-35058068,35058068
2022-10-26,218,218,209,211,297365513,2674,7,202356979,95008534,1658,7,286401957,10963556,-84044978,84044978
2022-10-29,216,220,212,214,281636761,1495,5,139995164,141641597,1963,7,269103041,12533720,-129107877,129107877
2022-10-30,217,219,211,218,195797555,1058,8,86809935,108987620,1612,6,184050840,11746715,-97240905,97240905
2022-10-31,216,225,216,224,173219495,1303,6,166440977,6778518,1822,8,166611160,6608335,-170183,170183
2022-11-01,225,227,222,225,175012464,1012,5,118636887,56375577,1686,6,170893300,4119164,-52256413,52256413
2022-11-02,224,228,221,223,166293685,968,4,90198876,76094809,1810,5,161774497,4519188,-71575621,71575621
2022-11-05,224,235,224,229,268822841,1844,13,260885629,13634999,2414,12,257113923,17406705,3771706,-3771706
2022-11-06,230,242,229,242,382721636,1405,10,276259861,106461775,3715,15,326626663,56094973,-50366802,50366802
2022-11-07,249,249,247,249,177125562,301,1,176125562,1000000,1796,6,140119562,37006000,36006000,-36006000
2022-11-08,262,262,251,253,1032502281,4143,32,853471027,179031254,6096,22,927869241,104633040,-74398214,74398214
2022-11-09,252,269,250,261,737470631,3410,34,596432671,141037960,4706,11,691750431,45720200,-95317760,95317760
2022-11-12,262,264,254,255,418460537,2817,10,327733332,90727205,2819,10,400912722,17547815,-73179390,73179390
2022-11-13,253,259,250,253,358951733,2253,14,249667461,109284272,2637,4,354044357,4907376,-104376896,104376896
2022-11-14,254,257,248,248,294181747,1583,12,156293082,137888665,1943,7,292475042,1706705,-136181960,136181960
2022-11-15,256,261,253,256,294846203,1509,12,223965677,70880526,2463,6,291903880,2942323,-67938203,67938203
2022-11-16,258,262,253,258,282656203,1357,11,211617244,71038959,2470,9,274770023,7886180,-63152779,63152779
2022-11-19,257,263,248,263,430081222,1674,17,373905901,56175321,3100,11,419366736,10714486,-45460835,45460835
2022-11-20,269,269,269,269,480087551,494,4,466887551,13200000,2634,11,241799878,238287673,225087673,-225087673
2022-11-21,283,283,275,277,1832966753,5681,45,1476470109,356496644,9166,36,1592507900,240458853,-116037791,116037791
2022-11-22,276,292,275,287,865708480,4368,29,736891107,128817373,4841,18,790508715,75199765,-53617608,53617608
2022-11-23,286,288,277,277,512842115,3439,20,398315243,114602474,3072,11,447612655,65305062,-49297412,49297412
2022-11-26,286,296,285,290,887081433,3637,26,835531006,51550427,6453,44,727670310,159411123,107860696,-107860696
2022-11-27,291,302,288,301,531926531,2586,19,442577087,89349444,4551,19,467677490,64249041,-25100403,25100403
2022-11-28,301,302,291,291,436845601,2569,25,313900478,122945123,3401,14,408247329,28598272,-94346851,94346851
2022-11-29,294,297,285,287,469013117,3428,25,321066761,147946356,2862,14,454207803,14805314,-133141042,133141042
2022-11-30,288,289,280,281,330743390,2838,23,265583068,65160322,2337,11,320248967,10494423,-54665899,54665899
2022-12-03,278,287,277,286,268887080,2051,18,211459812,57427268,2438,7,264411431,4475649,-52951619,52951619
2022-12-04,290,297,287,297,864722407,3291,38,703146997,161575410,6133,28,697788919,166933488,5358078,-5358078
2022-12-05,300,300,290,290,393159955,2961,29,323517304,69642651,2575,10,357676327,35483628,-34159023,34159023
2022-12-06,293,304,291,299,437585246,2394,18,405697890,31887356,3479,24,405843394,31741852,-145504,145504
2022-12-07,304,313,302,305,790389506,4316,19,748953983,41435523,5996,32,653909755,136479751,95044228,-95044228
2022-12-10,306,309,294,295,691183256,3907,20,423932363,267250893,3798,14,658811132,32372124,-234878769,234878769
2022-12-11,299,299,292,293,418617961,2641,20,265579285,153038676,2516,18,366350629,52267332,-100771344,100771344
2022-12-12,296,300,293,295,370218835,2324,14,266637549,103581286,2352,11,347383641,22835194,-80746092,80746092
2022-12-13,299,308,297,299,434281116,3140,18,389755719,44525397,2928,18,378301147,55979969,11454572,-11454572
2022-12-14,301,313,298,305,467035775,2708,28,347038747,119997028,3754,16,379377293,87658482,-32338546,32338546
2022-12-17,305,312,302,306,322883569,2281,35,234055139,88828430,3115,10,292594407,30289162,-58539268,58539268
2022-12-18,305,315,303,304,429478527,3272,36,337742892,91735635,3181,15,393834793,35643734,-56091901,56091901
2022-12-19,305,305,293,293,847818492,5588,37,552480821,295337671,2904,18,769127851,78690641,-216647030,216647030
2022-12-20,295,300,287,298,534751207,3844,24,426871186,107880021,3103,17,485870764,48880443,-58999578,58999578
2022-12-21,301,301,292,293,205837281,2137,15,172742463,33094818,1773,7,193779650,12057631,-21037187,21037187
2022-12-24,295,307,294,303,429478112,2730,35,305259765,124218347,3554,21,376750708,52727404,-71490943,71490943
2022-12-25,305,315,302,315,1278117991,3966,46,1059404956,218813035,8332,37,1030693567,247524424,28711389,-28711389
2022-12-26,317,329,311,326,792665950,4418,38,650974469,141691481,5524,23,665277199,127388751,-14302730,14302730
2022-12-28,326,340,326,338,907840184,4006,44,665035659,242804525,5767,21,670320298,237519886,-5284639,5284639
2022-12-31,327,346,322,337,782430865,6132,44,649829684,132601181,6814,21,741180676,41250189,-91350992,91350992
2023-01-01,346,349,336,347,1345500753,6696,48,1136859200,208641553,9145,44,1022114955,323385798,114744245,-114744245
2023-01-02,356,362,353,362,579189542,1324,21,487405430,91784112,3565,12,244395808,334793734,243009622,-243009622
2023-01-03,380,380,370,373,2127828444,9428,71,1716448727,411379717,10493,47,1582627091,545201353,133821636,-133821636
2023-01-04,368,395,368,392,1022535786,8203,54,921234757,101301029,7762,37,887934626,134601160,33300131,-33300131
2023-01-07,398,401,398,401,1250800861,5781,45,1064689663,186111198,6904,42,658475989,592324872,406213674,-406213674
2023-01-08,409,416,394,402,1263242036,11607,50,898490314,364751722,8971,36,1136210460,127031576,-237720146,237720146
2023-01-09,406,417,398,406,797449195,7685,24,708172089,89277106,6401,20,677890527,119558668,30281562,-30281562
2023-01-10,412,424,400,403,738060798,6592,45,527140122,210920676,5956,24,666944098,71116700,-139803976,139803976
2023-01-11,400,403,390,390,1039797100,9356,49,701365965,338431135,4919,22,940106386,99690714,-238740421,238740421
2023-01-17,413,413,401,401,1094538724,5879,42,868552262,225986462,6837,36,764507635,330031089,104044627,-104044627
2023-01-18,401,409,391,398,544041422,5830,31,471524672,72516750,5720,21,484909865,59131557,-13385193,13385193
2023-01-21,409,411,379,383,934850049,7435,33,709930175,224919874,4962,28,763443360,171406689,-53513185,53513185
2023-01-22,388,394,369,388,729791824,5580,44,538447854,191343970,5191,27,608577566,121214258,-70129712,70129712
2023-01-23,393,395,361,371,1511241065,11460,49,1176251627,334989438,5530,41,1341045908,170195157,-164794281,164794281
2023-01-24,373,375,361,373,583407169,5614,39,510851466,72555703,4571,27,433806943,149600226,77044523,-77044523
2023-01-25,371,375,351,356,809214125,7243,30,540049532,269164593,4781,18,694502730,114711395,-154453198,154453198
2023-01-28,362,365,344,347,643534786,5216,25,448795752,194739034,4695,24,567466496,76068290,-118670744,118670744
2023-01-29,347,352,334,334,982553586,7045,49,807056810,175496776,5836,24,932381211,50172375,-125324401,125324401
2023-01-30,335,344,324,343,711228006,4712,28,535522625,175705381,5390,24,660700975,50527031,-125178350,125178350
2023-01-31,341,350,335,350,592015718,4204,27,502125663,89890055,4578,24,482803139,109212579,19322524,-19322524
2023-02-01,351,353,339,339,446735588,4120,23,357863578,88872010,3355,15,399071911,47663677,-41208333,41208333
2023-02-21,362,362,351,351,1245421274,7538,22,1115248340,130172934,4451,47,787168641,458252633,328079699,-328079699
2023-02-22,353,359,342,346,656373600,5040,31,487353737,169019863,4314,26,605487601,50885999,-118133864,118133864
2023-02-25,357,366,357,366,1365523241,10222,47,1178141239,187382002,6271,45,1060980352,304542889,117160887,-117160887
2023-02-26,377,380,349,352,1204339387,11868,38,1007572974,196766413,7066,44,1033997122,170342265,-26424148,26424148
2023-02-27,380,380,367,380,2529399129,7935,66,2172793046,356606083,11783,50,1832714212,696684917,340078834,-340078834
2023-02-28,374,386,369,371,763880329,7106,28,642356684,121523645,5042,21,712880657,50999672,-70523973,70523973
2023-03-01,370,372,357,357,606726335,6466,30,480913335,125813000,3376,14,579764488,26961847,-98851153,98851153
2023-03-04,353,375,351,370,783586645,4633,29,659798506,123788139,5678,27,741043080,42543565,-81244574,81244574
2023-03-05,379,385,373,374,779039831,4844,35,645024941,134014890,5848,21,697986318,81053513,-52961377,52961377
2023-03-06,374,385,367,374,480291376,3710,37,375907937,104383439,3656,17,454021338,26270038,-78113401,78113401
2023-03-07,377,385,360,370,824691830,6371,32,629521137,195170693,4559,33,745409882,79281948,-115888745,115888745
2023-03-11,380,388,373,374,600664007,4332,31,389122518,211541489,5135,16,578698361,21965646,-189575843,189575843
2023-03-12,370,375,361,365,404782884,3722,22,290180055,115295888,4241,8,388063028,17412915,-97882973,97882973
2023-03-13,367,372,361,363,421881918,2919,24,250650085,171231833,4696,13,339144296,82737622,-88494211,88494211
2023-03-14,366,371,361,365,411707894,3208,31,318546008,93161886,8235,18,360333200,51374694,-41787192,41787192
2023-03-15,371,376,365,372,468546566,6012,25,325828217,142718349,3457,16,433685470,34861096,-107857253,107857253
2023-03-18,379,390,379,390,615913892,4017,34,453328994,162584898,4546,23,396354176,219559716,56974818,-56974818
2023-03-19,400,405,388,399,510381999,5318,24,415995899,94386100,4703,17,442200191,68181808,-26204292,26204292
2023-03-25,404,417,392,405,730525443,5619,37,570765841,159759602,6441,18,594608623,135916820,-23842782,23842782
2023-03-26,409,417,391,391,659932939,8737,25,590219496,69713443,5258,11,580300204,79632735,9919292,-9919292
2023-03-27,395,408,387,401,423190970,5383,17,386216143,36974827,4434,15,345515741,77675229,40700402,-40700402
2023-03-28,406,416,399,404,399745113,5349,16,353807784,45937329,4144,20,329438543,70306570,24369241,-24369241
2023-03-29,409,422,406,421,646616613,6991,27,556308741,90307872,6025,25,564905585,81711028,-8596844,8596844
2023-04-03,423,438,408,438,970938264,8214,36,801470141,169468123,7702,35,637083405,333854859,164386736,-164386736
2023-04-04,446,455,421,432,816425748,12523,41,737300793,79124955,7091,32,739342237,77083511,-2041444,2041444
2023-04-05,424,449,422,443,732569845,9725,29,652920084,79649761,5942,41,617964690,114605155,34955394,-34955394
2023-04-08,429,451,422,431,1045760502,15053,32,945465839,100294663,8415,44,914275159,131485343,31190680,-31190680
2023-04-09,435,459,431,459,1271709212,11308,32,1182319570,89389642,10792,55,908839967,362869245,273479603,-273479603
2023-04-10,471,471,431,439,1172965033,17040,19,1107542045,65422988,8081,59,995232295,177732738,112309750,-112309750
2023-04-11,445,462,435,455,527361701,6824,20,456310807,71050894,5019,32,475462021,51899680,-19151214,19151214
2023-04-15,461,475,460,464,843388154,11069,38,738326601,105061553,7965,30,717084907,126303247,21241694,-21241694
2023-04-16,468,482,460,463,850767586,9427,39,759792615,90974971,8249,25,811069405,39698181,-51276790,51276790
2023-04-17,467,479,458,473,812747263,8276,24,766956841,45790422,8329,16,751207322,61539941,15749519,-15749519
2023-04-18,475,493,472,488,1582129515,10447,54,1300831676,281297839,10398,47,986835610,595293905,313996066,-313996066
2023-04-19,489,498,477,481,793102317,8846,29,645529771,147572546,7157,32,740256060,52846257,-94726289,94726289
2023-04-24,483,496,471,483,657143947,6908,28,558415208,98728739,7188,30,613465847,43678100,-55050639,55050639
2023-04-25,488,498,466,468,912408305,8857,39,657399955,255008350,7013,27,731410970,180997335,-74011015,74011015
2023-04-26,468,474,458,458,979037310,12573,40,715063185,263974125,6333,29,868725099,110312211,-153661914,153661914
2023-04-29,458,470,452,458,812261547,10261,29,696760704,115500843,8518,27,739276664,72984883,-42515960,42515960
2023-04-30,461,480,461,475,853563689,9214,31,798669199,54894490,7746,31,645798919,207764770,152870280,-152870280
2023-05-01,476,480,460,467,700213648,8631,25,590225149,109988499,6813,17,612489294,87724354,-22264145,22264145
2023-05-02,465,488,465,480,1214396215,11017,37,1031939688,182456527,9793,27,1035945593,178450622,-4005905,4005905
2023-05-03,488,500,479,500,2418625809,16717,63,2175763956,242861853,11802,36,1020787525,1397838284,1154976431,-1154976431
2023-05-06,520,520,519,520,936756565,6040,25,857925015,78831550,5123,15,390133475,546623090,467791540,-467791540
2023-05-07,545,545,494,494,1369187991,14894,37,1066978746,302209245,8136,24,1308323436,60864555,-241344690,241344690
2023-05-08,486,492,486,486,527721936,4110,13,269077970,258643966,3934,11,468216515,59505421,-199138545,199138545
2023-05-09,462,486,462,475,1806190970,13640,28,1075434283,730756687,13750,28,1715798394,90392576,-640364111,640364111
2023-05-10,477,479,445,445,820010030,7059,19,409279944,410730086,4621,14,774436989,45573041,-365157045,365157045
2023-05-13,436,440,429,429,801623282,5669,22,418153375,383469907,7470,10,787987189,13636093,-369833814,369833814
2023-05-14,430,451,425,451,732652251,7224,23,609939230,122713021,7175,26,667827183,64825068,-57887953,57887953
2023-05-15,452,452,429,435,476266894,4080,29,322312033,153954861,4420,27,442404440,33862454,-120092407,120092407
2023-05-17,431,453,430,445,375108439,3865,23,295124306,79984133,4180,9,358421197,16687242,-63296891,63296891
2023-05-20,448,452,423,425,473883058,4944,20,362573787,111309271,4576,16,445879713,28003345,-83305926,83305926
2023-05-21,423,438,422,431,310389708,4296,16,277382182,33007526,3050,22,266678218,43711490,10703964,-10703964
2023-05-22,435,450,431,440,563502139,5253,18,515909736,47592403,4339,22,437131928,126370211,78777808,-78777808
2023-05-23,445,451,434,435,449401511,5339,23,369388342,80013169,3510,23,325787978,123613533,43600364,-43600364
2023-05-24,435,445,427,431,646201095,5765,19,483486688,162714407,3167,32,361770503,284430592,121716185,-121716185
2023-05-27,431,438,425,428,485357073,4497,34,376454229,108902844,4593,28,392125456,93231617,-15671227,15671227
2023-05-28,431,431,409,411,705700212,7177,23,449749810,255950402,3728,12,620447796,85252416,-170697986,170697986
2023-05-29,414,415,408,410,457683053,3676,17,284711800,172971253,3085,26,368182642,89500411,-83470842,83470842
2023-05-30,412,420,410,412,417968307,3302,18,284358458,133609849,3303,27,360879928,57088379,-76521470,76521470
2023-05-31,411,417,396,403,414481315,3234,19,249533980,164947335,2979,23,335787125,78694190,-86253145,86253145
2023-06-03,402,412,396,412,282558735,2374,17,205527707,77031028,3176,21,249080516,33478219,-43552809,43552809
2023-06-06,413,426,407,426,506587938,2576,27,378422458,128165480,4406,23,321798048,184789890,56624410,-56624410
2023-06-07,433,434,420,421,306516353,2648,16,229964273,76552080,3470,10,286565235,19951118,-56600962,56600962
2023-06-12,388,405,388,399,420877513,4216,9,261656149,159221364,2940,15,379327424,41550089,-117671275,117671275
2023-06-13,401,404,387,399,275016271,2800,20,188008980,87007291,3339,11,236351921,38664350,-48342941,48342941
2023-06-14,399,406,393,394,248840632,2418,17,149051199,99789433,2478,13,234438300,14402332,-85387101,85387101
2023-06-17,399,404,386,387,224143144,2631,18,150497901,73645243,2688,13,195722884,28420260,-45224983,45224983
2023-06-18,381,386,375,377,363008034,4697,13,226132675,136875359,3088,15,340431621,22576413,-114298946,114298946
2023-06-19,370,382,364,366,293955563,4287,12,257075043,36880520,3034,15,258574988,35380575,-1499945,1499945
2023-06-20,366,376,359,374,193652337,2661,14,167851303,25801034,2600,12,181920585,11731752,-14069282,14069282
2023-06-21,374,382,365,372,187198064,2326,12,138749936,48448128,2600,13,175222095,11975969,-36472159,36472159
2023-06-24,371,373,359,359,215316234,3998,9,183688895,31627339,2477,10,187505682,27810552,-3816787,3816787
2023-06-25,365,369,361,362,207636765,2125,11,114676690,14251554,1458,11,117045249,11882995,-2368559,2368559
2023-06-26,365,380,362,369,254150219,2492,17,207047812,47102407,2840,13,207521930,46628289,-474118,474118
2023-06-27,371,377,355,358,184692325,3217,17,158689425,26002900,1627,4,173335784,11356541,-14646359,14646359
2023-06-28,360,368,358,359,184304499,2452,11,150098882,34205617,1705,10,177585961,6718538,-27487079,27487079
2023-07-01,363,366,353,354,198882905,3178,7,154006151,44876754,1894,9,190729164,8153741,-36723013,36723013
2023-07-02,355,374,355,371,367564604,3601,24,335255030,32309574,3324,12,352283579,15281025,-17028549,17028549
2023-07-03,372,382,371,379,197294875,2615,13,169784297,27510578,2438,4,182844369,14450506,-13060072,13060072
2023-07-04,377,384,371,371,215171148,2896,13,176834114,38337034,2324,7,206393548,8777600,-29559434,29559434
2023-07-05,374,378,370,372,189985692,2042,15,130673122,59312570,1850,7,185786461,4199231,-55113339,55113339
2023-07-08,376,378,367,367,151883554,1783,14,118046838,33836716,1866,7,141000554,10883000,-22953716,22953716
2023-07-09,366,372,362,362,173951905,2258,9,128190824,45761081,1799,8,165890074,8061831,-37699250,37699250
2023-07-10,362,367,354,355,209602195,2428,7,158277136,51325059,1641,8,185530698,24071497,-27253562,27253562
2023-07-11,354,361,341,341,513951335,4856,10,275717583,238233752,2101,15,434580363,79370972,-158862780,158862780
2023-07-12,340,345,329,331,394438634,4863,19,291697114,102741520,2396,12,327808716,66629918,-36111602,36111602
2023-07-15,336,339,321,322,245006697,3015,12,212058658,32948039,1908,16,219892980,25113717,-7834322,7834322
2023-07-16,325,327,312,312,358906056,4664,17,279657353,79248703,1919,9,332617309,26288747,-52959956,52959956
2023-07-17,308,311,299,305,484736277,4513,5,476486277,8250000,2800,13,352192602,132543675,124293675,-124293675
2023-07-18,304,314,303,311,408124879,3589,14,397652879,10472000,2375,13,323526115,84598764,74126764,-74126764
2023-07-25,302,303,292,296,162432264,2042,5,148741456,13690808,825,10,125854899,36577365,22886557,-22886557
2023-07-26,298,308,293,303,287811905,2842,7,279810127,8001778,1974,16,199432467,88379438,80377660,-80377660
2023-07-29,307,309,296,296,177354074,2031,15,128532227,48821847,1431,13,138710770,38643304,-10178543,10178543
2023-07-30,301,304,286,286,447127930,3809,10,286615554,160512376,1852,19,344038249,103089681,-57422695,57422695
2023-07-31,289,296,286,293,215284000,2082,7,192177819,23106181,1570,13,150022957,65261043,42154862,-42154862
2023-08-01,296,299,292,297,161936983,1451,8,111795476,50141507,1384,13,128739912,33197071,-16944436,16944436
2023-08-05,301,310,300,310,591574877,1939,16,461006043,130568834,2534,17,294698910,296875967,166307133,-166307133
2023-08-06,309,317,304,312,411251338,2149,13,227112967,184138371,2163,21,313751806,97499532,-86638839,86638839
2023-08-07,316,327,315,321,719003547,2839,14,596573025,122430522,4171,34,471789596,247213951,124783429,-124783429
2023-08-08,321,326,314,319,292733636,1878,14,169564042,123169594,1939,11,272311434,20422202,-102747392,102747392
2023-08-09,322,324,313,313,173345287,1299,14,114188779,59156508,1407,12,156576765,16768522,-42387986,42387986
2023-08-12,307,314,302,302,241309793,2608,8,182859793,58450000,958,6,232037571,9272222,-49177778,49177778
2023-08-13,294,302,287,297,283314273,2711,8,261104153,22210120,1841,11,261950826,21363447,-846673,846673
2023-08-14,302,308,295,297,209833233,1510,13,156751531,53199270,1835,9,172574388,37376413,-15822857,15822857
2023-08-15,297,297,287,293,339859813,2860,19,194945147,144914666,1915,13,261923561,77936252,-66978414,66978414
2023-08-20,291,302,288,298,218594724,1318,6,143603281,74991443,1422,17,199839672,18755052,-56236391,56236391
2023-08-21,298,306,294,296,178313136,1407,5,106525587,71787549,1585,11,154847458,23465678,-48321871,48321871
2023-08-22,297,298,283,284,271624013,2413,14,215256917,56367096,1285,8,248691732,22932281,-33434815,33434815
2023-08-23,287,299,282,299,266911240,1307,9,196025360,70885880,1854,10,219538655,47372585,-23513295,23513295
2023-08-26,303,306,301,306,326023539,582,8,222074202,103949337,1789,5,265273825,60749714,-43199623,43199623
2023-08-27,321,321,316,321,581991752,2307,13,487965362,94026390,3154,10,509739160,72252592,-21773798,21773798
2023-08-28,327,336,321,327,626494743,4226,21,499395913,127098830,4336,17,576010499,50484244,-76614586,76614586
2023-08-29,333,349,327,334,337394919,2952,14,277859187,59535732,2749,18,297497564,39897355,-19638377,19638377
2023-08-30,335,347,330,337,330673325,2426,21,231300396,99372929,2632,9,277824428,52848897,-46524032,46524032
2023-09-02,341,345,330,337,222936910,1604,22,158656436,64280474,2045,12,196313266,26623644,-37656830,37656830
2023-09-03,338,345,333,338,188543566,1333,23,117295073,71248493,1742,13,163552302,24991264,-46257229,46257229
2023-09-04,339,352,336,349,309550536,1608,26,158650166,150900370,2066,14,262727505,46823031,-104077339,104077339
2023-09-05,350,363,350,356,480875185,2373,16,337578142,143297043,3587,23,347678201,133196984,-10100059,10100059
2023-09-09,359,359,341,344,338880829,1818,26,165647668,173233161,2710,17,290777919,48102910,-125130251,125130251
2023-09-10,341,349,337,343,165609921,1247,17,124152092,41457829,1621,12,142819309,22790612,-18667217,18667217
2023-09-11,345,356,342,350,209769651,1758,15,161688237,48081414,1964,13,159800051,49969600,1888186,-1888186
2023-09-12,353,362,351,355,188806094,1499,17,151084794,37721300,1892,12,155205931,33600163,-4121137,4121137
2023-09-13,360,362,352,357,174510234,1105,14,108137647,66372587,1588,8,138105675,36404559,-29968028,29968028
2023-09-17,357,363,352,357,187020887,1076,14,126205652,60815235,1769,13,169230349,17790538,-43024697,43024697
2023-09-18,360,362,353,355,199002666,941,22,135450579,63552087,1671,8,191571841,7430825,-56121262,56121262
2023-09-19,355,357,350,354,188201082,810,19,78989282,109211800,1347,5,176027017,12174065,-97037735,97037735
2023-09-20,354,356,351,355,170274493,832,20,91212593,79061900,1203,10,144651321,25623172,-53438728,53438728
2023-09-23,354,355,350,353,176439506,1138,13,122691819,53747687,1309,6,145252750,31186756,-22560931,22560931
2023-09-25,353,353,337,338,297497219,1525,17,143604692,153892527,1524,9,251606104,45891115,-108001412,108001412
2023-09-26,342,345,336,336,242682592,1944,14,186176037,56506555,1297,9,201382222,41300370,-15206185,15206185
2023-09-27,337,340,332,333,196462794,1900,15,142289012,54173782,1147,9,165014559,31448235,-22725547,22725547
2023-09-30,339,342,328,329,286079719,2061,23,216667455,69412264,1705,16,255104268,30975451,-38436813,38436813
2023-10-01,329,331,323,324,228310809,2089,13,153772134,74538675,1505,8,210256569,18054240,-56484435,56484435
2023-10-02,325,335,321,329,163644748,1768,18,137602846,26041902,1266,11,138365223,25279525,-762377,762377
2023-10-04,329,339,329,334,83685931,1011,12,72907209,10778722,1072,8,68854248,14831683,4052961,-4052961
2023-10-07,329,334,320,322,151454000,1094,17,76261754,75228446,1312,9,142986108,8504092,-66724354,66724354
2023-10-08,318,318,309,309,403246896,2760,21,194401196,208845700,1661,7,373011784,30235112,-178610588,178610588
2023-10-09,309,318,301,309,206985517,1531,15,98122119,108863398,1640,11,191952531,15032986,-93830412,93830412
2023-10-10,310,317,304,315,132208626,1013,19,88846989,43361637,1204,10,117275544,14933082,-28428555,28428555
2023-10-11,317,321,309,309,129124683,1093,17,102236789,26887894,1105,10,105623419,23501264,-3386630,3386630
2023-10-14,312,312,299,300,223709506,1593,16,103596902,120112604,1173,9,172198501,51511005,-68601599,68601599
2023-10-15,300,308,295,305,114382296,1038,14,83677215,30705081,1090,11,99744594,14637702,-16067379,16067379
2023-10-16,307,317,305,317,160174821,1055,9,141953953,18220868,1669,15,121958407,38216414,19995546,-19995546
2023-10-17,318,320,310,312,125649240,1109,17,100559025,25090215,1081,8,91678348,33970892,8880677,-8880677
2023-10-18,300,314,300,307,161154509,1381,18,110741871,50412638,1256,8,152497586,8656923,-41755715,41755715
2023-10-21,317,317,308,308,104975694,907,10,86278773,18696921,899,11,79678785,25296909,6599988,-6599988
2023-10-22,311,315,308,309,94716007,1081,10,77582586,17133421,1024,10,79481306,15234701,-1898720,1898720
2023-10-23,307,307,297,299,128320812,1625,16,110259345,18061467,1143,12,115514690,12806122,-5255345,5255345
2023-10-24,300,300,286,286,359187582,4116,22,319308144,39879438,1694,17,268996660,90190922,50311484,-50311484
2023-10-25,286,291,285,288,152179208,1482,14,130377073,21802135,1162,11,129131954,23047254,1245119,-1245119
2023-10-28,278,279,273,273,123630719,2004,7,101580719,22050000,232,3,88498299,35132420,13082420,-13082420
2023-10-29,265,280,265,276,393804301,1896,29,242294804,151509497,1746,16,337521950,56282351,-95227146,95227146
2023-10-30,277,287,274,286,258164944,1242,18,189100820,69064124,1912,11,242523406,15641538,-53422586,53422586
2023-10-31,286,288,276,277,166745090,1362,15,104700395,62044695,1191,3,164266574,2478516,-59566179,59566179
2023-11-01,277,285,268,279,221306710,1985,18,131498895,89807815,1356,10,195009145,26297565,-63510250,63510250
2023-11-04,285,286,282,286,181965599,900,15,133199103,48766496,1700,14,147787266,34178333,-14588163,14588163
2023-11-05,292,294,287,289,152676690,947,15,93023766,59652924,1238,16,115185241,37491449,-22161475,22161475
2023-11-06,290,298,286,296,136324773,952,15,100455924,35868849,1369,17,122527242,13797531,-22071318,22071318
2023-11-07,299,309,295,309,397019309,1079,22,270943319,126075990,2314,14,248941600,148077709,22001719,-22001719
2023-11-08,311,316,305,306,196379898,1187,16,150389373,45990525,1787,8,188639354,7740544,-38249981,38249981
2023-11-11,309,315,304,309,163661061,1104,15,104586021,59075040,1339,8,147158138,16502923,-42572117,42572117
2023-11-12,307,312,304,311,128087288,954,14,91504315,36582973,1142,18,110434962,17652326,-18930647,18930647
2023-11-13,314,317,309,310,150613660,986,18,107118801,43494859,1251,18,124960011,25653649,-17841210,17841210
2023-11-14,312,315,305,305,136376495,1016,7,64259237,72117258,1035,21,127012627,9363868,-62753390,62753390
2023-11-15,306,310,302,302,97285861,1003,8,72494976,24790885,889,10,85477130,11808731,-12982154,12982154
2023-11-18,303,310,301,308,142833935,822,10,71174977,71658958,1304,26,118008019,24825916,-46833042,46833042
2023-11-19,308,315,306,306,136551249,937,15,99090516,37460733,1065,11,107085788,29465461,-7995272,7995272
2023-11-20,307,310,303,304,133007571,863,7,59670149,73337422,1229,7,98041862,34965709,-38371713,38371713
2023-11-21,301,311,301,306,116618468,778,9,59109133,57509335,1004,21,81891117,34727351,-22781984,22781984
2023-11-22,306,309,304,305,108813651,792,11,69440095,39373556,956,10,88305014,20508637,-18864919,18864919
2023-11-25,306,310,302,303,118567546,828,13,65888396,52679150,1042,12,99466610,19100936,-33578214,33578214
2023-11-26,305,306,302,303,121547620,901,16,84086768,37460852,914,14,87222378,34325242,-3135610,3135610
2023-11-27,303,306,300,300,109424453,1076,14,83824523,25599930,969,9,95322774,14101679,-11498251,11498251
2023-11-28,300,308,299,307,173695675,1043,14,138025038,35670637,1072,18,101937521,71758154,36087517,-36087517
2023-11-29,307,316,305,313,260220025,1344,25,187654551,72565474,1621,16,189276608,70943417,-1622057,1622057
2023-12-02,315,327,314,317,335149154,1522,30,248491255,86657899,2023,26,256575565,78573589,-8084310,8084310
2023-12-03,318,330,317,329,257791769,1400,22,211225256,46566513,1996,9,220462799,37328970,-9237543,9237543
2023-12-04,333,337,322,323,219003036,1803,19,187781222,31221814,1748,16,196242884,22760152,-8461662,8461662
2023-12-05,325,344,323,339,716572602,2284,40,510478671,206093931,3905,41,544833304,171739298,-34354633,34354633
2023-12-06,338,343,335,338,185013518,1482,15,120541077,64472441,1620,13,181663744,3349774,-61122667,61122667
2023-12-09,333,339,326,327,239987435,1626,19,109881371,130106064,1552,9,229518935,10468500,-119637564,119637564
2023-12-10,329,335,327,328,116889496,1104,14,95933137,20956359,1147,12,97986990,18902506,-2053853,2053853
2023-12-11,328,336,327,331,129315385,1066,5,119856436,9458949,1239,13,111715653,17599732,8140783,-8140783
2023-12-12,333,337,327,328,129274861,1052,10,97730638,31544223,1057,13,115446436,13828425,-17715798,17715798
2023-12-13,328,331,324,324,107518175,1083,11,63101824,44416351,963,6,103773900,3744275,-40672076,40672076
2023-12-16,324,329,323,327,100314367,1052,12,81282007,19032360,1135,9,86688755,13625612,-5406748,5406748
2023-12-18,329,341,328,332,185295910,1141,20,123906351,61389559,1714,9,167096948,18198962,-43190597,43190597
2023-12-19,335,336,328,329,153925192,1016,13,99645042,54280150,1199,7,136382037,17543155,-36736995,36736995
2023-12-20,329,334,328,329,125554476,889,11,96379239,29175237,1005,13,100067811,25486665,-3688572,3688572
2023-12-23,331,337,328,329,121997768,1031,14,85293161,36704607,1252,5,107854158,14143610,-22560997,22560997
2023-12-24,329,333,326,327,108420749,1014,12,67584623,40836126,1120,9,95233411,13187338,-27648788,27648788
2023-12-25,328,330,323,324,155331777,1056,13,82932074,72399703,1156,7,144268960,11062817,-61336886,61336886
2023-12-26,324,326,318,320,168546657,968,22,84617947,83928710,1198,9,150948157,17598500,-66330210,66330210
2023-12-27,319,322,317,321,166270066,1429,14,131491546,34778520,1295,10,94839981,71430085,36651565,-36651565
2023-12-30,323,327,321,322,232527644,992,22,148476644,84051000,1280,12,214953450,17574194,-66476806,66476806
2023-12-31,325,328,323,325,132882152,795,23,72462333,60419819,1327,16,105337495,27544657,-32875162,32875162
2024-01-01,326,326,321,321,121730181,682,14,46617583,75112598,1225,10,105592822,16137359,-58975239,58975239
2024-01-02,325,326,318,322,99726193,789,14,63236622,36489571,1059,10,89408548,10317645,-26171926,26171926
2024-01-03,322,329,321,321,201625785,1223,23,156519171,45106614,990,9,153224590,48401195,3294581,-3294581
2024-01-06,325,340,321,340,500616491,2365,32,384369114,116247377,3028,28,303276781,197339710,81092333,-81092333
2024-01-07,340,344,330,333,300819287,2607,17,236688335,64130952,1875,16,264457042,36362245,-27768707,27768707
2024-01-08,334,338,329,331,134520463,1112,18,83974285,50546178,1440,6,132983034,1537429,-49008749,49008749
2024-01-09,332,335,329,334,148050511,757,23,80329229,67721282,1247,11,139957960,8092551,-59628731,59628731
2024-01-10,336,346,336,341,335848944,1341,38,224697785,111151159,2064,15,255902678,79946266,-31204893,31204893
2024-01-13,344,356,337,346,272711584,1547,30,186911278,87215442,2754,16,233608254,40518466,-46696976,46696976
2024-01-14,359,359,347,348,202230019,1413,21,139902192,61124777,1645,14,187107840,13919129,-47205648,47205648
2024-01-15,347,351,340,341,181183067,1227,25,116715495,64467572,1676,6,176114761,5068306,-59399266,59399266
2024-01-16,337,341,335,337,169707742,995,27,72645361,97062381,1319,6,157237742,12470000,-84592381,84592381
2024-01-17,337,344,335,342,182539624,729,23,50163216,132376408,1428,11,161498384,21041240,-111335168,111335168
2024-01-20,343,343,325,326,172394583,1064,17,66851938,105542645,1431,9,158659067,13735516,-91807129,91807129
2024-01-21,327,329,318,322,208474840,1219,21,101993948,106480892,1653,15,184839139,23635701,-82845191,82845191
2024-01-22,320,328,310,317,214352842,1688,25,150342062,64006780,1362,18,200995692,13353150,-50653630,50653630
2024-01-23,319,319,304,306,178997077,1623,19,106736233,72260844,1276,7,143661865,35335212,-36925632,36925632
2024-01-24,308,317,308,314,99326177,803,8,81100277,18225900,972,12,67533250,31792927,13567027,-13567027
2024-01-27,314,321,312,312,112177078,920,14,77747424,34429654,853,13,84921087,27255991,-7173663,7173663
2024-01-28,314,320,309,319,152099165,1054,13,81269259,70829906,1146,13,111618256,40480909,-30348997,30348997
2024-01-29,316,316,310,313,115983084,719,16,62377258,53605826,1076,14,100122502,15860582,-37745244,37745244
2024-01-30,308,312,305,305,262652012,1251,18,107058868,155593144,1256,16,175084250,87567762,-68025382,68025382
2024-01-31,306,311,303,309,161488167,1012,13,82359886,79128281,936,13,137980768,23507399,-55620882,55620882
2024-02-03,308,317,307,311,173619064,1306,26,145298117,28320947,1089,15,108667901,64951163,36630216,-36630216
2024-02-04,312,316,304,308,241932263,1144,13,86549048,155383215,959,16,108603457,133328806,-22054409,22054409
2024-02-18,309,311,306,310,364504351,776,4,57377976,317233665,697,19,290246796,84364845,-232868820,232868820
2024-02-19,311,314,307,309,401534155,1655,9,145453699,317802297,1660,37,246501007,216754989,-101047308,101047308
2024-02-20,308,315,307,309,246880052,852,10,53321545,193558507,1150,21,183951328,62928724,-130629783,130629783
2024-02-21,307,310,305,306,151918974,855,6,57787421,94131553,905,14,125648790,26270184,-67861369,67861369
2024-02-24,306,306,294,297,310712103,2136,12,160357876,150354227,1341,18,285233051,25479052,-124875175,124875175
2024-02-26,299,299,287,287,224266212,1967,10,155556389,71451378,1093,22,175410551,51597216,-19854162,19854162
2024-02-27,286,293,284,287,200876454,1843,19,138282883,62593571,959,15,100373394,100503060,37909489,-37909489
2024-02-28,293,297,287,287,161389415,1564,14,138371725,23057690,925,15,93503171,67926244,44868554,-44868554
2024-03-02,298,307,292,307,502994678,1328,12,436185766,66828912,1668,21,220435949,282578729,215749817,-215749817
2024-03-03,320,320,320,320,185315826,195,11,157735826,27600000,1111,11,83640130,101695696,74095696,-74095696
2024-03-04,329,336,325,330,1445649151,4561,40,987583867,458065284,5856,46,1095081208,350567943,-107497341,107497341
2024-03-05,334,351,331,340,556184171,3298,30,446602932,109581239,3021,22,452001724,104182447,-5398792,5398792
2024-03-06,346,349,338,341,281821289,1860,22,213186639,68634650,2075,25,218863024,62958265,-5676385,5676385
2024-03-09,343,346,337,338,199902949,1688,14,154761710,45141239,1663,12,188071849,11831100,-33310139,33310139
2024-03-10,341,357,341,349,318496049,1992,21,241926325,76569724,2386,30,261082119,57413930,-19155794,19155794
2024-03-11,351,367,347,367,583002581,1556,23,482247980,100754601,3497,27,316782438,266220143,165465542,-165465542
2024-03-12,373,382,365,368,623717676,3683,36,494261497,129456179,3688,33,530541635,93176041,-36280138,36280138
2024-03-13,369,378,364,365,326107069,2519,19,223322009,102785060,2530,13,277129819,48977250,-53807810,53807810
2024-03-16,365,373,362,370,285266513,1725,25,164382054,120884459,1978,12,197673845,87592668,-33291791,33291791
2024-03-17,367,382,367,369,297892797,2175,31,227655621,70237176,1568,13,217639527,80253270,10016094,-10016094
2024-03-18,374,387,374,381,89761727,477,5,46554041,43207686,492,9,60267252,29494475,-13713211,13713211
2024-03-24,392,399,383,399,469740514,3356,26,391343827,78396687,2901,27,308342669,161397845,83001158,-83001158
2024-03-25,400,408,383,386,447696222,4472,13,400968923,46727299,2708,45,337059580,110636642,63909343,-63909343
2024-03-26,390,393,380,381,245960328,2573,15,183560226,62400102,2069,17,208631228,37329100,-25071002,25071002
2024-03-27,382,387,375,377,255553451,2794,10,214556711,40996740,1817,18,211465221,44088230,3091490,-3091490
2024-03-30,377,381,370,377,232226180,1916,27,151178433,81047747,1710,7,210102611,22123569,-58924178,58924178
2024-04-02,360,377,356,374,337884761,2149,40,175382268,162502493,2367,10,331170207,6714554,-155787939,155787939
2024-04-03,374,380,365,373,255690806,1719,26,139276430,116414376,1885,14,211621101,44069705,-72344671,72344671
2024-04-06,372,376,352,353,501234968,2684,24,252558114,248676854,2838,17,450888625,50346343,-198330511,198330511
2024-04-07,358,364,353,359,257519745,1489,21,134825319,122694426,1735,6,234426895,23092850,-99601576,99601576
2024-04-08,363,369,358,359,134573033,1450,21,118191790,16381243,1151,9,112819255,21753778,5372535,-5372535
2024-04-09,362,370,360,364,182556281,1302,17,131743584,50812697,1590,12,168016071,14540210,-36272487,36272487
2024-04-13,355,359,347,347,524747064,2127,14,145350788,379396276,2255,14,481551726,43195338,-336200938,336200938
2024-04-14,345,345,345,345,14455337,330,2,11455337,3000000,52,3,12255337,2200000,-800000,800000
2024-04-15,350,350,349,350,100691590,310,2,99791590,900000,985,11,75537811,25153779,24253779,-24253779
2024-04-16,347,349,347,349,330732829,1659,20,194886383,135846446,1058,14,293486118,37246711,-98599735,98599735
2024-04-17,348,350,344,345,182989256,1143,21,141276544,41712712,1180,9,155926273,27062983,-14649729,14649729
2024-04-20,372,376,366,374,509413682,2771,21,437880449,71533233,2112,19,293906683,215506999,143973766,-143973766
2024-04-21,378,378,368,369,305022934,2535,15,208844940,96177994,2148,18,255475221,49547713,-46630281,46630281
2024-04-22,370,377,365,366,225344015,1752,11,194083865,31260150,1444,13,194326009,31018006,-242144,242144
2024-04-23,367,376,364,371,323281030,1751,10,166037975,157243055,1577,23,240755840,82525190,-74717865,74717865
2024-04-24,371,374,367,372,216957021,1358,11,145456777,71500244,1402,20,145200801,71756220,255976,-255976
2024-04-27,370,376,367,368,232502872,1095,28,128903777,103599095,1587,20,198834237,33668635,-69930460,69930460
2024-04-28,368,371,363,363,205508850,1076,27,106052191,99456659,1388,5,200398605,5110245,-94346414,94346414
2024-04-29,365,380,365,366,187013335,1210,24,129939443,57073892,1694,17,170152340,16860995,-40212897,40212897
2024-04-30,372,372,362,364,143827550,765,28,64206830,79629673,1104,10,122123887,21712616,-57917057,57917057
2024-04-30,366,366,366,366,8953,765,28,64206830,79629673,1104,10,122123887,21712616,-57917057,57917057
2024-05-01,362,371,362,369,102570890,513,28,55914929,46655961,1159,8,100564750,2006140,-44649821,44649821
2024-05-05,368,373,365,365,136554073,759,39,76808341,59745732,1340,15,99986092,36567981,-23177751,23177751
2024-05-06,364,368,361,362,191066623,804,36,61612741,129453882,1231,12,130628517,60438106,-69015776,69015776
2024-05-07,361,368,357,364,120070204,724,33,53283134,66787070,1047,15,102324988,17745216,-49041854,49041854
2024-05-08,362,364,351,352,127009925,1337,24,95919907,31090018,1042,12,109620068,17389857,-13700161,13700161
2024-05-11,348,358,346,347,152273839,968,24,66985563,85288276,1322,14,128327523,23946316,-61341960,61341960
2024-05-12,351,357,339,339,160605247,1291,17,86151471,74453776,1123,15,147800647,12804600,-61649176,61649176
2024-05-13,346,346,329,341,343412705,2103,34,152518288,190894417,2227,24,314669558,28743147,-162151270,162151270
2024-05-14,337,345,333,334,124960818,672,21,51404611,73556207,940,17,111885628,13075190,-60481017,60481017
2024-05-15,335,342,327,337,142381748,1140,22,102615978,39765770,1171,14,100161717,42220031,2454261,-2454261
2024-05-18,339,345,332,333,129968538,806,17,65754651,64213887,1046,14,102105110,27863428,-36350459,36350459
2024-05-19,321,333,321,329,199800374,1659,7,156975980,42824394,954,17,185031563,14768811,-28055583,28055583
2024-05-21,318,329,318,329,172465921,641,13,92047721,80418200,1043,24,134021007,38444914,-41973286,41973286
2024-05-25,325,331,321,321,227849553,1078,7,61626926,166222627,1056,26,183276995,44572558,-121650069,121650069
2024-05-26,317,324,317,317,55277994,533,3,27554289,25587055,239,5,48303470,4837874,-20749181,20749181
2024-05-27,313,316,313,314,199682376,1651,10,158406153,41276223,941,17,144091032,55591344,14315121,-14315121
2024-05-28,315,320,315,320,78729331,325,7,70579550,8149781,685,10,64959975,13769356,5619575,-5619575
2024-05-29,326,326,326,326,42116927,45,0,42116927,0,438,3,34103566,8013361,8013361,-8013361
2024-06-01,332,332,325,332,321224722,1073,19,239492626,81732096,1927,27,293315040,27909682,-53822414,53822414
2024-06-02,334,338,325,338,178672451,730,8,132474075,46198376,1231,24,145023729,33648722,-12549654,12549654
2024-06-05,339,339,335,338,259488057,908,6,239384552,20103505,1800,20,217462946,42025111,21921606,-21921606
2024-06-08,339,339,332,332,174995287,725,7,72357373,102641914,612,3,173155230,1844057,-100797857,100797857
2024-06-09,327,339,325,337,148557022,843,11,87679036,60877986,1398,17,130733797,17823225,-43054761,43054761
2024-06-10,339,339,336,339,46938200,84,1,46138200,800000,670,4,37867166,9071034,8271034,-8271034
2024-06-11,346,346,337,338,170263090,854,10,96646996,73616094,1128,22,134196233,36066857,-37549237,37549237
2024-06-12,341,342,336,337,137813541,444,7,45556643,92256898,915,15,116025389,21788152,-70468746,70468746
2024-06-15,333,339,333,333,17251661,310,1,15494192,1757469,70,0,17251661,0,-1757469,1757469
2024-06-16,330,332,330,330,155633846,790,6,124955918,30677928,590,8,137538075,18095771,-12582157,12582157
2024-06-18,326,328,323,323,136381045,766,9,69185514,67195531,539,5,132446470,3934575,-63260956,63260956
2024-06-19,320,330,320,328,142675395,595,13,67101342,75574053,1008,17,112020107,30655288,-44918765,44918765
2024-06-22,329,331,319,319,205549450,1069,8,96816520,108732930,1050,20,161730228,43819222,-64913708,64913708
2024-06-23,324,327,318,319,229691645,538,12,47222189,182469456,878,17,148480980,81210665,-101258791,101258791
2024-06-24,319,328,319,328,118566161,620,12,75875537,42690624,857,17,92168236,26397925,-16292699,16292699
2024-06-26,333,333,329,333,203483804,628,10,114656438,88827366,870,10,159737899,43745905,-45081461,45081461
2024-06-29,333,339,322,326,208243156,1083,17,138634318,69608838,966,17,162814395,45428761,-24180077,24180077
2024-06-30,328,328,311,313,274712265,892,22,85679094,189033171,1064,12,264763462,9948803,-179084368,179084368
2024-07-01,317,322,315,319,66388529,534,14,39542045,26846484,703,9,55764857,10623672,-16222812,16222812
2024-07-02,322,332,322,328,79256313,396,14,34360704,44895609,702,9,60443205,18813108,-26082501,26082501
2024-07-03,329,331,323,327,101708566,536,17,70127992,31580574,743,6,95613429,6095137,-25485437,25485437
2024-07-06,347,347,347,347,108688159,31,4,72088159,36600000,569,6,28864765,79823394,43223394,-43223394
2024-07-07,367,367,352,356,462937190,1704,31,297173013,165764177,2243,23,352903568,110033622,-55730555,55730555
2024-07-08,355,365,349,349,186170757,1032,18,125722169,60448588,1378,18,164629015,21541742,-38906846,38906846
2024-07-09,350,354,343,343,131656156,670,5,59752817,71903339,764,14,113927009,17729147,-54174192,54174192
2024-07-10,341,347,334,336,159927242,853,15,56676941,103250301,829,17,152185229,7742013,-95508288,95508288
2024-07-13,340,340,326,331,113182636,727,15,56977103,56205533,800,8,101704951,11477685,-44727848,44727848
2024-07-14,333,338,329,333,96778821,608,8,67083898,29694923,664,13,77548579,19230242,-10464681,10464681
2024-07-17,335,338,327,330,86010301,551,7,55008182,31002119,611,3,82831061,3179240,-27822879,27822879
2024-07-22,328,329,321,323,81959964,613,6,50357292,31602672,504,10,75835787,6124177,-25478495,25478495
2024-07-23,327,329,324,326,144599695,711,19,48206292,96393403,850,12,107665599,36934096,-59459307,59459307
2024-07-24,327,327,320,321,67863304,473,8,24946136,42917168,662,5,60346903,7516401,-35400767,35400767
2024-07-27,324,324,320,322,30731155,284,3,17888587,12842568,330,2,30092234,638921,-12203647,12203647
2024-07-29,324,326,312,315,202724432,688,12,61269672,141454760,892,19,171049463,31674969,-109779791,109779791
2024-07-30,318,318,308,317,99431668,796,13,55477158,43954510,731,12,74403744,25027924,-18926586,18926586
2024-07-31,304,306,294,299,397247667,1633,9,127781337,269466330,1434,12,371815046,25432621,-244033709,244033709
2024-08-03,284,291,279,279,256667957,1296,12,100432691,156235266,819,12,220583057,36084900,-120150366,120150366
2024-08-04,277,281,277,277,150883881,882,11,105506985,45376896,581,5,140188819,10695062,-34681834,34681834
2024-08-05,274,276,274,274,61099934,464,6,26216800,34883134,146,5,40548953,20550981,-14332153,14332153
2024-08-06,272,272,272,272,74512831,256,4,12343495,62169336,252,4,72375850,2136981,-60032355,60032355
2024-08-10,274,274,269,271,94046028,627,9,85282819,8763209,696,3,70689011,23357017,14593808,-14593808
2024-08-11,272,274,270,274,127445852,580,13,76068704,51377148,764,10,86656003,40789849,-10587299,10587299
2024-08-12,272,273,269,269,67603121,408,9,38630959,28972162,472,7,51574603,16028518,-12943644,12943644
2024-08-13,267,267,267,267,44983900,231,4,7347140,37636760,241,5,31454959,13528941,-24107819,24107819
2024-08-14,269,270,266,270,50609469,251,0,50609469,0,517,7,41258124,9351345,9351345,-9351345
2024-08-17,275,275,275,275,29450156,83,3,23750156,5700000,384,2,22398145,7052011,1352011,-1352011
2024-08-18,278,278,278,278,37859857,80,0,37859857,0,284,4,28379857,9480000,9480000,-9480000
2024-08-19,282,282,275,276,131098501,815,15,98140165,32958336,808,15,102706233,28392268,-4566068,4566068
2024-08-20,276,281,274,277,89762810,525,10,42012758,47750052,617,8,86058941,3703869,-44046183,44046183
2024-08-21,277,280,270,280,66048966,318,5,23758561,42290405,545,4,47763529,18285437,-24004968,24004968
2024-08-24,279,284,274,284,71469789,488,9,64857909,6611880,581,5,44506789,26963000,20351120,-20351120
2024-08-26,287,288,279,285,130059624,536,6,49228052,80831572,743,10,98741970,31317654,-49513918,49513918
2024-08-27,286,288,281,284,74222917,387,7,38484380,35738537,584,6,63704887,10518030,-25220507,25220507
2024-08-28,288,290,285,290,119870436,471,6,99999109,19871327,693,7,88277126,31593310,11721983,-11721983
2024-09-01,297,298,291,294,156830253,839,11,111387035,45443218,582,3,153710393,3119860,-42323358,42323358
2024-09-03,291,293,288,289,176611956,1075,4,164517479,12094477,591,1,174460982,2150974,-9943503,9943503
2024-09-07,289,296,287,289,109640437,560,11,97174183,12466254,782,6,91829441,17810996,5344742,-5344742
2024-09-08,287,294,283,290,81144018,533,8,48517175,32626843,604,3,80358778,785240,-31841603,31841603
2024-09-09,294,297,288,297,153848368,330,4,148815606,5032762,805,7,106789423,47058945,42026183,-42026183
2024-09-10,299,302,294,298,84921327,643,7,80758199,4163128,634,5,79935706,4985621,822493,-822493
2024-09-11,298,304,298,301,89281402,588,7,81164913,8116489,675,3,87968546,1312856,-6803633,6803633
2024-09-14,302,304,294,295,107403930,623,8,66511452,40892478,764,2,106661832,742098,-40150380,40150380
2024-09-15,295,295,289,289,63227663,479,7,29573584,33654079,430,1,61227663,2000000,-31654079,31654079
2024-09-16,287,298,285,291,103503185,592,17,61048134,42455051,717,9,89093544,14409641,-28045410,28045410
2024-09-17,293,301,292,301,152281622,526,11,119151180,33130442,868,11,89213075,63068547,29938105,-29938105
2024-09-18,301,309,298,301,111435593,876,11,98960881,12474712,763,11,86657687,24777906,12303194,-12303194
2024-09-22,298,304,297,298,83965593,620,11,48793282,35172311,677,3,82902948,1062645,-34109666,34109666
2024-09-23,300,309,297,309,162696809,493,15,138310992,24385817,1002,8,141655101,21041708,-3344109,3344109
2024-09-24,309,316,308,312,137885503,971,8,122446113,15439390,1040,14,128893105,8992398,-6446992,6446992
2024-09-25,314,315,306,308,153187832,905,8,107435226,45752606,931,8,147343470,5844362,-39908244,39908244
2024-09-28,307,307,307,307,1560711,85,1,1505602,55109,5,0,1560711,0,-55109,55109
2024-09-29,307,312,307,308,424900684,870,16,83522546,341378138,1260,10,402313728,22586956,-318791182,318791182
2024-09-30,306,309,304,304,78462140,481,6,38702461,39759679,398,6,74747526,3714614,-36045065,36045065
2024-10-01,301,301,301,301,1967204,95,0,1967204,0,6,0,1967204,0,0,0
2024-10-02,301,301,301,301,6193027,70,4,1144231,5048796,19,2,5442501,750526,-4298270,4298270
2024-10-05,301,301,301,301,1740645,73,2,1681462,59183,7,0,1740645,0,-59183,59183
2024-10-06,301,301,301,301,555823,40,0,555823,0,2,0,555823,0,0,0
2024-10-07,301,301,301,301,11696382,124,3,2394230,9302152,26,2,10896382,800000,-8502152,8502152
2024-10-08,300,302,300,300,193453422,808,9,84401776,108988265,756,12,153765334,39624707,-69363558,69363558
2024-10-09,297,300,297,297,220257069,1183,13,185789769,34467300,1118,9,148815340,71441729,36974429,-36974429
2024-10-12,297,304,294,300,101599256,595,14,68533715,33065541,997,2,93115503,8483753,-24581788,24581788
2024-10-13,300,302,291,293,137529743,610,13,77425882,60103861,869,5,120822633,16707110,-43396751,43396751
2024-10-14,291,294,286,286,45064862,440,9,30545288,14519574,241,2,44034862,1030000,-13489574,13489574
2024-10-15,279,279,279,279,39896673,368,9,34781381,5115292,43,2,31896673,8000000,2884708,-2884708
2024-10-16,272,280,272,272,153372036,1104,13,126458284,26913752,1075,4,147900201,5471835,-21441917,21441917
2024-10-19,265,269,265,265,104891404,621,11,62886831,42004573,294,1,104691404,200000,-41804573,41804573
2024-10-20,257,257,257,257,25714602,399,5,19029534,6685068,30,2,16714602,9000000,2314932,-2314932
2024-10-21,253,257,253,255,204781358,1302,7,190095614,14685744,1199,8,183832722,20948636,6262892,-6262892
2024-10-22,249,254,247,247,71584284,753,3,60595498,10988786,359,3,71572955,11329,-10977457,10977457
2024-10-23,240,246,240,241,299577557,1236,7,128056869,171520688,1011,7,264532729,35044828,-136475860,136475860
2024-10-26,248,248,248,248,35648601,61,0,35648601,0,437,2,25583601,10065000,10065000,-10065000
2024-10-27,253,253,253,253,58959007,158,2,58160007,799000,279,3,12909007,46050000,45251000,-45251000
2024-10-28,260,260,255,260,333475586,1160,12,318962967,14512619,1230,20,198999729,134475857,119963238,-119963238
2024-10-29,261,261,252,252,169869353,1076,14,106093590,63775763,868,11,147283521,22585832,-41189931,41189931
2024-10-30,254,262,247,260,208097881,709,12,153306985,54790896,1232,10,169443147,38654734,-16136162,16136162
2024-11-02,263,265,261,263,325640341,781,7,303231341,22409000,1553,17,262116760,63523581,41114581,-41114581
2024-11-03,257,259,257,257,27696098,421,4,26800581,895517,81,0,27696098,0,-895517,895517
2024-11-04,253,264,253,264,213777123,1013,10,170603304,43173819,1234,8,188443987,25333136,-17840683,17840683
2024-11-05,264,264,263,264,227445584,660,15,171873521,55572063,1041,7,191313047,36132537,-19439526,19439526
2024-11-06,261,272,256,267,348169647,1399,19,259421572,88748075,1408,17,297652096,50517551,-38230524,38230524
2024-11-09,272,272,268,272,45769317,82,1,43774892,1994425,477,3,34169317,11600000,9605575,-9605575
2024-11-10,279,279,279,279,40509460,103,6,37709460,2800000,380,3,15008113,25501347,22701347,-22701347
2024-11-11,286,286,286,286,408558024,730,24,333628461,74929563,1133,11,297184746,111373278,36443715,-36443715
2024-11-12,287,294,285,294,373021248,703,20,286204688,86816560,1445,15,283376931,89644317,2827757,-2827757
2024-11-13,297,302,296,302,118783674,211,2,114783674,4000000,767,8,55875109,62908565,58908565,-58908565
2024-11-16,311,311,311,311,59405323,161,11,55005323,4400000,473,3,15005323,44400000,40000000,-40000000
2024-11-17,320,320,316,320,1148934725,2487,50,919387050,229547675,3061,49,806161810,342772915,113225240,-113225240
2024-11-19,342,352,333,334,1996093421,4811,33,1318972022,677121399,3414,76,939372280,1056721141,379599742,-379599742
2024-11-20,337,351,334,348,1225377358,3406,20,831145086,394232272,3554,32,799433212,425944146,31711874,-31711874
2024-11-23,349,354,344,348,658844421,2877,34,570096166,88748255,2535,26,510348824,148495597,59747342,-59747342
2024-11-24,352,361,352,361,544431727,1919,25,427800360,116631367,1822,19,317666656,226765071,110133704,-110133704
2024-11-25,371,371,368,371,161032216,630,7,144632216,16400000,1115,7,118687216,42345000,25945000,-25945000
2024-11-26,382,382,368,372,1167622886,4853,39,905353153,262269733,4752,39,846243947,321378939,59109206,-59109206
2024-11-27,382,390,379,390,898160309,3561,22,854450180,43710129,3562,22,545890282,352270027,308559898,-308559898
2024-11-30,400,400,377,383,1124003931,4654,38,810666410,313337521,4383,35,952870803,171133128,-142204393,142204393
2024-12-01,381,402,379,390,779477066,2679,32,533451180,246025886,2846,17,628140012,151337054,-94688832,94688832
2024-12-02,404,404,403,404,659778943,1358,17,535551887,124227056,1877,14,194975093,464803850,340576794,-340576794
2024-12-03,416,416,403,413,1165974002,4261,48,820478497,345495505,4500,33,882889179,283084823,-62410682,62410682
2024-12-04,409,427,407,418,789299540,4037,49,555181703,234133540,3725,25,717983229,71332014,-162801526,162801526
2024-12-07,412,417,406,406,700302234,3043,28,371699709,328602525,1937,13,678468514,21833720,-306768805,306768805
2024-12-08,394,405,394,401,1126972594,4598,25,640934414,486047180,4063,20,928049098,198932496,-287114684,287114684
2024-12-09,407,408,402,408,521469890,2048,22,412578774,108891116,2120,13,248402283,273067607,164176491,-164176491
2024-12-10,416,416,395,395,771703244,4368,31,505646692,266056552,3210,20,700964271,70738973,-195317579,195317579
2024-12-11,399,412,391,412,669838468,2488,40,436264481,233573987,3964,20,532196833,137641635,-95932352,95932352
2024-12-14,418,419,413,419,336531993,1113,15,281863716,54668277,2020,5,238281993,98250000,43581723,-43581723
2024-12-15,431,431,409,412,826673391,5720,21,713277181,113396210,4473,25,742726697,83946694,-29449516,29449516
2024-12-16,413,418,407,407,665319916,4156,27,533771087,131548829,3338,22,571073914,94246002,-37302827,37302827
2024-12-17,400,407,398,398,460441557,3107,24,342430887,118010670,2409,14,377657489,82784068,-35226602,35226602
2024-12-18,389,407,387,406,593214392,2859,23,533411574,59802818,4382,32,547484148,45730244,-14072574,14072574
2024-12-21,407,407,407,407,482445531,581,11,466445531,16000000,681,9,35045531,447400000,431400000,-431400000
2024-12-22,412,419,398,405,775978971,3534,36,650620410,125358561,3248,31,694558272,81420699,-43937862,43937862
2024-12-23,404,422,400,422,988222406,2335,38,801427830,186794576,3691,31,510204345,478018061,291223485,-291223485
2024-12-24,433,433,428,433,1318989950,2973,50,979993963,338995987,4072,33,801822008,517167942,178171955,-178171955
2024-12-25,441,445,424,445,2207455463,5573,64,1795769391,411686072,5773,38,1254754052,952701411,541015339,-541015339
2024-12-28,445,457,437,441,1517041578,6129,56,1190766910,328146822,5242,63,1301012407,217901325,-110245497,110245497
2024-12-29,446,457,436,436,1050745874,4705,27,665732547,385013327,2942,33,924856548,125889326,-259124001,259124001
2024-12-30,433,445,428,428,975280979,3908,36,614176319,361104660,4633,33,851078879,124202100,-236902560,236902560
2024-12-31,428,438,421,425,965319741,3806,28,534681821,430637920,3166,26,813938873,151380868,-279257052,279257052
2025-01-01,429,433,413,427,435877172,2468,31,334496686,101380486,5072,30,328301952,107575220,6194734,-6194734
2025-01-04,432,439,430,433,607165313,4048,21,541845225,65320088,2910,26,521340221,85825092,20505004,-20505004
2025-01-05,436,449,424,435,726081104,3352,22,660248313,65842791,4085,33,618853396,107237708,41394917,-41394917
2025-01-06,447,447,432,443,307346200,1898,23,217664992,89691208,1900,12,270014096,37342104,-52349104,52349104
2025-01-07,442,452,439,449,492857339,3075,43,379580552,113276787,3135,15,471661908,21195431,-92081356,92081356
2025-01-11,452,452,433,433,449405227,2069,13,248654966,200750261,1907,20,400046909,49358318,-151391943,151391943
2025-01-12,434,435,428,428,485372769,3010,16,197889271,287483498,2095,18,398947540,86425229,-201058269,201058269
2025-01-13,426,436,421,426,377084905,2339,17,259112654,117987954,2903,25,308661998,68438610,-49549344,49549344
2025-01-15,431,436,421,421,323348412,2154,15,130740018,192608394,2263,16,241406960,81941452,-110666942,110666942
2025-01-18,419,427,413,413,239813119,1415,13,92928314,146884805,899,13,217755148,22057971,-124826834,124826834
2025-01-19,404,420,403,415,492233951,2976,20,264560711,227673240,2309,17,393928923,98305028,-129368212,129368212
2025-01-20,419,420,396,396,560126832,3399,19,377697969,182428863,2244,30,385766978,174359854,-8069009,8069009
2025-01-21,399,415,394,412,597326795,2696,17,271431456,325895339,2330,24,422819067,174507728,-151387611,151387611
2025-01-22,412,414,407,407,554393677,2297,12,263014149,16854869,1531,22,199831168,80037850,63182981,-63182981
2025-01-25,406,409,397,400,665210104,3574,34,438681195,226528909,2386,39,627014143,38195961,-188332948,188332948
2025-01-26,412,415,406,414,880523036,3227,25,647137863,233385173,3883,35,744037076,136485960,-96899213,96899213
2025-01-27,412,421,402,405,303529811,2165,18,168337232,135192579,1928,12,226953312,76576499,-58616080,58616080
2025-01-29,412,414,402,404,271419318,1870,18,129120582,142298736,1553,19,220312237,51107081,-91191655,91191655
2025-02-01,405,409,393,401,427390698,1991,12,133862918,293527780,1916,24,348651445,78739253,-214788527,214788527
2025-02-02,402,405,395,397,229316919,1667,20,120922173,108394746,1513,16,199586254,29730665,-78664081,78664081
2025-02-03,401,408,397,407,427463567,1944,36,219073854,208389713,1998,19,372757051,54706516,-153683197,153683197
2025-02-09,414,414,410,414,781894127,3812,25,701901882,79992245,3138,30,527076896,254817231,174824986,-174824986
2025-02-11,419,426,401,401,977945144,4032,23,551958236,425986908,3940,48,763477115,214468029,-211518879,211518879
2025-02-15,397,397,397,397,439918209,710,9,25254493,414663716,878,8,414242332,25675877,-388987839,388987839
2025-02-16,386,393,385,390,658908886,2885,17,284863377,374045509,2791,26,456697173,202211713,-171833796,171833796
2025-02-17,394,397,385,393,577442995,2486,18,482377884,95065111,2412,32,432796807,144646188,49581077,-49581077
2025-02-18,392,401,389,398,203436825,1694,14,166841316,36595509,1359,23,143136280,60300545,23705036,-23705036
2025-02-19,399,402,389,396,325401586,1446,8,143952418,181449168,1553,20,253070395,72331191,-109117977,109117977
2025-02-22,390,397,384,385,585617835,2476,20,205055883,380561952,2103,40,498753055,86864780,-293697172,293697172
2025-02-23,400,400,400,400,38772077,102,2,37972077,800000,704,3,31156887,7615190,6815190,-6815190
2025-02-24,411,411,411,411,26065326,72,0,26065326,0,646,4,25183958,881368,881368,-881368
2025-02-25,421,421,421,421,76421707,241,6,74670060,1751647,764,9,39936618,36485089,34733442,-34733442
2025-02-26,433,433,432,433,1165878606,3039,30,1067819055,98059551,3835,46,662682771,503195835,405136284,-405136284
2025-03-01,440,446,436,446,916093977,3996,19,746894853,169199124,3788,41,627208198,288885779,119686655,-119686655
2025-03-02,452,458,447,458,493031057,2087,9,433410290,59620767,2153,27,217575656,275455401,215834634,-215834634
2025-03-03,444,453,444,449,1216838307,5634,27,740393165,476445142,3769,34,955038628,261799679,-214645463,214645463
2025-03-04,458,458,444,445,955198601,4976,24,900705624,54492977,4233,43,676043332,279155269,224662292,-224662292
2025-03-05,452,470,448,470,870813601,2278,19,776404689,94408912,3684,40,452670628,418142973,323734061,-323734061
2025-03-08,480,480,460,461,1749059449,6692,33,1516894999,232164450,5943,65,1401188315,347871134,115706684,-115706684
2025-03-09,470,479,459,470,930117922,3923,23,635301976,294815946,4296,34,792563479,137554443,-157261503,157261503
2025-03-10,479,482,472,482,1102991425,4368,18,1004677317,98414987,4333,44,663782057,439310247,340895260,-340895260
2025-03-11,472,477,466,466,260885948,2765,11,222182336,38703612,451,7,241435327,19450621,-19252991,19252991
2025-03-12,455,460,455,455,1521006030,7279,30,858040544,662965486,3620,37,1274483625,246522405,-416443081,416443081
2025-03-15,461,468,450,457,861631131,5552,24,664094868,197536263,3783,40,706467097,155164034,-42372229,42372229
2025-03-16,457,467,449,454,1053822213,5396,19,587433842,466388371,3738,44,810867266,242954947,-223433424,223433424
