Date,Open,High,Low,Close,Volume,person_buyer_count,person_buy_volume,person_seller_count,company_seller_count,person_sell_volume,company_sell_volume,person_owner_change,company_owner_change,company_buyer_count,company_buy_volume
2015-06-23,38,39,37,38,6346737,164,6022886,155,8,3797773,2548964,2225113,-2225113,4,323851
2015-06-24,38,38,37,37,5129283,219,4163318,108,4,3048204,2081079,1115114,-1115114,3,965965
2015-06-27,37,37,36,36,3871700,189,3237818,91,3,3192077,679623,45741,-45741,4,633882
2015-06-28,36,36,35,35,3976902,121,2999951,111,2,3746902,230000,-746951,746951,3,976951
2015-06-29,36,36,35,35,3092664,130,2377561,71,2,2467206,625458,-89645,89645,7,715103
2015-06-30,36,37,36,37,16491433,157,10491433,189,8,7709551,8781882,2781882,-2781882,5,6000000
2015-07-01,37,38,36,37,10404211,231,7644211,179,2,8579034,1825177,-934823,934823,7,2760000
2015-07-04,38,39,37,38,44490180,559,30016536,539,21,26970228,17519952,3046308,-3046308,12,14473644
2015-07-12,43,43,42,43,25121078,579,15810536,251,22,11766601,9795935,4043935,-4043935,9,5752000
2015-07-13,44,44,44,44,2215005,26,2215005,57,4,506942,1708063,1708063,-1708063,0,0
2015-07-14,47,47,45,47,111592929,1176,83067245,565,24,39927523,71631704,43139722,-43139722,39,28491982
2015-07-15,49,49,46,48,42042311,730,31786841,645,12,37234487,4807824,-5447646,5447646,22,10255470
2015-07-20,47,48,46,47,16301549,283,13182666,326,5,14588850,1712699,-1406184,1406184,14,3118883
2015-07-21,48,49,47,48,16058087,312,12912487,334,8,12337887,3720200,574600,-574600,6,3145600
2015-07-22,48,48,46,46,16106541,394,10553802,253,1,15606541,500000,-5052739,5052739,14,5552739
2015-07-25,45,46,44,44,20314160,353,9424157,339,4,19005089,1309071,-9580932,9580932,18,10890003
2015-07-26,44,46,44,46,16366680,274,15438441,329,10,13363233,3003447,2075208,-2075208,4,928239
2015-07-27,46,47,44,45,7612601,242,5044633,151,4,7231730,380871,-2187097,2187097,9,2567968
2015-07-28,44,46,44,45,8645924,176,4067983,223,2,8605924,40000,-4537941,4537941,8,4577941
2015-07-29,46,47,45,46,9700080,252,8261063,211,3,6850080,2850000,1410983,-1410983,6,1439017
2015-08-01,46,47,45,45,8255382,134,2798349,98,1,2855035,100000,-56686,56686,3,156686
2015-08-02,45,46,45,45,3178644,102,2243209,123,1,2678644,500000,-435435,435435,2,935435
2015-08-03,45,46,45,45,3269310,82,1475205,110,1,3119310,150000,-1644105,1644105,2,1794105
2015-08-04,45,46,44,45,5681352,85,1076313,121,1,5621352,10000,-4545039,4545039,9,4555039
2015-08-05,45,46,45,45,2944017,94,1284541,85,0,2939017,0,-1654476,1654476,8,1654476
2015-08-08,45,45,43,44,6551919,183,2556826,116,1,6051919,500000,-3495093,3495093,11,3995093
2015-08-09,44,45,44,44,3737067,104,1541479,94,1,2937067,800000,-1395588,1395588,6,2195588
2015-08-10,44,45,44,44,5030217,68,1123470,70,1,2680217,2350000,-1556747,1556747,3,3906747
2015-08-12,44,44,43,43,4694519,129,1681366,68,2,3374264,1310000,-1692898,1692898,8,3002898
2015-08-15,43,43,42,43,5586358,96,969461,135,0,5586358,0,-4616897,4616897,9,4616897
2015-08-16,43,44,43,43,2341745,82,1305365,71,0,2341745,0,-1036380,1036380,9,1036380
2015-08-17,44,44,43,43,3233278,46,442502,88,1,3232678,600,-2790176,2790176,8,2790776
2015-08-18,43,43,42,42,3085709,24,148709,20,0,342429,0,-193720,193720,3,193720
2015-08-19,42,43,42,42,1833809,50,632865,81,2,1821185,12624,-1188320,1188320,4,1200944
2015-08-22,43,43,42,42,1548199,46,426480,54,0,1548199,0,-1121719,1121719,4,1121719
2015-08-23,43,43,42,42,2709091,40,1766912,92,1,2569091,140000,-802179,802179,7,942179
2015-08-24,42,42,41,42,2159394,59,634049,83,1,1917380,242014,-1283331,1283331,6,1525345
2015-08-25,41,42,40,41,11478636,153,2683626,147,2,9878636,1600000,-7195010,7195010,6,8795010
2015-08-26,41,41,40,40,3128217,98,1577572,66,2,1923289,1204928,-345717,345717,2,1550645
2015-08-29,41,42,41,41,2371057,76,2076712,84,3,2032764,343948,43948,-43948,1,300000
2015-08-30,41,42,40,41,1990169,90,765169,66,1,1986169,4000,-1221000,1221000,2,1225000
2015-08-31,41,41,40,40,1131974,48,851857,46,0,1131974,0,-280117,280117,5,280117
2015-09-01,41,41,40,40,1270263,72,880339,60,1,1264594,5669,-384255,384255,1,389924
2015-09-02,41,41,41,41,2020945,46,803451,86,1,2016614,4331,-1213163,1213163,3,1217494
2015-09-05,42,43,41,42,2969049,111,2598701,131,2,2782202,186847,-183501,183501,4,370348
2015-09-06,42,42,42,42,2130803,45,1957603,78,3,1915606,215197,41997,-41997,2,173200
2015-09-07,41,42,41,42,1838883,51,1338883,109,0,1838883,0,-500000,500000,1,500000
2015-09-08,42,42,41,42,5252205,46,4484456,82,3,1316502,3935703,3167954,-3167954,2,767749
2015-09-09,42,42,42,42,2025670,50,1567770,88,1,2025570,100,-457800,457800,3,457900
2015-09-12,42,43,41,41,1214228,69,887228,61,2,1211728,2500,-324500,324500,3,327000
2015-09-13,41,42,40,41,3849635,83,2557600,97,2,3649535,200100,-1091935,1091935,3,1292035
2015-09-14,41,41,40,41,5770511,63,3965003,72,0,5761811,0,-1796808,1796808,3,1796808
2015-09-15,40,41,40,40,2657922,42,791689,91,1,2649422,8500,-1857733,1857733,6,1866233
2015-09-16,40,40,40,40,1758862,50,1126342,87,0,1758862,0,-632520,632520,4,632520
2015-09-19,41,41,40,40,2056526,47,1618286,71,4,1880926,175600,-262640,262640,3,438240
2015-09-20,40,40,38,38,6958467,142,1900689,109,1,6907967,50000,-5007278,5007278,8,5057278
2015-09-21,37,38,36,38,8229800,164,4147450,110,5,6541164,1688636,-2393714,2393714,9,4082350
2015-09-22,37,39,37,39,2748913,92,2259360,98,5,2063527,685386,195833,-195833,4,489553
2015-09-23,39,40,38,39,3551919,98,2301919,134,3,3318069,233850,-1016150,1016150,3,1250000
2015-09-26,39,39,38,39,1433833,45,1284906,67,1,1333833,100000,-48927,48927,3,148927
2015-09-27,38,39,38,39,1922080,72,1838680,62,4,1303753,618327,534927,-534927,2,83400
2015-09-28,39,39,38,38,979563,48,690617,34,2,800163,179400,-109546,109546,6,288946
2015-09-29,39,39,38,39,1967932,31,666932,26,4,680358,1287574,-13426,13426,4,1301000
2015-09-30,38,38,38,38,1365240,69,805908,31,3,373361,991879,432547,-432547,3,559332
2015-10-03,38,38,36,36,4171998,132,1611998,39,3,3714285,457713,-2102287,2102287,7,2560000
2015-10-04,36,37,35,35,5732930,206,4102926,114,5,3822930,1910000,279996,-279996,6,1630004
2015-10-05,36,36,36,36,1951235,34,613446,103,2,1841245,109990,-1227799,1227799,3,1337789
2015-10-06,36,36,35,36,1842355,33,865924,67,2,1802805,39550,-936881,936881,7,976431
2015-10-07,36,37,36,37,7659622,201,7085051,176,8,5749622,1910000,1335429,-1335429,2,574571
2015-10-10,38,38,36,37,1894751,89,1461775,73,2,1884501,10250,-422726,422726,3,432976
2015-10-11,36,37,36,37,5485110,130,4395845,74,3,2501518,2983592,1894327,-1894327,3,1089265
2015-10-12,37,38,36,36,2753131,80,2433131,67,3,1028631,1724500,1404500,-1404500,2,320000
2015-10-13,37,39,36,38,5826424,79,3044374,122,4,3591424,2235000,-547050,547050,5,2782050
2015-10-14,39,39,38,39,3339302,148,2648824,103,2,3162571,176731,-513747,513747,2,690478
2015-10-17,40,40,39,40,3777002,110,1543402,133,5,3331486,445516,-1788084,1788084,3,2233600
2015-10-18,41,42,40,41,8167303,221,7667303,210,9,6760681,1406622,906622,-906622,2,500000
2015-10-19,40,41,40,40,3115149,84,2707999,94,1,2400069,715080,307930,-307930,3,407150
2015-10-20,40,40,39,39,6215555,147,3980554,61,2,5058784,1156771,-1078230,1078230,5,2235001
2015-10-21,39,39,38,38,2132210,72,1081710,70,4,1828260,303950,-746550,746550,4,1050500
2015-10-25,38,38,36,36,4984779,167,2509779,109,3,3991550,993229,-1481771,1481771,8,2475000
2015-10-26,37,37,36,36,1674251,56,1144479,30,3,1515889,158362,-371410,371410,3,529772
2015-10-27,37,37,36,36,2638562,85,1150606,31,2,2238833,399729,-1088227,1088227,2,1487956
2015-10-28,36,37,36,37,2333740,50,1534107,50,4,1352779,382920,181328,-181328,3,201592
2015-10-31,37,37,37,37,2408459,42,2108521,81,0,2408459,0,-299938,299938,1,299938
2015-11-01,37,39,36,39,2481403,89,1948896,126,2,2446587,34816,-497691,497691,2,532507
2015-11-02,38,39,38,38,1528915,56,1267475,66,4,1293464,235451,-25989,25989,1,261440
2015-11-03,38,39,37,38,589840,30,423815,39,0,589840,0,-166025,166025,1,166025
2015-11-04,39,39,38,38,896304,33,653617,41,2,888863,5754,-235246,235246,3,241000
2015-11-07,39,39,38,38,2071505,31,470555,65,2,1822909,248596,-1352354,1352354,3,1600950
2015-11-08,38,38,38,38,1190193,18,489193,41,1,1176048,14145,-686855,686855,3,701000
2015-11-09,37,39,37,38,3163674,12,229434,61,5,1541933,1621741,-1312499,1312499,6,2934240
2015-11-10,38,39,37,37,1354164,60,1134164,39,3,641614,712550,492550,-492550,3,220000
2015-11-11,38,38,37,37,1843985,55,1071085,34,3,915600,928385,155485,-155485,6,772900
2015-11-14,37,38,36,36,3255514,112,2432013,40,4,1500606,1754908,931407,-931407,6,823501
2015-11-15,37,37,35,36,3346141,145,2291941,59,2,2618241,716900,-326300,326300,6,1043200
2015-11-16,36,37,35,36,2156877,127,2095601,85,3,1596877,560000,498724,-498724,4,61276
2015-11-17,36,36,35,35,1916967,107,1370968,58,3,1284967,630000,86001,-86001,4,543999
2015-11-18,36,36,36,36,1359050,50,1358417,37,3,758540,600510,599877,-599877,1,633
2015-11-21,36,37,35,36,1355999,63,760791,60,3,1055680,300319,-294889,294889,2,595208
2015-11-22,35,36,35,35,2542866,108,2169113,30,4,604006,1938860,1565107,-1565107,3,373753
2015-11-23,35,35,35,35,1229100,47,688357,46,3,741260,487840,-52903,52903,2,540743
2015-11-24,36,36,35,35,1654908,47,392616,28,5,444508,1210400,-51892,51892,4,1262292
2015-11-25,36,37,36,37,3498376,36,1510362,108,12,2270480,1227896,-760118,760118,1,1988014
2015-11-28,38,38,36,37,17284498,121,3387094,165,5,3808560,13475938,-421466,421466,4,13897404
2015-11-29,37,37,36,36,4937998,125,2854984,126,5,2691365,2246633,163619,-163619,4,2083014
2015-11-30,36,37,35,36,3142263,94,1432263,72,4,2518607,623656,-1086344,1086344,4,1710000
2015-12-01,35,36,35,35,3161570,146,2288377,48,4,2418470,743100,-130093,130093,4,873193
2015-12-05,35,36,35,35,2008894,71,1472796,44,3,1287442,721452,185354,-185354,3,536098
2015-12-06,36,36,34,35,4323688,124,2693688,72,5,3847117,476571,-1153429,1153429,4,1630000
2015-12-07,35,35,34,34,1060003,65,995003,44,17,756399,303604,238604,-238604,2,65000
2015-12-08,34,35,34,34,1271346,43,966606,43,1,1265474,5872,-298868,298868,6,304740
2015-12-09,34,35,34,35,3378643,43,1158866,30,11,649145,624365,509721,-509721,1,114644
2015-12-13,35,35,34,34,1025629,55,625629,37,1,840295,185334,-214666,214666,2,400000
2015-12-14,34,35,34,35,1704760,96,1524520,53,2,1590617,114143,-66097,66097,3,180240
2015-12-15,34,35,34,34,1857418,74,1461184,50,3,1796818,60600,-335634,335634,3,396234
2015-12-16,35,35,34,34,1256358,61,1256358,48,1,1252363,3995,3995,-3995,0,0
2015-12-19,34,34,33,33,2428859,95,1400234,76,0,2428859,0,-1028625,1028625,5,1028625
2015-12-20,33,33,32,33,3403585,67,1731056,70,0,3403585,0,-1672529,1672529,6,1672529
2015-12-21,33,33,31,32,1740176,89,1591619,49,2,1690663,49513,-99044,99044,2,148557
2015-12-22,32,33,31,32,1829016,85,1227230,48,2,1621870,207146,-394640,394640,4,601786
2015-12-23,32,32,31,32,2034717,65,890032,45,2,1375597,659120,-485565,485565,4,1144685
2015-12-26,31,32,31,31,4424125,88,2667324,53,3,2157485,2266640,509839,-509839,8,1756801
2015-12-27,31,33,31,33,3840771,68,2740771,81,3,2845205,995566,-104434,104434,4,1100000
2015-12-28,33,33,32,33,3308205,88,2414398,117,5,3096852,211353,-682454,682454,5,893807
2015-12-30,33,34,33,34,3792437,66,2592437,140,5,3032437,760000,-440000,440000,2,1200000
2016-01-02,35,35,34,34,2153844,58,1707917,86,1,2053844,100000,-345927,345927,2,445927
2016-01-03,34,34,33,34,2757696,102,1952696,82,2,2487696,270000,-535000,535000,5,805000
2016-01-04,34,35,34,34,2367634,73,2045238,66,2,2180734,186900,-135496,135496,1,322396
2016-01-05,34,36,34,36,3781468,63,3005468,128,10,2540865,1240603,464603,-464603,3,776000
2016-01-06,37,37,36,37,18917665,289,15455910,232,23,7675001,11229491,7780909,-7780909,6,3448582
2016-01-09,39,39,36,36,14500715,325,12002510,236,8,11505444,2995271,497066,-497066,9,2498205
2016-01-10,36,39,36,37,6195164,185,5567666,179,6,3899562,2295602,1668104,-1668104,4,627498
2016-01-11,38,39,38,39,10093779,371,9893779,214,12,6402636,3691143,3491143,-3491143,2,200000
2016-01-12,39,40,38,39,11457262,433,11295555,294,8,7077642,4379620,4217913,-4217913,4,161707
2016-01-13,39,40,38,40,36399404,340,22497628,332,9,9539856,26859548,12957772,-12957772,9,13901776
2016-01-16,41,41,40,41,49397520,522,37997520,337,21,14644685,34752835,23352835,-23352835,11,11400000
2016-01-17,42,42,39,40,24221498,440,16162784,370,10,20935308,3286190,-4772524,4772524,8,8058714
2016-01-18,40,40,38,40,17842638,308,11102762,273,9,15034768,2807870,-3932006,3932006,12,6739876
2016-01-19,40,41,40,41,39774977,300,29624977,201,15,10189076,29585901,19435901,-19435901,12,10150000
2016-01-20,42,42,41,42,30860424,848,27506446,407,14,23621395,7239029,3885051,-3885051,18,3353978
2016-01-23,42,43,40,42,44193940,1009,33174990,675,9,34950460,9243480,-1775470,1775470,16,11018950
2016-01-24,42,43,42,42,30469046,578,24302535,453,9,23683299,6785747,619236,-619236,14,6166511
2016-01-25,42,45,42,45,63324842,659,40313842,832,21,39878308,23446534,435534,-435534,24,23011000
2016-01-26,46,46,45,46,47973428,444,41539227,305,20,17386651,30586777,24152576,-24152576,10,6434201
2016-01-27,48,48,44,44,47743835,938,41024482,802,16,37441875,10301960,3582607,-3582607,12,6719353
2016-01-30,44,45,43,43,25568489,591,15018828,457,10,23635896,1932593,-8617068,8617068,19,10549661
2016-01-31,43,43,42,43,19417731,300,14992412,442,5,18517731,900000,-3525319,3525319,11,4425319
2016-02-01,43,45,43,45,17398095,290,15048975,353,12,9748650,7649445,5300325,-5300325,6,2349120
2016-02-02,46,47,44,44,31653479,482,27542469,538,13,23326295,8327184,4216174,-4216174,13,4111010
2016-02-03,45,46,44,46,21019758,411,16272397,439,8,17942806,3076952,-1670409,1670409,14,4747361
2016-02-06,46,48,46,47,18733778,477,17266917,353,6,12791592,5942186,4475325,-4475325,6,1466861
2016-02-07,48,49,48,49,14603926,85,8168215,343,8,11664173,2939753,-3495958,3495958,6,6435711
2016-02-08,51,51,50,51,38380467,219,30480467,205,17,5200218,33180249,25280249,-25280249,9,7900000
2016-02-09,54,54,49,52,54781233,414,28070675,478,20,28696739,26084494,-626064,626064,14,26710558
2016-02-10,52,56,51,54,72430309,696,35638429,877,22,52447929,19982380,-16809500,16809500,20,36791880
2016-02-13,54,56,52,53,43366968,460,18965318,509,13,34182276,9184692,-15216958,15216958,14,24401650
2016-02-14,53,55,52,53,22533758,282,10284385,347,8,15984669,6549089,-5700284,5700284,12,12249373
2016-02-15,54,55,54,55,28747270,241,21926721,321,12,14048015,14699255,7878706,-7878706,9,6820549
2016-02-16,57,57,55,56,21889881,338,15246697,427,11,14210882,7678999,1035815,-1035815,7,6643184
2016-02-17,56,59,56,59,28875806,319,18442750,402,12,15770206,13105600,2672544,-2672544,13,10433056
2016-02-20,59,59,55,55,30316057,521,19065057,304,8,23986057,6330000,-4921000,4921000,12,11251000
2016-02-21,54,55,53,53,20894969,307,11744969,307,12,14163581,6731388,-2418612,2418612,9,9150000
2016-02-22,55,56,54,56,35337788,543,21735909,369,14,25892788,9445000,-4156879,4156879,14,13601879
2016-02-23,57,57,53,53,28376933,693,21196933,339,8,20524644,7852289,672289,-672289,12,7180000
2016-02-24,53,53,51,53,12873892,424,11184723,248,11,8939885,3934007,2244838,-2244838,6,1689169
2016-02-27,54,55,52,52,11214891,445,9599891,237,6,6985376,4229515,2614515,-2614515,6,1615000
2016-02-28,54,54,51,51,13153646,401,7043069,253,3,8553646,4600000,-1510577,1510577,12,6110577
2016-02-29,51,53,50,51,23626860,573,15906860,293,14,10333278,13293582,5573582,-5573582,5,7720000
2016-03-01,52,54,52,54,19970177,286,19099177,317,9,7033827,13886350,12065350,-12065350,9,1821000
2016-03-01,54,54,54,54,950000,286,19099177,317,9,7033827,13886350,12065350,-12065350,9,1821000
2016-03-02,55,56,54,56,65586797,924,41296634,840,29,41687241,23899556,-390607,390607,13,24290163
2016-03-05,58,59,58,59,44293458,427,34938621,338,17,15200411,29093047,19738210,-19738210,15,9354837
2016-03-06,61,61,61,61,70893810,1060,51012032,570,26,27714297,43179513,23297735,-23297735,24,19881778
2016-03-07,63,64,59,59,59982258,1333,43258573,953,16,51311255,8671003,-8052682,8052682,24,16723685
2016-03-08,59,61,58,59,34625629,690,18810573,621,12,29341659,5283970,-10531086,10531086,9,15815056
2016-03-09,57,59,56,58,24854189,871,17799947,562,8,18687489,6166700,-887542,887542,9,7054242
2016-03-14,60,60,60,60,2044696,7,1544696,57,2,290804,1753892,1253892,-1253892,1,500000
2016-03-15,63,63,62,63,87189030,1027,69401282,603,22,29793030,57396000,39608252,-39608252,30,17787748
2016-03-16,64,66,60,62,52371887,1300,34192334,654,7,39933253,12438634,-5740919,5740919,10,18179553
2016-03-26,63,63,60,60,25322605,473,11822605,388,8,17303239,8019366,-5480634,5480634,2,13500000
2016-03-27,59,61,57,57,26194615,676,14994615,290,6,17801275,8393340,-2806660,2806660,5,11200000
2016-03-28,56,59,55,59,21219123,723,12416673,463,4,20030276,1188847,-7613603,7613603,6,8802450
2016-03-29,59,60,58,60,46478869,987,41877869,427,10,20422264,26056605,21455605,-21455605,10,4601000
2016-03-30,62,63,61,63,48077127,1222,36157634,661,10,29137111,18940016,7020523,-7020523,19,11919493
2016-04-02,61,63,60,60,17951519,701,16331519,548,2,17639432,312087,-1307913,1307913,4,1620000
2016-04-03,61,61,57,59,16138791,485,11888791,451,2,15638791,500000,-3750000,3750000,10,4250000
2016-04-04,59,60,57,59,10432125,364,8083557,332,5,8422251,2009874,-338694,338694,5,2348568
2016-04-05,59,61,59,60,10497797,342,6330623,383,5,8763780,1734017,-2433157,2433157,4,4167174
2016-04-06,60,61,58,58,12715351,592,11365351,365,5,10595689,2119662,769662,-769662,3,1350000
2016-04-09,59,60,58,58,9156099,385,7965777,358,3,9005094,151005,-1039317,1039317,2,1190322
2016-04-10,58,59,56,56,18360242,786,17273366,401,7,14069806,4290436,3203560,-3203560,9,1086876
2016-04-11,57,57,55,55,13390208,382,9588408,247,12,8326913,5063295,1261495,-1261495,11,3801800
2016-04-12,55,56,53,53,22531020,541,16186120,236,7,15757345,6773675,428775,-428775,8,6344900
2016-04-13,54,54,51,51,29343898,602,15702983,384,11,21463241,7880657,-5760258,5760258,16,13640915
2016-04-16,51,51,49,49,13512737,281,6908737,236,5,10426707,3086030,-3517970,3517970,8,6604000
2016-04-17,47,51,47,49,20275163,368,15484794,444,5,14072163,6203000,1412631,-1412631,10,4790369
2016-04-18,50,50,49,50,14208262,335,7963766,192,6,11535700,2672562,-3571934,3571934,3,6244496
2016-04-19,52,52,47,48,11114780,356,10814780,189,3,5462440,5652340,5352340,-5352340,1,300000
2016-04-20,49,50,47,48,18324500,464,14846737,305,2,16984305,1340195,-2137568,2137568,4,3477763
2016-04-27,50,50,50,50,26637734,158,20237734,51,3,969658,25668076,19268076,-19268076,3,6400000
2016-04-30,52,53,50,51,33072098,448,21772098,512,3,30572098,2500000,-8800000,8800000,8,11300000
2016-05-01,51,52,50,50,7601536,286,6156867,242,2,7597459,4077,-1440592,1440592,4,1444669
2016-05-02,50,52,49,52,12752403,255,6985669,310,5,10875903,1876500,-3890234,3890234,10,5766734
2016-05-03,51,52,50,51,10872953,93,2120436,230,2,6292953,4580000,-4172517,4172517,6,8752517
2016-05-04,50,52,49,49,9491075,166,4228534,138,1,5891075,3600000,-1662541,1662541,4,5262541
2016-05-07,50,50,48,48,10706834,254,6073838,154,3,9206834,1500000,-3132996,3132996,10,4632996
2016-05-08,47,49,47,48,5228684,172,3659704,224,0,5228684,0,-1568980,1568980,5,1568980
2016-05-09,48,48,47,47,5679204,151,3630251,162,3,5422282,256922,-1792031,1792031,6,2048953
2016-05-10,47,47,45,46,6759617,160,3744151,149,3,6555721,203896,-2811570,2811570,6,3015466
2016-05-11,46,46,45,46,9846461,156,4722885,198,1,8046461,1800000,-3323576,3323576,8,5123576
2016-05-14,46,48,46,48,7326107,54,1291236,140,4,4267599,3058508,-2976363,2976363,7,6034871
2016-05-15,48,49,47,48,9407275,110,6562692,243,5,4359111,5048164,2203581,-2203581,5,2844583
2016-05-17,48,48,47,48,8276531,73,1006531,125,2,3376531,4900000,-2370000,2370000,7,7270000
2016-05-18,48,50,47,50,7480938,82,3213829,278,2,5980938,1500000,-2767109,2767109,6,4267109
2016-05-21,50,52,50,52,21094179,101,18563987,184,10,4370637,16723542,14193350,-14193350,8,2530192
2016-05-23,53,54,53,54,10061160,54,6327336,230,2,4620748,5440412,1706588,-1706588,4,3733824
2016-05-24,57,57,55,57,30166324,108,22875731,432,20,18756461,11409863,4119270,-4119270,7,7290593
2016-05-25,57,58,55,58,63997976,418,30743644,871,21,41552273,22445703,-10808629,10808629,28,33254332
2016-05-28,58,60,57,60,65612278,355,29557858,990,28,42526714,23085564,-12968856,12968856,29,36054420
2016-05-29,60,61,59,60,20662053,181,9825515,531,13,16014405,4647648,-6188890,6188890,15,10836538
2016-05-30,60,60,59,60,17677982,95,4438799,295,8,7575982,10102000,-3137183,3137183,15,13239183
2016-05-31,59,60,59,59,21255569,93,6825321,347,9,14459758,6795811,-7634437,7634437,16,14430248
2016-06-01,59,61,59,61,33925737,197,17752114,530,22,21896597,12029140,-4144483,4144483,10,16173623
2016-06-05,61,63,61,61,16630286,234,11461980,344,12,13403399,3226887,-1941419,1941419,10,5168306
2016-06-06,62,62,60,60,11097719,134,3364975,297,3,10696819,400900,-7331844,7331844,8,7732744
2016-06-07,60,64,60,61,27868353,298,14221959,482,10,23897758,3970595,-9675799,9675799,17,13646394
2016-06-08,62,62,59,59,17353600,310,8762539,302,5,14798394,2555206,-6035855,6035855,12,8591061
2016-06-11,60,61,57,57,16312750,178,3707514,203,5,15129830,1182920,-11422316,11422316,10,12605236
2016-06-12,57,58,55,56,7433029,140,3294482,130,5,3188860,4244169,105622,-105622,7,4138547
2016-06-13,55,57,55,55,17040732,106,2690433,117,5,6384145,10656587,-3693712,3693712,6,14350299
2016-06-14,56,56,53,54,9332560,141,5334955,154,9,6448968,2883592,-1114013,1114013,7,3997605
2016-06-15,54,56,53,55,11042200,231,6821319,146,9,5843346,5198854,977973,-977973,12,4220881
2016-06-18,56,56,54,55,10994443,85,1768105,102,5,2501969,8492474,-733864,733864,6,9226338
2016-06-19,55,55,53,54,4944146,48,2473746,139,5,2828110,2116036,-354364,354364,3,2470400
2016-06-20,53,54,52,54,8134155,94,6237697,119,3,6208413,1925742,29284,-29284,5,1896458
2016-06-21,53,56,53,56,4505275,44,3888965,115,0,4505275,0,-616310,616310,5,616310
2016-06-22,57,58,57,58,3205129,23,3205129,72,4,1714129,1491000,1491000,-1491000,0,0
2016-06-25,60,61,58,59,17624976,294,13759238,316,11,9496440,8128536,4262798,-4262798,11,3865738
2016-06-28,62,63,61,61,30477185,696,25584896,311,17,18058790,12418395,7526106,-7526106,10,4892289
2016-06-29,60,62,59,60,17800503,447,13227133,437,15,13987167,3813336,-760034,760034,15,4573370
2016-07-02,60,60,58,58,5228448,126,3178339,148,4,4690942,537506,-1512603,1512603,7,2050109
2016-07-03,59,60,58,59,5854164,113,1856288,147,5,4878114,976050,-3021826,3021826,12,3997876
2016-07-04,58,59,57,57,4387945,91,2003146,153,0,4387945,0,-2384799,2384799,8,2384799
2016-07-05,57,59,57,58,1595893,31,710983,100,2,1502893,93000,-791910,791910,4,884910
2016-07-09,57,59,56,58,5270920,58,1046213,117,1,5120920,150000,-4074707,4074707,10,4224707
2016-07-10,57,58,57,58,1738063,45,858743,108,2,1327330,410733,-468587,468587,6,879320
2016-07-11,58,59,58,58,3807143,32,775021,123,8,2679765,1127378,-1904744,1904744,10,3032122
2016-07-12,58,58,56,58,8397995,57,3405486,154,5,7278356,1119639,-3872870,3872870,13,4992509
2016-07-13,57,58,56,58,8899020,35,1555576,121,5,3855288,5043732,-2299712,2299712,12,7343444
2016-07-16,58,58,57,58,3373661,31,489138,127,4,3222980,150681,-2733842,2733842,9,2884523
2016-07-17,58,60,58,58,6199700,85,3704921,132,4,3337571,2862129,367350,-367350,10,2494779
2016-07-18,58,59,58,58,4687447,34,526849,127,5,3059904,1627543,-2533055,1233055,10,2860598
2016-07-19,60,60,58,58,9363428,103,2646347,155,5,7555091,1808337,-4908744,4908744,14,6717081
2016-07-25,60,60,58,58,3295976,64,1553340,77,5,2687460,608516,-1134120,1134120,7,1742636
2016-07-26,57,60,57,60,1629996,39,348445,113,1,1445034,184962,-1096589,1096589,7,1281551
2016-07-27,59,60,58,59,2355500,41,1232340,60,10,1394327,961173,-161987,161987,5,1123160
2016-07-31,59,61,58,59,4608348,67,970280,112,2,2906348,1702000,-1936068,1936068,8,3638068
2016-08-01,59,59,58,58,1907426,34,1666921,88,0,1907426,0,-240505,240505,2,240505
2016-08-02,59,59,58,59,1502040,37,916385,100,3,1152040,350000,-235655,235655,5,585655
2016-08-03,59,60,59,59,779627,47,729627,66,0,929627,0,-200000,200000,2,200000
2016-08-06,59,60,58,58,3618687,71,1923859,93,3,2813212,805475,-889353,889353,4,1694828
2016-08-07,58,60,58,58,3625113,69,2082113,109,4,3007975,617138,-925862,925862,6,1543000
2016-08-08,58,59,58,58,1590458,43,1253575,59,0,1590458,0,-336883,336883,3,336883
2016-08-09,58,58,57,58,1014718,48,310969,61,2,957188,57530,-646219,646219,4,703749
2016-08-10,58,58,57,57,2179483,84,871443,75,2,1777808,401675,-906365,906365,6,1308040
2016-08-13,57,59,57,58,2549552,75,884494,87,3,1877158,672394,-992664,992664,6,1665058
2016-08-14,58,59,57,58,1996895,56,1720506,95,3,1853657,143238,-133151,133151,3,276389
2016-08-15,58,58,57,58,2150996,26,1515264,83,1,1805511,345485,-290247,290247,3,635732
2016-08-16,57,58,56,57,11166210,66,1800039,62,5,1972176,9194034,-172137,172137,7,9366171
2016-08-17,58,58,57,57,1368534,35,513965,51,0,1368534,0,-854569,854569,3,854569
2016-08-20,58,58,56,56,2476681,69,712321,66,1,2376681,100000,-1664360,1664360,7,1764360
2016-08-21,56,57,56,56,1784112,82,814982,61,1,1748995,35117,-934013,934013,6,969130
2016-08-22,56,57,56,56,5155429,73,1038168,73,3,2623143,2532286,-1584975,1584975,11,4117261
2016-08-23,56,57,55,55,1035500,78,375500,37,0,1035500,0,-660000,660000,4,660000
2016-08-24,56,56,55,55,4225479,134,1197145,36,5,2499255,1726224,-1302110,1302110,6,3028334
2016-08-27,56,56,54,54,1957486,90,1134126,73,2,1357486,600000,-223360,223360,1,823360
2016-08-28,54,56,51,52,24815058,345,7948469,163,15,11191098,13623960,-3242629,3242629,22,16866589
2016-08-29,52,53,52,52,1983587,70,1139589,57,2,1107680,875907,31909,-31909,4,843998
2016-08-30,52,52,52,52,1033352,55,433352,41,2,809434,223918,-376082,376082,5,600000
2016-08-31,52,52,52,52,1006684,54,496489,52,3,966509,40175,-470020,470020,6,510195
2016-09-03,52,52,51,51,1980575,47,1494989,81,2,1546445,434130,-51456,51456,1,485586
2016-09-04,52,52,51,51,2433855,61,1243355,67,2,2101092,332763,-857737,857737,3,1190500
2016-09-05,52,52,50,50,1256400,64,682876,28,0,1256400,0,-573524,573524,2,573524
2016-09-06,50,53,50,52,1120538,56,720538,80,1,1120438,100,-399900,399900,1,400000
2016-09-07,52,53,52,52,2162582,47,1165047,89,3,1755582,407000,-590535,590535,4,997535
2016-09-10,52,53,51,52,1000456,22,825456,57,2,870456,130000,-45000,45000,1,175000
2016-09-11,53,53,52,52,1496179,35,638101,79,2,1086179,410000,-448078,448078,5,858078
2016-09-13,52,53,52,52,1611025,17,906025,61,2,995985,615040,-89960,89960,2,705000
2016-09-14,53,53,51,52,739928,43,284006,38,1,605339,134589,-321333,321333,2,455922
2016-09-17,53,55,52,55,12737469,81,2887469,234,11,6485774,6251695,-3598305,3598305,3,9850000
2016-09-18,55,56,53,53,1402888,77,1202888,78,2,974371,428517,228517,-228517,1,200000
2016-09-19,53,55,53,55,2272486,54,853195,121,5,1850993,421493,-997798,997798,2,1419291
2016-09-21,54,55,54,54,1851017,38,551017,66,2,926743,924274,-375726,375726,3,1300000
2016-09-24,54,57,54,57,3817784,122,2049819,144,7,2584388,1233396,-534569,534569,5,1767965
2016-09-25,57,57,54,55,1838051,94,1438051,79,1,1697435,140616,-259384,259384,1,400000
2016-09-26,54,55,53,54,1720632,131,1614937,61,2,1114132,606500,500805,-500805,2,105695
2016-09-27,52,53,52,53,1018629,88,1018629,45,1,1017339,1290,1290,-1290,0,0
2016-09-28,53,55,52,53,1532280,98,1532280,110,2,1490280,42000,42000,-42000,0,0
2016-10-01,54,55,52,52,6190312,299,6040312,55,2,1217428,4972884,4822884,-4822884,2,150000
2016-10-02,52,52,52,52,1846689,132,1846689,64,1,1826689,20000,20000,-20000,0,0
2016-10-03,53,54,52,54,12000408,248,8493443,313,10,7010041,4990367,1483402,-1483402,7,3506965
2016-10-04,52,55,51,53,7122785,247,4876370,150,5,3281785,3841000,1594585,-1594585,6,2246415
2016-10-05,53,53,52,52,2487980,145,2083980,78,2,1917980,570000,166000,-166000,3,404000
2016-10-08,52,53,51,52,1493140,110,1124830,64,1,1483140,10000,-358310,358310,2,368310
2016-10-09,52,52,51,52,2742197,117,1638197,60,4,2029933,712264,-391736,391736,3,1104000
2016-10-10,51,53,51,53,1678469,52,1078469,104,1,1576356,102113,-497887,497887,1,600000
2016-10-15,53,53,52,53,1148872,104,959577,49,1,1120684,28188,-161107,161107,2,189295
2016-10-16,53,53,51,51,1328187,87,923187,53,2,1292084,36103,-368897,368897,3,405000
2016-10-17,52,52,51,52,817844,63,617844,56,2,745645,72199,-127801,127801,1,200000
2016-11-07,51,53,51,51,6196387,228,5446387,91,8,4333604,1862783,1112783,-1112783,4,750000
2016-11-08,51,51,49,49,12540732,648,10520732,186,14,10216716,2324016,304016,-304016,6,2020000
2016-11-09,47,47,47,47,3388756,212,2668756,76,1,2988756,400000,-320000,320000,7,720000
2016-11-12,47,47,45,45,5237076,247,3606145,161,2,4957076,280000,-1350931,1350931,6,1630931
2016-11-13,46,46,45,45,2238363,87,1326629,92,2,1191863,1046500,134766,-134766,5,911734
2016-11-14,45,47,45,46,2925216,111,2285216,99,1,2487165,438051,-201949,201949,3,640000
2016-11-15,46,47,45,45,2479386,127,1304386,84,2,2466286,13100,-1161900,1161900,4,1175000
2016-11-16,46,46,45,45,2472746,73,1210111,77,1,2172746,300000,-962635,962635,5,1262635
2016-11-19,46,46,45,45,1737590,55,687590,73,1,1537590,200000,-850000,850000,2,1050000
2016-11-21,45,46,45,45,1388084,97,827198,71,0,1711868,0,-884670,884670,6,884670
2016-11-22,45,45,44,45,1364459,69,812775,63,0,1364459,0,-551684,551684,4,551684
2016-11-23,45,45,44,44,2538880,104,1559544,51,0,2538880,0,-979336,979336,4,979336
2016-11-26,45,45,44,44,2211411,85,1101411,71,4,1734652,476759,-633241,633241,3,1110000
2016-11-27,44,45,44,45,3230948,59,1867294,69,3,1710496,1520452,156798,-156798,3,1363654
2016-11-29,44,45,44,44,1640957,66,686278,72,0,1640957,0,-954679,954679,1,954679
2016-12-03,44,45,42,42,7012664,165,1723359,118,6,3996671,3015993,-2273312,2273312,7,5289305
2016-12-04,42,43,41,42,1982059,73,1124701,72,2,1750954,231105,-626253,626253,5,857358
2016-12-05,42,43,42,42,1556550,72,1006550,45,3,1307056,249494,-300506,300506,2,550000
2016-12-06,43,43,42,42,2116309,72,1308235,62,3,1564596,551713,-256361,256361,2,808074
2016-12-07,42,44,42,44,5016330,103,1675920,134,6,2861251,2155079,-1185331,1185331,4,3340410
2016-12-10,44,45,42,43,1313474,79,793474,71,3,1214946,98528,-421472,421472,3,520000
2016-12-11,43,44,43,43,1218292,53,598284,54,1,1193292,25000,-595008,595008,3,620008
2016-12-12,43,43,42,42,2021901,81,512171,56,1,1813501,212400,-1301330,1301330,4,1513730
2016-12-13,42,43,42,42,1988962,55,468962,37,2,1773962,215000,-1305000,1305000,3,1520000
2016-12-14,42,43,42,43,1918485,47,1065158,76,2,1676027,242458,-610869,610869,3,853327
2016-12-18,42,43,42,42,665103,45,547103,38,2,594361,70742,-47258,47258,1,118000
2016-12-19,42,42,42,42,753683,40,398975,37,1,723683,30000,-324708,324708,2,354708
2016-12-20,42,42,41,41,1568881,39,385589,57,0,1568881,0,-1183292,1183292,2,1183292
2016-12-21,42,43,42,42,934123,24,286044,49,2,684935,249188,-398891,398891,2,648079
2016-12-24,42,43,42,42,1437778,44,809038,49,3,629947,807831,179091,-179091,2,628740
2016-12-25,42,42,41,42,1206927,42,531085,41,2,706283,500644,-175198,175198,4,675842
2016-12-26,41,42,41,41,1038126,37,408459,51,1,934357,103769,-525898,525898,3,629667
2016-12-27,41,41,40,41,1077639,29,156717,61,0,1077639,0,-920922,920922,3,920922
2016-12-28,42,42,41,41,746318,20,193567,37,1,731319,14999,-537752,537752,4,552751
2016-12-31,41,42,41,42,571019,29,382019,51,1,511019,60000,-129000,129000,3,189000
2017-01-01,42,42,40,41,2829398,31,529058,43,11,783775,2045623,-254717,254717,6,2300340
2017-01-02,41,41,40,41,770861,33,267466,34,1,757197,13664,-489731,489731,3,503395
2017-01-03,40,41,39,40,1042824,54,530548,34,4,464979,577845,65569,-65569,5,512276
2017-01-04,41,41,39,40,1056115,15,66416,38,1,573815,500000,-507399,507399,4,1007399
2017-01-07,40,40,39,40,1238283,27,155191,55,2,1118283,120000,-963092,963092,6,1083092
2017-01-08,40,40,39,39,1917339,58,901339,67,3,1046986,870353,-145647,145647,4,1016000
2017-01-09,39,40,39,39,1609879,48,418196,51,1,609879,1000000,-191683,191683,7,1191683
2017-01-11,39,40,38,40,1591061,41,754725,87,0,1591061,0,-836336,836336,7,836336
2017-01-14,40,41,40,41,3250633,76,1662582,124,3,1535025,1715608,127557,-127557,5,1588051
2017-01-15,42,42,41,42,1462865,59,706072,66,1,1248265,214600,-542193,542193,5,756793
2017-01-16,42,42,40,41,865273,32,317924,56,0,865273,0,-547349,547349,4,547349
2017-01-17,41,42,41,42,481220,28,296220,44,0,481220,0,-185000,185000,2,185000
2017-01-18,41,42,41,41,1067547,42,614576,62,2,1029847,37700,-415271,415271,6,452971
2017-01-21,41,42,40,40,1042245,49,452216,31,0,1042245,0,-590029,590029,6,590029
2017-01-22,40,41,40,40,407817,33,276101,17,0,407817,0,-131716,131716,2,131716
2017-01-23,41,41,40,41,523503,33,273443,39,0,523503,0,-250060,250060,4,250060
2017-01-24,41,41,40,40,1654674,52,823734,64,2,949674,705000,-125940,125940,7,830940
2017-01-25,40,40,40,40,1072232,46,196152,41,1,572232,500000,-376080,376080,4,876080
2017-01-28,40,40,39,40,589359,26,418527,37,1,489359,100000,-70832,70832,3,170832
2017-01-29,39,40,39,40,1021607,32,475592,45,3,654457,367150,-178865,178865,3,546015
2017-01-30,39,41,39,40,6087752,181,4390623,68,4,2195510,3892242,2195113,-2195113,7,1697129
2017-01-31,41,41,39,39,2805154,167,2542154,67,6,1517518,1287636,1024636,-1024636,4,263000
2017-02-01,40,40,39,40,2866122,57,2288784,70,5,1714487,1151635,574297,-574297,4,577338
2017-02-04,39,40,39,39,801433,55,641433,44,2,771383,30050,-129950,129950,2,160000
2017-02-05,39,39,39,39,1169508,64,987258,79,2,1059508,110000,-72250,72250,3,182250
2017-02-06,39,40,39,39,1002537,53,902537,48,1,972537,30000,-70000,70000,1,100000
2017-02-07,39,39,39,39,1662882,52,1077780,30,2,962882,700000,114898,-114898,3,585102
2017-02-08,40,40,38,39,1147722,84,955722,37,1,798015,349707,157707,-157707,2,192000
2017-02-11,39,39,38,38,1281494,103,1076494,52,2,1136037,145457,-59543,59543,3,205000
2017-02-12,38,38,37,37,1275531,106,872368,48,1,1013790,261741,-141422,141422,2,403163
2017-02-13,37,39,37,37,925734,55,583226,48,1,859975,65759,-276749,276749,2,342508
2017-02-14,38,38,37,38,1357331,46,1030965,57,3,1086532,283799,-55567,55567,5,339366
2017-02-15,38,38,37,38,1354726,47,929278,47,3,1128037,226689,-198759,198759,7,425448
2017-02-18,38,39,37,38,1667666,68,1557714,55,4,1015429,652237,542285,-542285,2,109952
2017-02-19,38,39,38,38,1142892,49,1042792,49,3,710192,432700,332600,-332600,2,100100
2017-02-20,38,38,38,38,1596891,57,808888,34,1,1550152,46739,-741264,741264,5,788003
2017-02-21,38,39,38,38,1764438,42,954450,58,0,1764438,0,-809988,809988,7,809988
2017-02-22,38,39,38,38,1020266,47,1020266,61,0,1020266,0,0,0,0,0
2017-02-25,39,39,38,39,1091478,42,991478,72,0,1091478,0,-100000,100000,1,100000
2017-02-26,39,39,38,39,1514103,61,1208344,44,0,1514103,0,-305759,305759,3,305759
2017-02-27,39,39,38,38,1107828,31,995622,53,1,738827,369001,256795,-256795,2,112206
2017-02-28,38,40,38,38,2217589,77,1658497,67,2,1079542,1138047,578955,-578955,4,559092
2017-03-01,38,39,38,38,1490898,32,1090898,31,1,674695,816203,416203,-416203,2,400000
2017-03-04,38,38,38,38,896563,23,208581,46,1,497890,398673,-289309,289309,3,687982
2017-03-05,38,38,38,38,1129170,31,460232,40,3,629170,500000,-168938,168938,4,668938
2017-03-06,38,39,38,38,1403225,24,308565,41,1,903225,500000,-594660,594660,5,1094660
2017-03-07,38,39,38,38,1498015,21,342162,42,1,1198015,300000,-855853,855853,9,1155853
2017-03-08,38,39,38,38,1238236,31,380701,49,1,1038236,200000,-657535,657535,4,857535
2017-03-11,38,38,38,38,1721971,35,288310,58,1,1125534,596437,-837224,837224,2,1433661
2017-03-12,38,38,38,38,1382018,29,371601,41,3,793952,588066,-422351,422351,2,1010417
2017-03-13,38,38,38,38,2001296,42,955906,52,3,1131862,869434,-175956,175956,3,1045390
2017-03-14,39,39,38,38,2041389,47,918089,37,4,957789,1083600,-39700,39700,3,1123300
2017-03-15,38,39,38,38,3006003,51,1903236,23,4,464769,2541234,1438467,-1438467,2,1102767
2017-03-18,39,39,38,39,5275456,84,5175456,54,2,1464839,3810617,3710617,-3710617,1,100000
2017-03-25,39,40,39,40,3132301,69,2732301,73,5,1272300,1860001,1460001,-1460001,1,400000
2017-03-26,41,42,41,42,7958341,188,6458341,189,6,4529579,3428762,1928762,-1928762,1,1500000
2017-03-27,42,43,41,42,1299068,71,1063922,83,2,1297015,2053,-233093,233093,2,235146
2017-03-28,42,43,41,43,2898231,90,2598231,148,2,2042109,856122,556122,-556122,2,300000
2017-03-29,42,43,42,42,1162502,44,1062502,60,2,568125,594377,494377,-494377,1,100000
2017-04-03,43,43,42,42,1370654,69,1270654,54,1,1250654,120000,20000,-20000,1,100000
2017-04-04,42,43,42,42,1076189,33,621622,68,0,1076189,0,-454567,454567,3,454567
2017-04-05,42,43,42,43,3440725,72,2513764,128,1,2740026,700699,-226262,226262,4,926961
2017-04-08,43,45,42,45,5230131,59,2407696,153,6,2382219,2847912,25477,-25477,9,2822435
2017-04-09,45,47,45,45,4520487,164,4014133,141,5,3376049,1144438,638084,-638084,6,506354
2017-04-10,45,46,44,44,6020246,201,5065016,137,5,4026857,1993389,1038159,-1038159,6,955230
2017-04-12,44,44,44,44,2324931,134,2004931,95,1,2174931,150000,-170000,170000,4,320000
2017-04-15,44,45,44,44,5959432,140,3403432,116,3,3519870,2439562,-116438,116438,13,2556000
2017-04-16,44,45,43,44,5491598,160,3520959,109,5,3569866,1921732,-48907,48907,12,1970639
2017-04-17,44,44,43,43,3351494,68,1359620,90,1,2370197,981297,-1010577,1010577,9,1991874
2017-04-18,44,44,42,43,2546509,109,1986509,53,1,1746509,800000,240000,-240000,7,560000
2017-04-19,43,43,42,43,1110766,49,769170,61,2,1067766,43000,-298596,298596,5,341596
2017-04-22,43,45,43,44,5361920,143,4636670,149,1,3450166,1911754,1186504,-1186504,5,725250
2017-04-23,44,45,44,44,2724945,70,1201922,75,1,2605180,119765,-1403258,1403258,6,1523023
2017-04-24,43,44,43,43,3454333,66,1302084,81,2,3401504,52829,-2099420,2099420,6,2152249
2017-04-26,43,44,43,44,1489664,39,802665,69,1,1431758,57906,-629093,629093,4,686999
2017-04-29,44,44,43,44,2360055,46,913101,86,1,1671639,688416,-758538,758538,6,1446954
2017-04-30,43,44,43,44,2314386,32,860192,99,2,2211421,102965,-1351229,1351229,5,1454194
2017-05-01,43,44,43,44,3683695,25,1936092,69,1,3032992,650703,-1096900,1096900,4,1747603
2017-05-02,44,45,43,44,7328853,47,1026343,87,3,1325925,6002928,-299582,299582,9,6302510
2017-05-03,44,44,43,43,7110730,40,1419874,49,3,1253600,5857130,166274,-166274,8,5690856
2017-05-06,43,44,43,43,2838362,24,2016219,82,1,2738362,100000,-722143,722143,4,822143
2017-05-07,43,44,43,43,2178338,41,1052972,74,1,2078338,100000,-1025366,1025366,6,1125366
2017-05-08,43,43,43,43,2314702,24,448723,42,2,2204702,110000,-1755979,1755979,8,1865979
2017-05-09,44,44,42,44,1794621,36,838515,74,0,1794621,0,-956106,956106,7,956106
2017-05-10,44,44,43,43,2350511,38,1077511,49,1,2054362,296149,-976851,976851,7,1273000
2017-05-13,44,44,42,42,382891,31,239891,15,1,182891,200000,57000,-57000,3,143000
2017-05-14,42,43,42,42,581972,26,481972,27,1,481972,100000,0,0,1,100000
2017-05-15,42,44,42,42,1705089,33,1335089,52,2,1441246,263843,-106157,106157,5,370000
2017-05-16,42,44,42,43,599845,18,449845,38,1,549845,50000,-100000,100000,2,150000
2017-05-17,43,43,43,43,2150589,40,1480589,39,1,2100589,50000,-620000,620000,7,670000
2017-05-20,44,45,44,45,11037424,50,4010313,150,7,8346424,2691000,-4336111,4336111,4,7027111
2017-05-21,45,46,44,44,1476285,38,925933,92,1,1475185,1100,-549252,549252,4,550352
2017-05-22,44,44,43,44,1616938,39,1316290,33,4,976938,640000,339352,-339352,4,300648
2017-05-23,43,43,43,43,551813,46,451813,32,1,501813,50000,-50000,50000,1,100000
2017-05-24,43,43,43,43,1176036,43,453872,32,3,716036,460000,-262164,262164,5,722164
2017-05-27,43,44,42,42,2913597,44,934542,35,0,2913597,0,-1979055,1979055,21,1979055
2017-05-28,43,43,42,42,4546545,27,2334428,42,0,4546545,0,-2212117,2212117,11,2212117
2017-05-29,42,43,42,42,376045,17,99456,33,0,376045,0,-276589,276589,4,276589
2017-05-30,42,43,42,43,1355747,25,858480,48,1,1055747,300000,-197267,197267,6,497267
2017-05-31,42,43,42,43,980760,24,180801,36,1,880760,100000,-699959,699959,10,799959
2017-06-03,43,44,42,44,3264506,25,2125244,99,2,2464506,800000,-339262,339262,4,1139262
2017-06-06,44,45,43,44,2074106,28,1183971,75,3,1771110,302996,-587139,587139,4,890135
2017-06-07,43,45,42,44,3116033,48,796112,99,3,2262858,853175,-1466746,1466746,14,2319921
2017-06-10,46,46,46,46,2733665,27,2433665,78,5,2173665,560000,260000,-260000,1,300000
2017-06-11,48,48,46,46,9652907,261,7698657,208,19,5124186,4528721,2574471,-2574471,9,1954250
2017-06-12,46,46,45,45,4271814,89,3570193,99,3,2457530,1814284,1112663,-1112663,9,701621
2017-06-13,46,46,45,45,4457688,59,2621845,56,6,1912355,2545333,709490,-709490,12,1835843
2017-06-14,46,48,46,48,6635303,87,3918970,223,10,4927703,1707600,-1008733,1008733,9,2716333
2017-06-17,48,48,46,46,1718591,66,1360531,48,2,985321,733270,375210,-375210,5,358060
2017-06-18,46,46,45,46,1867311,36,659277,47,3,979962,887349,-320685,320685,12,1208034
2017-06-19,46,46,45,46,2361251,32,784987,53,5,939852,1421399,-154865,154865,9,1576264
2017-06-20,46,46,46,46,2614310,23,604186,43,4,1057160,1557150,-452974,452974,4,2010124
2017-06-21,46,46,46,46,3057886,34,907487,34,6,2455366,602520,-1547879,1547879,21,2150399
2017-06-24,46,48,45,45,5056399,68,2209109,60,7,837075,4219324,1372034,-1372034,8,2847290
2017-06-25,46,46,45,45,14030051,55,5607238,19,5,292458,13837593,5314780,-5314780,22,8522813
2017-06-28,45,46,45,46,1824332,21,764227,45,2,853325,971007,-89098,89098,6,1060105
2017-07-01,46,47,45,46,4500292,79,3986970,55,4,3583505,916787,403465,-403465,5,513322
2017-07-02,46,46,45,46,1513292,23,586042,69,1,1253292,260000,-667250,667250,9,927250
2017-07-03,46,46,45,45,1320630,44,407108,41,3,910430,410200,-503322,503322,9,913522
2017-07-04,45,46,45,45,1782606,45,723587,43,2,907917,874689,-184330,184330,8,1059019
2017-07-05,45,46,45,45,3497488,30,1286791,58,3,1941179,1556309,-654388,654388,10,2210697
2017-07-08,45,46,45,46,7068798,95,2958632,138,1,6445241,623557,-3486609,3486609,20,4110166
2017-08-20,47,48,46,47,11234314,154,11113933,113,8,7085583,4148731,4028350,-4028350,1,120381
2017-08-21,48,49,47,47,5384303,181,5354103,87,7,4749303,635000,604800,-604800,1,30200
2017-08-22,48,48,47,47,9439383,67,6449054,66,5,8626336,813047,-2177282,2177282,5,2990329
2017-08-23,47,47,46,47,7562231,106,2210867,63,3,7375601,186630,-5164734,5164734,9,5351364
2017-08-26,47,47,46,46,8828660,129,6281682,64,3,7405436,1423224,-1123754,1123754,2,2546978
2017-08-27,46,47,45,47,7235258,77,3228432,60,4,6921756,313502,-3693324,3693324,4,4006826
2017-08-28,47,48,47,47,5083626,67,2114195,91,3,3984079,1099547,-1869884,1869884,5,2969431
2017-08-30,48,48,46,47,3432523,62,1723838,42,2,2973011,459512,-1249173,1249173,24,1708685
2017-09-02,47,47,46,46,1620023,75,1620023,42,1,1457493,162530,162530,-162530,0,0
2017-09-03,46,47,46,46,2845471,77,1830661,61,2,2559353,286118,-728692,728692,2,1014810
2017-09-04,47,47,45,46,1549450,87,1549450,25,1,1545845,3605,3605,-3605,0,0
2017-09-05,45,46,45,46,221057,28,192557,18,1,220860,197,-28303,28303,1,28500
2017-09-06,46,46,45,46,1344208,50,755793,31,2,1115356,228852,-359563,359563,3,588415
2017-09-10,44,46,44,45,900621,49,594203,29,1,840661,59960,-246458,246458,2,306418
2017-09-11,45,45,43,44,4630755,98,2971616,44,1,4595421,35334,-1623805,1623805,4,1659139
2017-09-12,44,45,44,45,1061539,38,350420,74,1,1052768,8771,-702348,702348,3,711119
2017-09-13,45,46,45,45,1174755,31,707453,81,5,981758,192997,-274305,274305,2,467302
2017-09-16,45,45,44,44,9893890,47,7969231,37,4,8347055,1546835,-377824,377824,3,1924659
2017-09-17,44,45,44,45,2374496,43,830952,46,2,2034162,340334,-1203210,1203210,4,1543544
2017-09-18,45,46,45,45,4728627,39,1140513,34,3,1589512,3139115,-448999,448999,5,3588114
2017-09-19,46,46,45,45,3812939,56,1069412,30,2,844160,2968779,225252,-225252,6,2743527
2017-09-20,45,47,45,47,14354119,43,4192809,124,9,4786880,9567239,-594071,594071,6,10161310
2017-09-23,48,49,47,47,6856283,116,5690698,119,4,6200372,655911,-509674,509674,6,1165585
2017-09-24,48,48,46,47,3788221,60,1930921,75,4,2833314,954907,-902393,902393,5,1857300
2017-09-25,48,48,46,46,1509545,79,1000364,37,1,807058,702487,193306,-193306,4,509181
2017-09-26,47,47,46,46,3299794,80,1690972,39,1,2696114,603680,-1005142,1005142,4,1608822
2017-09-27,46,47,46,46,2218746,71,1120700,33,1,1784173,434573,-663473,663473,3,1098046
2017-10-02,46,46,45,45,2529694,84,1133107,30,1,1527423,1002271,-394316,394316,4,1396587
2017-10-03,45,46,44,44,1592907,89,1489494,19,1,522615,1070292,966879,-966879,2,103413
2017-10-04,45,45,44,44,3319800,98,1814912,25,1,1592200,1727600,222712,-222712,4,1504888
2017-10-07,44,44,43,44,11492978,62,1027130,58,3,11094434,398544,-10067304,10067304,7,10465848
2017-10-08,44,44,42,44,9207011,71,1095543,79,3,5505238,3701773,-4409695,4409695,4,8111468
2017-10-09,44,44,43,43,2949692,41,399692,35,1,2416424,533268,-2016732,2016732,4,2550000
2017-10-10,44,44,43,43,7307290,77,3952290,30,2,6046915,1260375,-2094625,2094625,5,3355000
2017-10-11,43,43,43,43,2191181,31,963333,28,1,1599466,591715,-636133,636133,4,1227848
2017-10-14,44,44,43,43,1034400,50,776119,30,0,1034400,0,-258281,258281,3,258281
2017-10-15,43,44,43,43,1027622,36,685881,33,0,1027622,0,-341741,341741,4,341741
2017-10-16,43,44,43,44,6570246,19,1066685,79,4,3146278,3423968,-2079593,2079593,6,5503561
2017-10-17,44,45,44,44,5467269,17,300292,97,5,3399105,2068164,-3098813,3098813,5,5166977
2017-10-18,45,45,44,44,2272026,33,575848,79,2,2248902,23124,-1673054,1673054,4,1696178
2017-10-21,45,45,43,44,5831238,50,1823890,63,3,3665746,2165492,-1841856,1841856,4,4007348
2017-10-22,45,45,44,44,4899699,22,1975645,29,3,1703573,3196126,272072,-272072,3,2924054
2017-10-23,45,45,44,44,7488205,29,1294618,53,3,2457206,5030999,-1162588,1162588,5,6193587
2017-10-24,43,44,43,44,12827773,32,1207371,40,5,3365918,9461855,-2158547,2158547,4,11620402
2017-10-25,44,44,43,44,28221072,62,2983081,47,3,3337370,24883702,-354289,354289,7,25237991
2017-10-28,44,46,44,46,11171037,68,2764674,142,8,6278699,4892338,-3514025,3514025,3,8406363
2017-10-29,46,47,46,46,6025037,54,2655055,99,7,2649843,3375194,5212,-5212,1,3369982
2017-10-30,46,48,46,47,7526419,69,2201701,150,10,4198278,3328141,-1996577,1996577,2,5324718
2017-10-31,47,48,46,47,8477955,90,2650547,118,11,2965132,5512823,-314585,314585,4,5827408
2017-11-01,48,48,46,47,1657471,46,670599,58,10,1084482,572989,-413883,413883,1,986872
2017-11-04,48,48,46,47,3157271,50,1095829,58,1,2168327,988944,-1072498,1072498,1,2061442
2017-11-05,47,48,46,48,1506322,50,1031265,76,1,1440264,66058,-408999,408999,2,475057
2017-11-06,48,48,47,47,947074,19,847074,37,0,947074,0,-100000,100000,1,100000
2017-11-07,47,47,47,47,3451047,17,469544,70,2,2420081,1030966,-1950537,1950537,1,2981503
2017-11-08,47,47,46,46,1128056,26,709559,28,3,803738,324318,-94179,94179,2,418497
2017-11-11,47,47,46,46,1421525,13,117820,38,0,1421525,0,-1303705,1303705,4,1303705
2017-11-12,46,47,46,46,1515980,34,306146,47,5,1149481,366499,-843335,843335,1,1209834
2017-11-13,46,47,45,47,1451373,30,666273,54,1,1259658,191715,-593385,593385,5,785100
2017-11-14,46,47,46,46,1200044,36,918262,28,2,795310,404734,122952,-122952,3,281782
2017-11-15,46,47,46,46,4139328,26,628776,40,2,2132526,2006802,-1503750,1503750,12,3510552
2017-11-18,47,47,46,46,765930,22,242678,16,0,765930,0,-523252,523252,10,523252
2017-11-20,46,46,46,46,2709760,15,291444,28,3,1326329,1383431,-1034885,1034885,15,2418316
2017-11-21,46,47,46,47,5909996,17,1392646,84,5,3419726,3199004,-2027080,2027080,6,5226084
2017-11-22,46,48,46,48,8927350,35,3160602,119,3,7194644,1732706,-4034042,4034042,20,5766748
2017-11-25,47,50,47,50,29873649,82,13359301,259,11,8611251,21262398,4748050,-4748050,14,16514348
2017-11-26,50,52,49,52,35455869,149,9942079,283,44,13836011,21619858,-3893932,3893932,13,25513790
2017-11-28,52,53,51,52,7071824,109,3443463,175,6,4945804,2126020,-1502341,1502341,6,3628361
2017-11-29,51,54,51,54,7035809,92,3329817,165,6,5089957,1945852,-1760140,1760140,6,3705992
2017-12-02,53,54,53,53,5339234,65,2352355,101,4,2947399,2391793,-595044,595044,5,2986837
2017-12-03,54,54,51,52,6432222,98,3271369,67,2,2767424,3664798,503945,-503945,3,3160853
2017-12-04,51,52,50,52,7015852,54,1315187,77,2,2178735,4837117,-863548,863548,6,5700665
2017-12-05,51,53,51,51,3304207,46,1368257,65,1,2950524,362883,-1582267,1582267,4,1945150
2017-12-09,51,54,51,54,10594398,75,7707407,148,2,7605006,2989392,102401,-102401,3,2886991
2017-12-10,52,54,52,52,2492364,50,1674144,49,0,2492364,0,-818220,818220,2,818220
2017-12-11,52,55,52,54,3125518,84,2771733,103,3,2464985,660533,306748,-306748,3,353785
2017-12-12,54,55,52,53,7754000,94,2927854,75,1,7673363,80637,-4745509,4745509,3,4826146
2017-12-13,53,54,52,52,3514035,60,1215932,57,2,2010436,1503599,-794504,794504,23,2298103
2017-12-16,54,54,52,52,3681534,70,2555375,79,2,2344868,1336666,210507,-210507,5,1126159
2017-12-17,52,55,52,53,7019039,46,2807537,76,3,5839669,1179370,-3032132,3032132,8,4211502
2017-12-18,53,55,52,55,8906585,97,5977526,127,4,6398125,2508460,-420599,420599,4,2929059
2017-12-19,54,55,53,53,3093037,65,1623037,73,2,2834851,258186,-1211814,1211814,4,1470000
2017-12-20,53,54,52,53,7870480,77,2190573,60,3,2295480,1639760,-104907,104907,9,1744667
2017-12-23,53,53,52,52,5491799,80,3628899,44,3,2887875,2603924,741024,-741024,7,1862900
2017-12-24,52,55,52,54,11488183,88,9359132,177,6,6489132,4999051,2870000,-2870000,5,2129051
2017-12-25,54,55,53,53,8480528,66,2714561,47,1,1314561,2000000,1400000,-1400000,3,600000
2017-12-26,55,55,54,54,3683013,72,3706440,101,3,3458299,348141,248141,-248141,1,100000
2017-12-27,55,56,54,55,3192952,59,2990952,123,3,3073686,119266,-82734,82734,3,202000
2017-12-30,54,54,52,52,5452968,100,4080702,93,1,4703987,748981,-623285,623285,5,1372266
2017-12-31,52,53,51,52,9695882,94,2261579,166,1,9595882,100000,-7334303,7334303,29,7434303
2018-01-01,53,53,51,53,4210169,82,3145408,60,4,2395124,1815045,750284,-750284,2,1064761
2018-01-02,53,53,52,53,3229465,29,335376,61,2,2792035,437430,-2456659,2456659,4,2894089
2018-01-03,53,53,52,52,3223742,49,1026644,48,0,1611871,0,-585227,585227,5,585227
2018-01-06,52,53,52,52,3271689,69,2582523,38,1,1271689,2000000,1310834,-1310834,4,689166
2018-01-07,52,53,52,52,2953513,38,555804,45,3,2302435,651078,-1746631,1746631,18,2397709
2018-01-08,52,53,52,52,2696885,42,802910,47,4,1600991,1095894,-798081,798081,10,1893975
2018-01-09,53,53,52,52,2411678,41,904018,48,0,2411678,0,-1507660,1507660,4,1507660
2018-01-10,53,53,52,53,2086901,39,1150146,64,1,1938774,148127,-788628,788628,3,936755
2018-01-13,53,54,52,52,6581065,79,3256065,46,3,1218388,5362677,2037677,-2037677,5,3325000
2018-01-14,53,53,52,53,25794663,74,1883311,44,2,1395617,24399046,487694,-487694,6,23911352
2018-01-15,52,52,51,52,8220710,72,1269835,43,1,3220710,5000000,-1950875,1950875,6,6950875
2018-01-16,52,52,51,52,8315828,42,1591489,64,3,2865828,5450000,-1274339,1274339,7,6724339
2018-01-17,51,53,51,52,8446751,70,1906367,67,2,2311023,6135728,-404656,404656,11,6540384
2018-01-20,53,53,52,52,2195515,58,1210874,42,0,2195515,0,-984641,984641,4,984641
2018-01-21,51,51,50,51,5301719,89,1901719,65,1,2879858,2421861,-978139,978139,5,3400000
2018-01-22,51,51,50,51,3544874,66,1009731,41,3,1436813,2108061,-427082,427082,6,2535143
2018-01-23,51,52,50,51,2413213,52,1303213,29,2,1584621,828592,-281408,281408,3,1110000
2018-01-24,50,51,50,50,5083907,85,1918952,47,2,1914082,3169825,4870,-4870,5,3164955
2018-01-27,50,51,49,50,2183965,93,1830965,50,1,2087085,96880,-256120,256120,14,353000
2018-01-28,51,51,50,50,2145589,35,1712589,32,2,939664,1205925,772925,-772925,11,433000
2018-01-29,50,50,49,50,1300183,52,836334,51,1,1256683,43500,-420349,420349,2,463849
2018-01-30,50,50,49,50,1679695,27,956966,39,1,1344695,335000,-387729,387729,4,722729
2018-01-31,49,50,49,50,2003989,60,1070489,35,2,1259586,744403,-189097,189097,3,933500
2018-02-03,49,49,48,49,1842607,58,766745,49,1,1755527,87080,-988782,988782,5,1075862
2018-02-04,48,49,48,48,1377397,68,1265397,49,1,1093897,283500,171500,-171500,2,112000
2018-02-05,49,51,49,50,2846665,76,2846665,72,1,2493746,352919,352919,-352919,0,0
2018-02-06,50,50,49,49,1217386,64,1217386,38,1,1003386,214000,214000,-214000,0,0
2018-02-07,49,50,49,49,2590650,47,2335196,29,2,1919459,671191,415737,-415737,2,255454
2018-02-10,49,50,48,49,4322768,56,2921648,57,2,2011764,2311004,909884,-909884,2,1401120
2018-02-12,50,52,50,51,9359329,127,6029304,117,6,5036627,4321702,992677,-992677,3,3329025
2018-02-13,51,51,50,50,5061225,69,2848204,54,2,3143225,1918000,-295021,295021,3,2213021
2018-02-14,51,51,50,50,2966502,50,2675052,76,4,2231874,734628,443178,-443178,1,291450
2018-02-17,50,50,50,50,1359545,58,1359545,43,0,1359545,0,0,0,0,0
2018-02-18,50,50,49,49,1188427,54,1188427,31,1,861423,327004,327004,-327004,0,0
2018-02-19,50,50,49,49,850836,57,712786,19,2,592518,258318,120268,-120268,1,138050
2018-02-21,49,51,49,50,2770653,85,2267653,53,5,2268716,501937,-1063,1063,2,503000
2018-02-24,50,53,50,51,40595469,702,39591089,194,15,11313803,29281666,28277286,-28277286,2,1004380
2018-02-25,51,52,51,51,6227685,183,5197685,94,6,3963533,2264152,1234152,-1234152,2,1030000
2018-02-26,51,51,50,50,4806942,178,3796942,52,2,2235044,2571898,1561898,-1561898,2,1010000
2018-02-27,50,51,50,51,2788034,84,2651034,68,2,2355162,432872,295872,-295872,2,137000
2018-02-28,50,52,49,49,9483910,261,8926910,60,5,7289845,2194065,1637065,-1637065,3,557000
2018-03-03,50,51,50,50,5372012,116,5372012,103,4,3409600,1962412,1962412,-1962412,0,0
2018-03-04,51,51,50,50,3724758,158,3525579,59,1,2118191,1606567,1407388,-1407388,2,199179
2018-03-05,50,50,49,49,4528059,124,2423343,57,2,1690110,2837949,733233,-733233,3,2104716
2018-03-06,49,49,48,48,2994387,145,2542903,70,2,1833360,1161027,709543,-709543,4,451484
2018-03-07,48,48,47,48,3258780,184,2708780,78,1,1682983,1575797,1025797,-1025797,2,550000
2018-03-10,47,49,47,48,3809391,123,1645350,57,1,1663254,2146137,-17904,17904,3,2164041
2018-03-11,48,49,48,48,3132995,48,1312076,75,3,2647372,485623,-1335296,1335296,4,1820919
2018-03-12,48,48,48,48,1766673,72,1138221,58,2,1680090,86583,-541869,541869,2,628452
2018-03-13,48,48,47,47,2645004,81,1157015,39,1,2640004,5000,-1482989,1482989,3,1487989
2018-03-14,48,48,47,47,3346080,159,2346080,50,1,3339080,7000,-993000,993000,1,1000000
2018-03-17,47,48,46,47,3283077,111,2380637,72,2,2828697,454380,-448060,448060,3,902440
2018-03-18,47,48,46,48,5405083,43,4505083,32,3,4159112,1245971,345971,-345971,3,900000
2018-03-19,47,48,47,47,1261012,56,1261012,40,2,682973,578039,578039,-578039,0,0
2018-03-25,47,49,46,46,2063463,87,1829526,26,0,2063463,0,-233937,233937,3,233937
2018-03-26,46,47,46,47,1689696,37,1139719,39,1,1489696,200000,-349977,349977,1,549977
2018-03-27,46,47,46,46,1660154,65,1130154,51,1,1644966,15188,-514812,514812,2,530000
2018-03-28,46,48,46,47,3923414,54,1334035,31,2,730066,3193348,603969,-603969,5,2589379
2018-04-03,47,47,46,46,1367289,80,1367289,22,0,1367289,0,0,0,0,0
2018-04-04,47,47,46,46,2002128,110,1802128,37,1,1934515,67613,-132387,132387,1,200000
2018-04-07,46,46,44,46,3668308,102,1237286,81,1,3598869,69439,-2361583,2361583,2,2431022
2018-04-08,46,46,44,45,3376563,57,1226591,75,0,3376563,0,-2149972,2149972,4,2149972
2018-04-09,45,46,43,43,11940718,147,6532648,102,6,7547987,4392731,-1015339,1015339,6,5408070
2018-04-10,45,46,45,45,11477508,72,4947508,90,5,5271414,6206094,-323906,323906,3,6530000
2018-04-11,45,46,44,44,5684374,39,876330,75,1,5545685,138689,-4669355,4669355,5,4808044
2018-04-15,43,45,43,45,3434700,38,1006891,66,4,2692340,742360,-1685449,1685449,4,2427809
2018-04-16,46,46,45,45,2054340,25,1054340,25,6,883027,1171313,171313,-171313,4,1000000
2018-04-17,45,46,44,45,1265004,20,239956,32,0,1265004,0,-1025048,1025048,2,1025048
2018-04-18,45,45,44,44,1250845,29,612986,32,0,1250845,0,-637859,637859,4,637859
2018-04-21,44,45,44,44,853226,27,493956,31,1,828576,24650,-334620,334620,4,359270
2018-04-22,44,45,44,44,1470004,21,551977,57,1,1445354,24650,-893377,893377,2,918027
2018-04-23,45,45,44,44,475304,30,360902,33,0,475304,0,-114402,114402,3,114402
2018-04-24,44,45,44,45,3254537,19,2996326,45,4,3013837,240700,-17511,17511,2,258211
2018-04-25,44,45,44,44,1545583,48,1435583,28,0,1545583,0,-110000,110000,1,110000
2018-04-28,44,45,43,43,2123804,46,1873804,40,1,2076804,47000,-203000,203000,2,250000
2018-04-29,43,45,43,44,2342097,28,782553,68,4,2053792,288305,-1271239,1271239,4,1559544
2018-04-30,43,44,43,44,2933671,29,2480248,37,1,2903671,30000,-423423,423423,3,453423
2018-05-01,43,45,43,45,3096362,24,513041,56,6,2764999,331363,-2251958,2251958,2,2583321
2018-05-05,45,45,43,43,1878555,35,948555,25,2,1658627,219928,-710072,710072,2,930000
2018-05-06,43,44,43,43,1721693,45,472649,34,0,1721693,0,-1249044,1249044,3,1249044
2018-05-07,43,44,43,44,2874956,22,2382056,56,1,2842956,32000,-460900,460900,4,492900
2018-05-08,44,45,44,45,7968995,52,2457265,52,4,5107605,2861390,-2650340,2650340,6,5511730
2018-05-09,45,45,43,43,12911530,56,1399596,70,2,11911530,1000000,-10511934,10511934,4,11511934
2018-05-12,44,45,44,44,1347888,13,797188,37,1,1307888,40000,-510700,510700,2,550700
2018-05-13,45,45,44,45,3356312,99,2856312,74,2,2939182,417130,-82870,82870,2,500000
2018-05-14,46,47,45,47,15869398,226,14684122,119,9,3606670,12262728,11077452,-11077452,4,1185276
2018-05-15,47,49,45,45,7331997,161,5902416,115,8,5580554,1751443,321862,-321862,5,1429581
2018-05-16,47,47,45,45,1472583,51,1204588,49,2,1255045,217538,-50457,50457,2,267995
2018-05-19,46,47,45,45,3734050,140,3724050,75,4,2104743,1629307,1619307,-1619307,1,10000
2018-05-20,45,46,44,44,1871517,99,1817517,42,4,1325083,546434,492434,-492434,1,54000
2018-05-21,44,45,43,44,2037038,99,1675800,51,3,1264507,772531,411293,-411293,4,361238
2018-05-22,44,44,43,43,5405463,107,1886299,42,3,4230751,1174712,-2344452,2344452,5,3519164
2018-05-23,43,43,43,43,4529466,200,4365532,38,5,2640668,1888798,1724864,-1724864,1,163934
2018-05-26,43,44,43,43,3269284,74,3269284,59,1,3169284,100000,100000,-100000,0,0
2018-05-27,43,44,43,43,3821279,91,3658556,41,4,2760724,1060555,897832,-897832,2,162723
2018-05-28,43,43,42,43,2223779,121,2223779,36,2,2054928,168851,168851,-168851,0,0
2018-05-30,43,43,42,42,4126055,119,3429444,63,2,3906055,220000,-476611,476611,3,696611
2018-06-02,43,44,43,43,4646079,71,3773000,85,14,2582059,2064020,1190941,-1190941,3,873079
2018-06-03,43,43,43,43,2789100,56,2774380,88,3,2151459,637641,622921,-622921,1,14720
2018-06-09,43,43,42,42,5663495,76,4613376,74,7,4809675,853820,-196299,196299,3,1050119
2018-06-10,42,42,42,42,2679784,84,2489873,61,5,2339685,350188,150188,-150188,1,200000
2018-06-11,42,42,42,42,4063037,107,3783037,68,6,3309313,753724,473724,-473724,3,280000
2018-06-12,42,43,42,42,3945042,66,3671752,39,7,2584682,1360360,1087070,-1087070,3,273290
2018-06-13,42,44,42,44,9032594,137,5543554,151,9,6265030,2767564,-721476,721476,6,3489040
2018-06-17,44,46,44,46,18732826,324,16682826,123,7,5628875,13103951,11053951,-11053951,2,2050000
2018-06-18,47,47,44,44,18008782,222,15738782,193,9,8732179,9276603,7006603,-7006603,2,2270000
2018-06-19,46,46,44,44,21930454,284,18244454,113,7,14689513,7240941,3554941,-3554941,10,3686000
2018-06-20,45,46,44,46,25088334,241,20852705,157,7,15198707,9889627,5653998,-5653998,24,4235629
2018-06-23,47,47,47,47,59573525,428,58273525,166,17,11626128,47947397,46647397,-46647397,5,1300000
2018-06-24,49,49,46,48,43323510,531,38431640,299,14,21972237,21203273,16459403,-16459403,11,4743870
2018-06-25,47,48,46,46,46417316,562,39795829,244,7,28345864,18071452,11449965,-11449965,9,6621487
2018-06-26,46,48,45,46,22967794,247,22917794,287,10,15279922,7687872,7637872,-7637872,1,50000
2018-06-27,47,48,44,45,20522916,328,15532820,145,5,12758721,7764195,2774099,-2774099,21,4990096
2018-06-30,46,47,45,46,6793270,196,5793270,93,3,6143270,650000,-350000,350000,1,1000000
2018-07-01,46,46,44,45,5748403,179,5748403,92,1,5418394,330009,330009,-330009,0,0
2018-07-02,45,46,44,44,8033199,173,7333199,74,1,7059923,973276,273276,-273276,2,700000
2018-07-03,45,45,44,44,13648138,160,6108727,104,5,6346169,7301969,-237442,237442,13,7539411
2018-07-04,44,46,43,46,21976726,314,18934260,265,7,15898700,6078026,3035560,-3035560,8,3042466
2018-07-07,46,46,44,44,7502121,163,7002121,81,3,4061501,3440620,2940620,-2940620,1,500000
2018-07-08,45,46,44,45,7213344,139,5063244,144,1,6013344,1200000,-950100,950100,4,2150100
2018-07-10,44,44,44,44,4760993,88,3101780,120,1,3660993,1100000,-559213,559213,2,1659213
2018-07-11,44,44,43,43,11008738,179,9108738,239,1,10708738,300000,-1600000,1600000,4,1900000
2018-07-14,43,45,43,44,15811309,216,15016951,116,7,13161952,2649357,1854999,-1854999,3,794358
2018-07-21,51,51,49,50,51571596,676,45373207,294,38,26033058,25538538,19340149,-19340149,8,6198389
2018-07-22,50,50,48,48,54746054,603,38318347,208,18,38314562,16431492,3785,-3785,11,16427707
2018-07-23,49,49,47,47,9938711,278,7338711,146,3,9474264,464447,-2135553,2135553,3,2600000
2018-07-24,47,49,47,47,15660214,233,8939214,153,2,14865214,795000,-5926000,5926000,4,6721000
2018-07-25,48,48,46,47,10634374,244,9421544,96,2,9234374,1400000,187170,-187170,9,1212830
2018-07-28,47,47,45,46,16076760,269,11264390,146,1,16036260,40500,-4771870,4771870,8,4812370
2018-07-29,46,47,46,46,14113356,290,11761584,130,4,12344696,1768660,-583112,583112,3,2351772
2018-07-30,46,46,44,45,27953799,437,19704523,198,6,21231835,6721964,-1527312,1527312,5,8249276
2018-07-31,45,47,45,47,7883438,93,7383438,114,1,7740438,143000,-357000,357000,1,500000
2018-08-01,47,48,45,46,16725968,358,13325968,182,4,15416691,1309277,-2090723,2090723,3,3400000
2018-08-04,46,46,44,44,6442786,180,6342786,106,1,6242786,200000,100000,-100000,1,100000
2018-08-05,46,46,45,45,11901823,179,9121636,137,3,11349823,552000,-2228187,2228187,4,2780187
2018-08-06,45,46,43,43,15628669,319,14328669,183,3,13626669,2002000,702000,-702000,2,1300000
2018-08-07,43,47,43,47,28298414,380,24840014,325,12,16817699,11480715,8022315,-8022315,5,3458400
2018-08-08,47,48,46,47,14498696,252,10869202,207,8,12885151,1613545,-2015949,2015949,4,3629494
2018-08-11,47,48,46,47,9032122,205,8033677,159,2,5841977,3190145,2191700,-2191700,3,998445
2018-08-12,46,48,46,47,17426659,284,16794239,279,3,12463097,4963562,4331142,-4331142,5,632420
2018-08-13,48,48,46,47,9608544,178,8824656,154,0,9608544,0,-783888,783888,3,783888
2018-08-14,46,47,46,47,5922820,123,5603493,133,1,5912820,10000,-309327,309327,2,319327
2018-08-15,48,48,46,47,3952489,106,3826816,82,0,3952489,0,-125673,125673,2,125673
2018-08-18,47,48,47,47,9820928,155,8480928,181,4,8915928,905000,-435000,435000,2,1340000
2018-08-19,47,49,47,48,14589737,174,13059901,245,2,14439737,150000,-1379836,1379836,2,1529836
2018-08-20,49,50,48,49,12179815,165,11038656,275,8,9629952,2549863,1408704,-1408704,1,1141159
2018-08-21,51,52,50,51,21387139,391,21387139,254,7,16426731,4960408,4960408,-4960408,0,0
2018-08-25,53,53,51,53,34912437,402,34621741,305,26,16916640,17995797,17705101,-17705101,2,290696
2018-08-26,55,56,54,56,51459646,753,50309646,363,27,24901388,26558258,25408258,-25408258,3,1150000
2018-08-27,57,57,53,53,41987891,269,11293134,184,0,11342264,0,-49130,49130,1,49130
2018-08-28,53,55,51,53,24544095,434,24184095,295,4,18544914,5999181,5639181,-5639181,4,360000
2018-08-29,53,54,51,52,12368390,374,11888163,174,4,11783390,585000,104773,-104773,3,480227
2018-09-01,52,52,50,50,18074311,421,17136968,194,1,18044726,29585,-907758,907758,1,937343
2018-09-02,50,51,49,49,14102169,294,13205959,162,1,13952169,150000,-746210,746210,6,896210
2018-09-03,50,52,50,52,14894681,224,13135683,241,5,13372800,1521881,-237117,237117,6,1758998
2018-09-04,52,54,51,54,30810285,289,21195363,385,21,21905785,8904500,-710422,710422,13,9614922
2018-09-05,54,55,53,54,19960291,277,13990099,312,15,15876282,4062009,-1886183,1886183,4,5948192
2018-09-08,55,57,53,57,50438941,323,41745482,440,36,22141234,28297707,19604248,-19604248,6,8693459
2018-09-09,59,60,58,60,22834948,187,19814948,211,9,12400591,10434357,7414357,-7414357,4,3020000
2018-09-10,62,62,59,59,47756724,580,32119838,408,7,38323629,9433095,-6203791,6203791,12,15636886
2018-09-11,59,59,57,58,22704485,386,22704485,439,2,22517394,187091,187091,-187091,0,0
2018-09-12,59,61,58,61,38264433,537,35364433,434,7,25984433,12280000,9380000,-9380000,5,2900000
2018-09-15,64,64,63,64,20258074,253,19257074,200,7,12231791,8025283,7025283,-7025283,1,1000000
2018-09-16,65,67,62,67,77090520,721,57580520,605,10,47260520,29830000,10320000,-10320000,6,19510000
2018-09-17,68,69,67,69,7679864,39,7579864,175,2,7664864,15000,-85000,85000,1,100000
2018-09-18,72,72,72,72,1066686,10,1050000,72,2,1021551,45135,28449,-28449,1,16686
2018-09-22,73,73,73,73,6228164,64,6028164,10,1,1228164,5000000,4800000,-4800000,2,200000
2018-09-23,76,79,74,74,62083763,698,61083763,466,12,31845287,30238476,29238476,-29238476,1,1000000
2018-09-24,75,75,73,73,11346918,263,11126918,64,6,4412194,6934724,6714724,-6714724,2,220000
2018-09-25,76,78,75,78,81830629,738,76565629,485,16,35909569,45956060,40656060,-40656060,5,5300000
2018-09-26,80,80,75,76,46310472,713,33118373,498,10,34376353,11934119,-1257980,1257980,10,13192099
2018-09-29,77,81,76,81,69824577,824,69196563,529,15,38504413,31320164,30692150,-30692150,3,628014
2018-09-30,84,84,83,84,78271260,1126,67171260,387,9,58938556,19332704,8232704,-8232704,3,11100000
2018-10-01,87,87,80,80,68307531,1134,63797531,657,4,57817463,10490068,5980068,-5980068,6,4510000
2018-10-02,78,79,77,77,6667680,182,6177680,43,1,5167680,1500000,1010000,-1010000,2,490000
2018-10-03,74,74,74,74,28556355,208,14196355,193,0,28556355,0,-14360000,14360000,4,14360000
2018-10-06,72,77,70,70,41327578,511,32927578,420,1,40879966,447612,-7952388,7952388,7,8400000
2018-10-07,68,68,68,68,11066982,90,4346982,168,0,11066982,0,-6720000,6720000,4,6720000
2018-10-08,65,65,65,65,5608649,37,1008649,88,0,5608649,0,-4600000,4600000,2,4600000
2018-10-09,68,70,65,65,30360770,504,30290770,377,3,24326579,6034191,5964191,-5964191,2,70000
2018-10-10,64,66,64,64,16015838,223,8445838,340,2,15917631,98207,-7471793,7471793,6,7570000
2018-10-13,61,63,61,61,9258682,113,5938682,119,0,9258682,0,-3320000,3320000,4,3320000
2018-10-14,58,60,58,59,15871075,157,12071075,258,1,15866575,4500,-3795500,3795500,3,3800000
2018-10-15,59,61,59,61,21808371,363,18508371,262,5,15081711,6726660,3426660,-3426660,1,3300000
2018-10-16,64,64,63,64,27182255,353,22282255,274,5,21318353,5863902,963902,-963902,3,4900000
2018-10-17,61,63,61,61,47965848,535,38134848,571,4,45375848,2590000,-7241000,7241000,4,9831000
2018-10-20,64,64,62,64,22689779,202,18589779,215,6,11201954,11487825,7387825,-7387825,3,4100000
2018-10-21,65,65,61,63,23274615,397,23274615,283,5,17274615,6000000,6000000,-6000000,0,0
2018-10-22,64,64,60,61,25760251,460,20640251,216,1,19760251,6000000,880000,-880000,4,5120000
2018-10-23,61,61,57,58,20566414,420,20336414,250,1,20564710,1704,-228296,228296,4,230000
2018-10-24,56,59,55,56,11833800,297,10224800,229,0,11833800,0,-1609000,1609000,3,1609000
2018-10-27,57,59,56,57,13354225,265,12454225,214,3,11954225,1400000,500000,-500000,1,900000
2018-10-28,58,60,57,60,19216866,293,17516866,248,3,18806866,410000,-1290000,1290000,3,1700000
2018-10-29,61,62,61,62,22175848,342,20857842,341,3,18165848,4010000,2691994,-2691994,2,1318006
2018-10-31,62,64,61,64,19221743,337,19221743,321,3,18727743,494000,494000,-494000,0,0
2018-11-03,62,63,60,60,8858723,187,8458723,193,5,8246093,612630,212630,-212630,1,400000
2018-11-04,60,63,59,60,12859332,308,11729332,184,1,12719332,140000,-990000,990000,3,1130000
2018-11-05,59,63,59,63,33686114,286,32686114,412,6,23621878,10064236,9064236,-9064236,1,1000000
2018-11-06,63,65,62,62,18013331,299,17213331,322,4,17098331,915000,115000,-115000,1,800000
2018-11-10,64,66,63,64,29761849,420,29741849,294,2,19990747,9771102,9751102,-9751102,1,20000
2018-11-11,64,65,61,63,16285574,271,16285574,204,3,14701187,1584387,1584387,-1584387,0,0
2018-11-12,63,66,63,66,67767278,633,67136739,499,9,31807451,35959827,35329288,-35329288,4,630539
2018-11-13,67,68,65,66,42731499,548,42531499,431,4,30313208,12418291,12218291,-12218291,1,200000
2018-11-14,64,66,64,65,11396249,185,11396249,247,0,11396249,0,0,0,0,0
2018-11-17,65,66,63,64,18254877,223,17254877,330,2,17534877,720000,-280000,280000,1,1000000
2018-11-18,64,64,61,61,26425717,422,24395717,251,0,26425717,0,-2030000,2030000,2,2030000
2018-11-19,62,63,61,62,7001639,217,6991639,176,0,7001639,0,-10000,10000,1,10000
2018-11-20,62,62,60,62,8522045,212,7238316,180,0,8522045,0,-1283729,1283729,4,1283729
2018-11-21,62,64,62,64,30685388,307,29614110,339,4,14950058,15735330,14664052,-14664052,2,1071278
2018-11-24,67,67,65,67,33286908,614,33286908,430,6,20430681,12856227,12856227,-12856227,0,0
2018-11-26,67,67,63,64,12392715,274,12382715,264,1,12192715,200000,190000,-190000,1,10000
2018-11-27,63,66,62,63,8352604,213,8052604,145,0,8352604,0,-300000,300000,1,300000
2018-11-28,62,63,61,62,13461919,227,13461919,164,3,13268335,193584,193584,-193584,0,0
2018-12-01,63,63,59,60,20626190,254,20426190,223,2,16691329,3934861,3734861,-3734861,1,200000
2018-12-02,61,63,60,63,9110866,156,8208750,209,4,8070584,1040282,138166,-138166,1,902116
2018-12-03,63,64,61,63,14641631,164,13233634,254,0,14641631,0,-1407997,1407997,3,1407997
2018-12-04,61,64,61,62,7111916,135,4327916,163,1,7011916,100000,-2684000,2684000,2,2784000
2018-12-05,64,66,63,66,36641230,431,36641230,428,10,15891417,20749813,20749813,-20749813,0,0
2018-12-08,68,69,67,69,48751800,778,48251800,427,7,23411800,25340000,24840000,-24840000,1,500000
2018-12-09,72,72,65,67,62222917,972,56729764,748,6,53977917,8245000,2751847,-2751847,8,5493153
2018-12-10,67,69,66,66,18488932,277,18312932,342,1,18488207,725,-175275,175275,2,176000
2018-12-11,66,67,65,65,15187922,255,13757922,194,1,14793445,394477,-1035523,1035523,3,1430000
2018-12-12,66,66,65,65,19785868,354,17875868,237,0,19785868,0,-1910000,1910000,2,1910000
2018-12-15,65,65,63,64,20317216,203,17808464,189,2,18817216,1500000,-1008752,1008752,7,2508752
2018-12-16,64,65,62,64,18860763,142,18213797,232,2,14302896,4557867,3910901,-3910901,4,646966
2018-12-17,65,66,63,64,18509052,393,17809052,233,5,11165312,7343740,6643740,-6643740,2,700000
2018-12-18,63,64,62,63,14180692,110,13980692,184,1,11574498,2606194,2406194,-2406194,2,200000
2018-12-19,64,65,62,63,8242901,168,6984189,154,2,4816501,3426400,2167688,-2167688,3,1258712
2018-12-22,64,65,63,63,2830483,106,2730483,107,2,2700483,130000,30000,-30000,1,100000
2018-12-23,64,65,64,65,12166879,179,9103576,177,1,12116879,50000,-3013303,3013303,3,3063303
2018-12-24,65,65,64,64,7095824,134,5825824,132,0,7095824,0,-1270000,1270000,2,1270000
2018-12-25,64,66,64,65,12995373,182,11385373,289,2,11623462,1371911,-238089,238089,3,1610000
2018-12-26,66,68,65,67,15942802,320,15442802,448,11,14753468,1189334,689334,-689334,1,500000
2018-12-29,68,68,65,65,5965464,205,4540574,158,1,5865464,100000,-1324890,1324890,4,1424890
2018-12-30,65,67,64,66,13753976,168,13503946,222,4,12322201,1431775,1181745,-1181745,2,250030
2018-12-31,66,68,65,66,15265223,272,15245223,248,1,15115223,150000,130000,-130000,1,20000
2019-01-01,65,66,64,65,12681023,185,12397616,204,1,11347249,1333774,1050367,-1050367,3,283407
2019-01-02,65,67,64,65,19643612,277,19633612,270,9,14323925,5319687,5309687,-5309687,1,10000
2019-01-05,66,66,65,65,9128279,208,9088279,173,3,7602281,1525998,1485998,-1485998,1,40000
2019-01-06,65,66,64,64,14042917,155,13292917,172,7,11929193,2113724,1363724,-1363724,3,750000
2019-01-07,65,66,64,64,9142044,216,9132044,164,1,9109370,32674,22674,-22674,1,10000
2019-01-08,64,65,64,64,10013012,217,9993012,166,2,8358464,1654548,1634548,-1634548,2,20000
2019-01-09,64,65,64,64,7844395,230,7793095,139,3,7671114,173281,121981,-121981,3,51300
2019-01-12,65,66,64,66,18347826,285,17182826,233,3,15387339,2960487,1795487,-1795487,2,1165000
2019-01-13,67,68,66,66,44241852,525,43737409,599,17,36668213,7573639,7069196,-7069196,2,504443
2019-01-14,67,67,64,65,18050543,257,17265673,205,1,17950543,100000,-684870,684870,4,784870
2019-01-15,65,66,64,65,8131606,126,7976843,212,3,7880128,251478,96715,-96715,3,154763
2019-01-16,65,65,63,65,9074708,172,6932708,177,3,8968853,105855,-2036145,2036145,3,2142000
2019-01-19,64,65,63,65,7885272,147,7875272,180,3,7089758,795514,785514,-785514,1,10000
2019-01-20,65,66,64,65,12763629,106,8763629,280,4,11901111,862518,-3137482,3137482,2,4000000
2019-01-21,64,65,62,62,15990503,381,14070503,188,3,15896427,94076,-1825924,1825924,3,1920000
2019-01-22,62,64,61,64,7252684,153,7042684,194,2,6392684,860000,650000,-650000,3,210000
2019-01-23,64,65,63,64,8532031,49,8532031,300,2,7369522,1162509,1162509,-1162509,0,0
2019-01-26,65,65,62,63,6225953,155,6132953,124,2,5562733,663220,570220,-570220,2,93000
2019-01-27,62,65,62,63,16236858,95,16236858,246,6,12598078,3638780,3638780,-3638780,0,0
2019-01-28,64,65,62,64,7002407,119,6750736,143,3,5387407,1615000,1363329,-1363329,1,251671
2019-01-29,63,64,62,64,9154765,73,7637480,153,2,7824765,1330000,-187285,187285,2,1517285
2019-01-30,63,65,63,64,25336479,103,24734516,281,6,11592065,13744414,13142451,-13142451,1,601963
2019-02-02,65,65,63,63,11848468,79,8138468,212,5,7853644,3994824,284824,-284824,2,3710000
2019-02-03,63,63,62,63,6737723,128,5717723,119,3,3957053,2780670,1760670,-1760670,2,1020000
2019-02-04,62,63,62,63,12138187,51,9027037,130,5,5551911,6586276,3475126,-3475126,1,3111150
2019-02-05,64,64,63,64,13184131,60,7071015,131,3,8324131,4860000,-1253116,1253116,2,6113116
2019-02-06,64,66,63,64,24428400,109,14428400,310,22,16103779,8324621,-1675379,1675379,1,10000000
2019-02-10,65,65,63,64,6277671,58,1277671,146,4,4421630,1856041,-3143959,3143959,1,5000000
2019-02-12,63,65,63,64,9066329,20,541700,167,5,7569123,1497206,-7027423,7027423,1,8524629
2019-02-13,64,65,63,64,5952611,61,1432611,212,2,5152611,800000,-3720000,3720000,3,4520000
2019-02-16,65,65,63,64,6924985,63,1834985,171,5,5654985,1270000,-3820000,3820000,3,5090000
2019-02-17,63,64,62,62,10825580,127,10585580,65,3,3812384,7013196,6773196,-6773196,2,240000
2019-02-18,62,64,62,63,9754199,114,9734199,73,5,7815504,1938695,1918695,-1918695,1,20000
2019-02-19,63,64,62,62,8596084,111,3529764,84,5,3455497,5140587,74267,-74267,1,5066320
2019-02-20,63,63,63,63,9477595,41,6475595,99,2,8706736,770859,-2231141,2231141,2,3002000
2019-02-23,63,66,63,66,27559635,138,10133360,333,7,23211685,4347950,-13078325,13078325,4,17426275
2019-02-24,66,67,64,64,9350172,140,6415917,156,7,5233179,4116993,1182738,-1182738,2,2934255
2019-02-25,64,65,64,64,4620087,108,4120087,112,2,3765205,854882,354882,-354882,1,500000
2019-02-26,64,64,63,63,12074310,78,11474310,87,1,12073064,1246,-598754,598754,1,600000
2019-02-27,63,64,63,64,12921050,104,12321050,85,0,12921050,0,-600000,600000,2,600000
2019-03-02,63,64,63,64,5939430,29,5939430,104,1,5439430,500000,500000,-500000,0,0
2019-03-03,64,64,63,63,3460786,61,2260786,75,0,3460786,0,-1200000,1200000,1,1200000
2019-03-04,63,64,62,62,12090810,186,11480810,80,2,3067527,9023283,8413283,-8413283,3,610000
2019-03-05,62,63,61,62,11790918,127,11750918,75,3,4756172,7034746,6994746,-6994746,2,40000
2019-03-06,62,62,61,62,3651748,150,3441748,42,2,1623948,2027800,1817800,-1817800,2,210000
2019-03-09,61,62,61,62,6444678,133,6344678,78,1,6018137,426541,326541,-326541,1,100000
2019-03-10,62,62,61,62,7213307,126,6993307,72,1,5213307,2000000,1780000,-1780000,2,220000
2019-03-11,61,62,60,61,7846730,188,7030721,87,1,7826774,3441,-796053,796053,3,799494
2019-03-12,61,61,60,61,9673716,205,8583706,79,0,9673716,0,-1090010,1090010,5,1090010
2019-03-13,60,61,60,61,5512465,82,5471465,149,2,4761401,751064,710064,-710064,1,41000
2019-03-16,61,62,60,61,8204495,78,7204495,179,3,5060157,3144338,2144338,-2144338,1,1000000
2019-03-17,61,63,61,62,5402976,99,3402976,123,1,4952919,450057,-1549943,1549943,2,2000000
2019-03-18,62,63,62,62,4963576,96,3963576,100,1,3638120,1325456,325456,-325456,1,1000000
2019-03-19,63,64,62,64,6163121,74,5163121,104,1,3172362,2990759,1990759,-1990759,1,1000000
2019-03-25,63,66,63,66,19280086,217,15280086,224,8,11808570,7471516,3471516,-3471516,2,4000000
2019-03-26,66,69,66,69,36744881,196,12765566,379,19,15696824,21048057,-2931258,2931258,6,23979315
2019-03-27,68,70,66,67,18258737,232,12238052,317,0,18258737,0,-6020685,6020685,4,6020685
2019-03-30,66,71,66,71,42818477,48,39818477,331,4,27118477,15700000,12700000,-12700000,1,3000000
2019-03-31,72,74,70,73,37130942,344,32120942,518,5,30830023,6300919,1290919,-1290919,2,5010000
2019-04-06,70,75,70,72,20974370,215,20654370,271,27,11940156,9034214,8714214,-8714214,2,320000
2019-04-07,72,76,72,75,53970884,263,50470884,481,9,36064080,17906804,14406804,-14406804,2,3500000
2019-04-08,73,75,72,72,24656072,347,21289296,257,29,17443790,7212282,3845506,-3845506,4,3366776
2019-04-09,71,72,69,70,10893619,194,8481574,222,1,10889229,4390,-2407655,2407655,5,2412045
2019-04-10,70,73,70,72,10753196,117,9753196,244,5,7543525,3209671,2209671,-2209671,1,1000000
2019-04-13,72,76,72,76,73367457,124,73208757,507,11,43187984,30179473,30020773,-30020773,1,158700
2019-04-14,77,79,76,77,33696931,320,28496931,441,10,21158183,12538748,7338748,-7338748,2,5200000
2019-04-15,77,80,77,78,27709592,261,27489592,292,6,17287049,10422543,10202543,-10202543,2,220000
2019-04-16,78,79,76,78,14724135,120,14664135,281,2,14224135,500000,440000,-440000,2,60000
2019-04-17,76,79,74,78,12555375,124,10536375,259,7,8281463,4273912,2254912,-2254912,4,2019000
2019-04-20,79,81,79,81,35479040,31,14355373,178,8,10134560,25344480,4220813,-4220813,1,21123667
2019-04-22,85,85,81,84,79692954,237,30092954,592,39,44252503,35440451,-14159549,14159549,3,49600000
2019-04-23,81,85,81,83,16533272,99,7663894,210,4,11578543,4954729,-3914649,3914649,4,8869378
2019-04-24,81,85,81,84,16273508,141,7858626,175,6,9802508,6471000,-1943882,1943882,3,8414882
2019-04-27,84,86,83,85,25101826,124,8801474,287,6,20709876,4391950,-11908402,11908402,3,16300352
2019-04-28,85,85,83,85,17350541,84,4041532,213,1,16939849,410692,-12898317,12898317,3,13309009
2019-04-29,84,89,81,89,8991124,10,8991124,227,5,5616745,3374379,3374379,-3374379,0,0
2019-04-30,92,92,89,92,56583787,270,52793787,432,12,32876852,23706935,19916935,-19916935,4,3790000
2019-05-01,94,97,94,97,47854297,153,25366800,294,11,14894297,32960000,10472503,-10472503,3,22487497
2019-05-04,101,101,101,101,20167025,29,12024638,107,6,3067025,17100000,8957613,-8957613,2,8142387
2019-05-05,106,106,96,105,65838194,430,29866293,472,11,37951980,27886214,-8085687,8085687,3,35971901
2019-05-06,106,106,100,100,82143814,263,52103814,382,9,53089359,29054455,-985545,985545,2,30040000
2019-05-07,96,100,95,96,63611366,215,33581366,592,4,56971610,6639756,-23390244,23390244,2,30030000
2019-05-08,94,100,94,98,17302407,178,15688970,227,7,8966446,8335961,6722524,-6722524,5,1613437
2019-05-11,96,98,92,92,30829037,210,11965526,184,5,14067566,16761471,-2102040,2102040,4,18863511
2019-05-12,94,95,89,89,30705788,147,8705788,224,6,20697284,10008504,-11991496,11991496,4,22000000
2019-05-13,86,93,86,92,13727159,144,6509307,193,8,6589741,7137418,-80434,80434,3,7217852
2019-05-14,93,95,92,93,44093246,231,11093246,198,12,6716244,37377002,4377002,-4377002,4,33000000
2019-05-15,93,100,90,100,30444947,138,5202514,366,4,19092763,11352184,-13890249,13890249,5,25242433
2019-05-18,99,100,97,100,14787238,135,11000846,244,8,7259701,7527537,3741145,-3741145,2,3786392
2019-05-19,100,102,96,98,7192784,141,4896500,154,2,7103828,88956,-2207328,2207328,2,2296284
2019-05-20,96,97,93,93,7972048,143,4074527,143,1,7672048,300000,-3597521,3597521,3,3897521
2019-05-21,92,99,92,96,6468630,98,4735500,146,6,4540543,1928087,194957,-194957,2,1733130
2019-05-22,98,98,94,96,10821084,50,1132807,147,5,8328127,2492957,-7195320,7195320,4,9688277
2019-05-25,97,97,94,95,2589669,93,2579669,91,16,2564102,25567,15567,-15567,1,10000
2019-05-26,96,101,96,96,11215808,155,10833733,202,5,6080621,5135187,4753112,-4753112,2,382075
2019-05-28,100,102,97,100,8495550,206,6340397,160,6,5739417,2756133,600980,-600980,2,2155153
2019-05-29,98,103,98,98,4688081,134,3878081,156,4,4349268,338813,-471187,471187,2,810000
2019-06-01,100,102,97,98,3766550,96,2466550,158,2,3428055,338495,-961505,961505,1,1300000
2019-06-02,98,101,97,97,8937765,211,8679765,134,3,6954803,1982962,1724962,-1724962,2,258000
2019-06-03,100,102,97,98,5549564,162,5549564,155,4,5012966,536598,536598,-536598,0,0
2019-06-08,99,99,96,97,4741204,160,4741204,103,1,4246016,495188,495188,-495188,0,0
2019-06-09,98,102,98,102,23815440,295,17745675,259,5,11252003,12563437,6493672,-6493672,2,6069765
2019-06-10,104,106,99,100,19565964,246,4961393,223,2,18010314,1555650,-13048921,13048921,3,14604571
2019-06-11,102,107,100,106,27935003,149,3478430,282,5,23282002,4653001,-19803572,19803572,6,24456573
2019-06-12,105,108,102,104,21956155,217,8436591,221,4,20541252,1414903,-12104661,12104661,4,13519564
2019-06-15,102,105,101,104,8963936,158,4585920,149,1,8163936,800000,-3578016,3578016,4,4378016
2019-06-16,105,105,99,99,15602362,175,8227061,174,3,14625987,976375,-6398926,6398926,7,7375301
2019-06-17,101,101,98,98,5741459,118,4575781,161,3,3794959,1946500,780822,-780822,3,1165678
2019-06-18,102,104,97,103,15710544,87,8674430,156,6,13424764,2285780,-4750334,4750334,4,7036114
2019-06-19,101,102,97,100,12253651,106,7461630,110,6,8950419,3303232,-1488789,1488789,6,4792021
2019-06-22,97,102,97,101,8138205,65,6676799,106,2,6499729,1638476,177070,-177070,3,1461406
2019-06-23,99,103,99,101,14735847,66,7156977,138,4,11556241,3179606,-4399264,4399264,4,7578870
2019-06-24,100,107,100,107,26762321,149,7328184,292,6,22159919,4602402,-14831735,14831735,5,19434137
2019-06-25,107,110,101,106,11320684,173,4350019,137,2,11310682,10002,-6960663,6960663,7,6970665
2019-06-26,105,108,104,105,7584302,98,2774283,130,0,7584302,0,-4810019,4810019,5,4810019
2019-06-30,105,107,101,102,7830041,156,4513551,105,1,6830041,1000000,-2316490,2316490,5,3316490
2019-07-01,101,104,101,102,3013622,107,3013622,92,2,2491050,522572,522572,-522572,0,0
2019-07-02,102,104,102,103,8827573,77,6115689,121,2,7308881,1518692,-1193192,1193192,4,2711884
2019-07-03,103,104,101,103,8436600,114,4572026,102,5,4139259,4297341,432767,-432767,5,3864574
2019-07-06,101,103,100,102,18369543,75,4608762,110,3,16629543,1740000,-12020781,12020781,3,13760781
2019-07-07,101,103,101,102,3977226,56,1848126,92,4,2382225,1595001,-534099,534099,3,2129100
2019-07-08,103,104,102,103,6081451,96,3615076,88,3,5688932,392519,-2073856,2073856,3,2466375
2019-07-09,103,103,101,103,8360197,64,3595197,141,2,5433763,2926434,-1838566,1838566,3,4765000
2019-07-10,101,103,101,102,16649262,109,6028130,115,4,3947074,12702188,2081056,-2081056,3,10621132
2019-07-13,102,103,101,102,7855930,73,2545830,202,3,3816307,4039623,-1270477,1270477,6,5310100
2019-07-14,104,104,102,102,7928712,131,7928712,98,3,5551559,2377153,2377153,-2377153,0,0
2019-07-15,104,104,101,102,16042488,85,8599011,130,4,8927678,7114810,-328667,328667,4,7443477
2019-07-16,102,103,97,99,16656021,121,5241776,165,0,16656021,0,-11414245,11414245,3,11414245
2019-07-17,96,104,96,101,11095619,96,5116939,166,2,7085619,4010000,-1968680,1968680,2,5978680
2019-07-20,98,106,98,104,17819469,246,17512437,292,3,11561949,6257520,5950488,-5950488,3,307032
2019-07-24,108,111,106,109,2152334,72,1627299,59,1,1952334,200000,-325035,325035,1,525035
2019-07-27,108,110,103,105,7688381,151,5668381,100,4,2620384,5067997,3047997,-3047997,2,2020000
2019-07-28,104,107,104,104,21638457,106,2632629,79,3,18138456,3500001,-15505827,15505827,4,19005828
2019-07-29,103,106,103,105,29799634,77,2403796,85,1,28838634,961000,-26434838,26434838,2,27395838
2019-07-30,106,106,103,105,1663408,77,1611412,73,1,1532109,131299,79303,-79303,1,51996
2019-07-31,106,108,104,106,4210385,52,3484624,112,3,2400594,1809791,1084030,-1084030,3,725761
2019-08-03,106,108,105,108,3768702,57,3171730,111,2,3268553,500149,-96823,96823,3,596972
2019-08-04,108,113,108,111,9611833,181,7810502,197,3,4315269,5296564,3495233,-3495233,4,1801331
2019-08-05,113,113,109,109,2650780,122,2650780,86,1,2541639,109141,109141,-109141,0,0
2019-08-06,110,110,106,110,3604448,65,2665855,92,1,3436282,168166,-770427,770427,3,938593
2019-08-07,107,112,107,111,10503855,65,8365579,111,4,4908638,5595217,3456941,-3456941,2,2138276
2019-08-10,109,116,109,116,13658264,63,8888789,250,7,8763342,4894922,125447,-125447,3,4769475
2019-08-11,117,121,117,121,50147821,399,20705878,302,8,39261239,10886582,-18555361,18555361,8,29441943
2019-08-13,122,122,117,119,6831536,242,6293929,195,1,6827710,3826,-533781,533781,2,537607
2019-08-14,120,126,119,126,29692033,221,8498225,365,4,28243755,1448278,-19745530,19745530,6,21193808
2019-08-17,128,128,123,127,7877853,208,6152809,194,2,5704371,2173482,448438,-448438,3,1725044
2019-08-18,126,131,125,126,6112544,136,5263300,150,5,4655633,1456911,607667,-607667,2,849244
2019-08-19,125,128,121,122,31774394,207,9254394,145,3,6244394,25530000,3010000,-3010000,3,22520000
2019-08-21,122,123,120,122,14834005,237,13700683,127,3,7777791,7056214,5922892,-5922892,3,1133322
2019-08-24,123,128,123,125,43019616,296,31459616,246,8,31677436,11342180,-217820,217820,4,11560000
2019-08-25,125,128,121,125,9404104,183,6719032,143,2,7990103,1414001,-1271071,1271071,3,2685072
2019-08-26,127,129,124,126,10257898,133,8180723,154,6,7952450,2305448,228273,-228273,1,2077175
2019-08-27,126,130,121,123,18624693,229,11734693,141,3,16054693,2570000,-4320000,4320000,5,6890000
2019-08-28,121,124,121,123,9462420,109,2391318,98,1,6962420,2500000,-4571102,4571102,5,7071102
2019-08-31,121,125,116,121,26858769,218,17364864,191,4,21615795,5242974,-4250931,4250931,3,9493905
2019-09-01,124,127,120,127,107003120,309,88703120,255,9,68891767,38111353,19811353,-19811353,6,18300000
2019-09-02,129,131,122,123,26894012,244,18777581,198,2,22190129,4703883,-3412548,3412548,5,8116431
2019-09-03,125,127,122,122,8519148,158,7850429,118,0,8519148,0,-668719,668719,4,668719
2019-09-04,123,123,121,123,9707491,159,7259712,153,1,8307491,1400000,-1047779,1047779,3,2447779
2019-09-07,125,125,122,125,22489302,179,19384189,171,3,18779302,3710000,604887,-604887,5,3105113
2019-09-08,125,128,123,126,8071387,173,8071387,187,1,7992360,79027,79027,-79027,0,0
2019-09-11,127,132,126,132,47435331,384,42435331,361,5,27042862,20392469,15392469,-15392469,1,5000000
2019-09-14,132,138,132,137,146237056,916,128637056,352,6,139057056,7180000,-10420000,10420000,8,17600000
2019-09-15,135,140,133,136,28327354,543,24483992,293,3,23527354,4800000,956638,-956638,9,3843362
2019-09-16,136,139,131,133,40454895,514,23885604,263,4,35775876,4679019,-11890272,11890272,58,16569291
2019-09-17,132,135,129,131,28051724,401,17541724,241,4,23589872,4461852,-6048148,6048148,4,10510000
2019-09-18,128,128,124,127,14453688,307,11259586,206,5,12208081,2245607,-948495,948495,4,3194102
2019-09-21,126,130,125,128,10586284,242,9176037,145,5,8809598,1776686,366439,-366439,4,1410247
2019-09-22,130,131,127,128,18299502,266,16090240,154,5,13468927,4830575,2621313,-2621313,5,2209262
2019-09-23,130,132,127,130,17770905,303,17091276,223,5,13323836,4447069,3767440,-3767440,1,679629
2019-09-24,132,134,127,129,26611743,336,23211743,231,9,9124265,17487478,14087478,-14087478,5,3400000
2019-09-25,132,137,131,137,77839871,578,58750108,458,11,21326292,56513579,37423816,-37423816,6,19089763
2019-09-28,141,143,139,143,68858473,1156,46427681,467,8,35592353,33266120,10835328,-10835328,6,22430792
2019-09-29,144,145,137,139,37216406,801,27196406,338,4,26404689,10811717,791717,-791717,1,10020000
2019-10-02,143,150,143,146,43852013,640,36852013,416,7,26793140,17058873,10058873,-10058873,3,7000000
2019-10-05,146,154,143,144,40539799,642,25515407,515,7,27669028,12870771,-2153621,2153621,12,15024392
2019-10-06,145,146,140,142,33409568,489,17824381,304,4,25732492,7677076,-7908111,7908111,7,15585187
2019-10-07,142,145,137,140,16410864,226,13279652,258,4,9978524,6432340,3301128,-3301128,2,3131212
2019-10-09,134,141,134,141,41391080,201,15373277,225,4,38465889,2925191,-23092612,23092612,6,26017803
2019-10-12,142,144,139,143,22289034,324,10905034,309,3,14987527,7301507,-4082493,4082493,5,11384000
2019-10-13,141,145,140,141,15978877,189,4384210,268,4,12109151,3869726,-7724941,7724941,3,11594667
2019-10-14,135,142,134,141,17978999,215,7949073,229,4,14578999,3400000,-6629926,6629926,4,10029926
2019-10-15,136,141,129,129,54606775,220,19524775,223,4,51175883,3430892,-31651108,31651108,5,35082000
2019-10-16,131,133,125,129,12488586,184,3247878,195,1,12488056,530,-9240178,9240178,5,9240708
2019-10-20,128,135,123,126,16940300,148,7538486,263,19,13428901,3511399,-5890415,5890415,5,9401814
2019-10-21,125,132,124,130,11215967,222,8916189,202,3,9908696,1307271,-992507,992507,2,2299778
2019-10-22,131,135,129,130,7748389,278,7421952,150,2,6287008,1461381,1134944,-1134944,2,326437
2019-10-23,134,135,130,130,5699177,143,3176301,126,0,5699177,0,-2522876,2522876,1,2522876
2019-10-26,127,130,127,128,4411627,124,2663226,97,1,3475852,935775,-812626,812626,4,1748401
2019-10-28,132,134,131,134,7125008,191,7124994,116,3,4154149,2970859,2970845,-2970845,1,14
2019-10-30,135,138,134,136,5276576,266,5216576,130,2,5176566,100010,40010,-40010,2,60000
2019-11-02,137,137,130,137,6344528,183,4343371,212,2,6199528,145000,-1856157,1856157,6,2001157
2019-11-03,132,140,132,140,20048568,359,19296955,352,4,17002019,3046549,2294936,-2294936,3,751613
2019-11-04,141,142,135,136,8302062,231,7508142,223,4,7449859,852203,58283,-58283,4,793920
2019-11-05,137,141,134,137,6567556,167,6449316,130,1,5867556,700000,581760,-581760,3,118240
2019-11-09,140,143,135,137,7675416,223,7364616,178,0,7675416,0,-310800,310800,3,310800
2019-11-10,134,140,133,135,7993324,138,2781822,149,0,7993324,0,-5211502,5211502,5,5211502
2019-11-11,133,139,133,139,7341924,124,4676670,178,3,6983417,358507,-2306747,2306747,3,2665254
2019-11-12,139,143,138,142,10947861,190,6912794,304,4,10086681,861180,-3173887,3173887,3,4035067
2019-11-13,142,144,139,141,5917859,231,5742859,233,1,5631318,286541,111541,-111541,2,175000
2019-11-16,142,143,135,135,6372988,240,5518617,143,3,5919623,453365,-401006,401006,2,854371
2019-11-17,130,134,129,131,7513947,108,3854429,153,1,7435630,78317,-3581201,3581201,5,3659518
2019-11-18,127,138,127,135,8582377,109,8385077,161,3,6486759,2098318,1898318,-1898318,1,200000
2019-11-19,138,139,132,139,4871911,114,2623085,131,2,4587738,284173,-1964653,1964653,2,2248826
2019-11-20,138,138,135,136,3679596,102,2592872,115,3,3479596,200000,-886724,886724,3,1086724
2019-11-23,135,139,135,137,3855487,82,3036551,112,0,3855487,0,-818936,818936,2,818936
2019-11-24,139,141,136,140,6984565,102,3050514,161,3,5371729,1612836,-2321215,2321215,5,3934051
2019-11-25,142,144,139,143,8456563,169,8332436,218,3,7839399,617164,493037,-493037,2,124127
2019-11-26,144,144,142,143,8318673,110,3668371,276,3,8123161,195512,-4454790,4454790,3,4650302
2019-11-27,145,150,143,150,59422989,174,58065973,426,5,53397949,6025040,4668024,-4668024,3,1357016
2019-11-30,152,157,151,153,25928459,616,24683204,428,3,22856243,3072216,1826961,-1826961,4,1245255
2019-12-01,154,159,150,157,23777798,473,21677798,377,3,18355683,5422115,3322115,-3322115,2,2100000
2019-12-02,160,160,150,152,12668850,307,9587662,268,1,12063850,605000,-2476188,2476188,6,3081188
2019-12-03,155,158,150,158,14427001,338,8197685,305,1,12027001,2400000,-3829316,3829316,3,6229316
2019-12-04,160,162,155,156,26704477,416,18254477,250,1,24045071,2659406,-5790594,5790594,4,8450000
2019-12-07,158,160,154,156,8075469,273,7990469,295,1,7975469,100000,15000,-15000,2,85000
2019-12-08,156,159,154,159,16555761,335,11009625,306,2,15147334,1408427,-4137709,4137709,4,5546136
2019-12-09,160,165,156,164,31483711,418,17378888,509,5,24161707,7322004,-6782819,6782819,3,14104823
2019-12-10,165,167,160,163,17054871,475,15759080,289,4,15165078,1889793,594002,-594002,3,1295791
2019-12-11,164,171,158,165,13029229,303,12892672,316,3,8163729,4865500,4728943,-4728943,3,136557
2019-12-14,168,168,163,165,14563990,398,12716648,258,1,14533990,30000,-1817342,1817342,2,1847342
2019-12-15,164,166,158,164,11383824,413,10304401,299,4,9445866,1937958,858535,-858535,3,1079423
2019-12-16,164,164,159,162,7401589,292,4972097,225,1,7400589,1000,-2428492,2428492,5,2429492
2019-12-17,162,164,158,161,10785296,319,8039305,236,3,8945681,1839615,-906376,906376,4,2745991
2019-12-18,160,161,156,158,8516033,361,6143779,202,2,5912164,2603869,231615,-231615,4,2372254
2019-12-21,158,165,157,164,11473247,294,10563247,281,1,9412818,2060429,1150429,-1150429,2,910000
2019-12-22,165,168,161,166,8613591,241,7277973,272,2,8080099,533492,-802126,802126,2,1335618
2019-12-23,162,169,159,165,13307959,291,10057931,344,5,12833700,474259,-2775769,2775769,3,3250028
2019-12-24,164,167,160,166,7468291,196,6220646,223,2,6967700,500591,-747054,747054,2,1247645
2019-12-25,165,173,165,173,24427674,274,22727674,457,7,14126347,10301327,8601327,-8601327,2,1700000
2019-12-28,180,181,175,178,35834147,903,29455692,408,7,24184147,11650000,5271545,-5271545,2,6378455
2019-12-29,185,189,173,186,20967812,479,20327780,400,4,19330092,1637720,997688,-997688,4,640032
2019-12-30,187,190,184,189,16459886,500,13932962,311,4,15309006,1135000,-1376044,1376044,4,2511044
2019-12-31,190,190,181,186,21260233,391,16506678,314,2,21108833,151400,-4602155,4602155,5,4753555
2020-01-01,188,192,183,190,22969780,369,22969780,478,6,18788112,4181668,4181668,-4181668,0,0
2020-01-04,181,183,181,181,78769429,490,17905890,892,7,74714713,4054716,-56808823,56808823,7,60863539
2020-01-05,177,186,177,179,15572553,323,11070703,251,3,12494121,3078432,-1423418,1423418,4,4501850
2020-01-07,179,183,172,175,28812927,213,6887702,400,6,26685157,2127770,-19797455,19797455,5,21925225
2020-01-08,170,177,170,177,45906984,286,13563201,615,5,44298484,1608500,-30735283,30735283,6,32343783
2020-01-11,175,175,175,175,1587258,3,1587258,21,1,87258,1500000,1500000,-1500000,0,0
2020-01-12,182,182,182,182,7080648,28,6580648,50,3,1312156,5768492,5268492,-5268492,1,500000
2020-01-13,191,191,191,191,3593122,24,3593122,81,2,1093122,2500000,2500000,-2500000,0,0
2020-01-14,200,200,200,200,56180580,323,44310556,261,6,11777933,44402647,32532623,-32532623,2,11870024
2020-01-15,208,210,200,210,74160005,569,68877855,285,5,33810005,40350000,35067850,-35067850,3,5282150
2020-01-18,220,220,216,218,79817391,1077,64346411,466,7,59987241,19830150,4359170,-4359170,6,15470980
2020-01-19,223,226,209,217,37520240,974,29759123,455,2,37260240,260000,-7501117,7501117,6,7761117
2020-01-20,220,222,212,217,19669490,523,10027489,434,3,19009490,660000,-8982001,8982001,7,9642001
2020-01-21,217,221,209,213,16469792,575,11942522,335,3,11183661,5286131,758861,-758861,5,4527270
2020-01-22,213,224,209,224,23924359,465,20997559,472,5,21210114,2714245,-212555,212555,5,2926800
2020-01-25,233,233,228,233,20028942,562,18328942,299,3,16378942,3650000,1950000,-1950000,2,1700000
2020-01-26,243,244,229,233,26972419,973,22514642,454,3,22143952,4828467,370690,-370690,6,4457777
2020-01-27,228,239,228,234,13266500,618,12313251,364,3,12696903,569597,-383652,383652,3,953249
2020-01-28,234,242,231,239,16636647,543,10177725,392,2,15286647,1350000,-5108922,5108922,7,6458922
2020-02-01,244,248,241,245,31358801,1002,22132447,540,8,16243801,15115000,5888646,-5888646,4,9226354
2020-02-02,248,249,242,245,29472617,978,27859096,447,4,15663563,13809054,12195533,-12195533,4,1613521
2020-02-03,246,253,245,249,47361510,928,24173336,507,9,25304621,22056889,-1131285,1131285,5,23188174
2020-02-04,255,255,237,241,28874561,665,19464604,476,2,22371135,6503426,-2906531,2906531,8,9409957
2020-02-05,243,253,242,244,35798907,568,19663612,501,4,17551303,18247604,2112309,-2112309,3,16135295
2020-02-08,249,251,243,249,34898535,476,7279315,723,4,33552306,1346229,-26272991,26272991,5,27619220
2020-02-09,251,251,245,246,10011455,422,8845855,441,1,9822430,189025,-976575,976575,2,1165600
2020-02-10,243,246,235,235,25724544,611,14181122,301,2,25353192,371352,-11172070,11172070,4,11543422
2020-02-12,235,242,233,236,7592177,475,5490310,345,0,7592177,0,-2101867,2101867,4,2101867
2020-02-15,233,237,225,229,18214110,786,13684409,416,3,17713217,500893,-4028808,4028808,4,4529701
2020-02-16,234,236,224,226,16233943,777,11631513,343,2,14506811,1727132,-2875298,2875298,7,4602430
2020-02-17,229,230,222,224,23980574,568,11178884,474,2,22969290,1011284,-11790406,11790406,4,12801690
2020-02-18,220,231,220,225,11643250,451,11343250,357,3,8404534,3238716,2938716,-2938716,1,300000
2020-02-19,226,237,226,237,16868710,475,16632866,518,4,12768710,4100000,3864156,-3864156,3,235844
2020-02-22,226,248,226,248,21596465,567,21596465,510,5,14111854,7484611,7484611,-7484611,0,0
2020-02-23,253,258,253,258,12054283,260,11994283,377,5,7348215,4706068,4646068,-4646068,2,60000
2020-02-24,269,269,259,269,40957842,967,40957842,765,6,33108701,7849141,7849141,-7849141,0,0
2020-02-25,273,276,268,271,23247241,1159,22742241,458,5,16961521,6285720,5780720,-5780720,2,505000
2020-02-26,277,277,266,267,13665060,712,9026169,764,1,13641515,23545,-4615346,4615346,3,4638891
2020-02-29,256,269,255,259,12650858,619,9401297,498,2,10694295,1956563,-1292998,1292998,3,3249561
2020-03-01,263,272,257,272,12925254,575,9175254,447,5,7403969,5521285,1771285,-1771285,1,3750000
2020-03-02,276,278,262,276,12652002,653,10507819,450,5,10635800,2016202,-127981,127981,7,2144183
2020-03-03,276,287,270,285,18163276,494,12934226,689,6,12745815,5417461,188411,-188411,6,5229050
2020-03-04,284,290,276,278,14358740,513,10968056,446,7,6544579,7814161,4423477,-4423477,5,3390684
2020-03-07,269,276,267,270,10943375,368,5883452,576,2,7773224,3170151,-1889772,1889772,4,5059923
2020-03-09,257,263,257,257,20927402,471,5089956,177,1,19566776,1360626,-14476820,14476820,4,15837446
2020-03-10,245,263,245,245,15255731,480,9347108,469,4,8408176,6847555,938932,-938932,5,5908623
2020-03-11,246,259,246,248,14587891,599,12860991,344,4,7775422,6812469,5085569,-5085569,4,1726900
2020-03-14,245,252,239,239,20167695,408,4167695,262,4,18581600,1586095,-14413905,14413905,3,16000000
2020-03-15,231,243,228,232,8880089,415,6980089,342,2,6731005,2149084,249084,-249084,2,1900000
2020-03-16,239,248,239,248,8823342,560,8284004,259,4,6018342,2805000,2265662,-2265662,2,539338
2020-03-17,247,248,235,245,5434262,369,4434262,219,2,4762487,671775,-328225,328225,1,1000000
2020-03-18,249,253,243,253,19250833,476,14348538,230,4,7270494,11980339,7078044,-7078044,3,4902295
2020-03-24,259,261,250,253,12473512,622,11955727,215,3,8330980,4142532,3624747,-3624747,2,517785
2020-03-25,255,268,255,268,12578302,491,10479928,304,5,5090395,7544650,5389533,-5389533,4,2155117
2020-03-28,278,278,275,278,12399046,314,11805848,211,3,9800502,2598544,2005346,-2005346,2,593198
2020-03-29,292,292,277,291,21761203,623,17606624,381,5,17395039,4366164,211585,-211585,5,4154579
2020-03-30,297,301,277,301,18863158,804,15475500,674,3,16910085,1952073,-1434585,1434585,7,3386658
2020-04-04,304,304,297,304,19136031,678,12423236,447,8,8819173,10316858,3604063,-3604063,2,6712795
2020-04-05,317,317,309,317,26517796,831,21173026,490,12,15355422,11162374,5817604,-5817604,3,5344770
2020-04-06,328,332,310,332,20478018,795,18933545,801,8,16190474,4287544,2743071,-2743071,4,1544473
2020-04-07,337,339,333,339,34814170,576,28688170,389,6,10714170,24100000,17974000,-17974000,5,6126000
2020-04-08,356,356,351,356,55899692,892,50409441,338,7,7449692,48450000,42959749,-42959749,6,5490251
2020-04-11,364,373,339,370,15686278,748,15085278,407,5,11556704,4078574,3528574,-3528574,2,550000
2020-04-14,342,359,342,359,3632608,96,3575325,438,1,2692608,940000,882717,-882717,1,57283
2020-04-15,377,377,374,377,57802053,623,43500220,622,8,25802053,32000000,17698167,-17698167,2,14301833
2020-04-18,396,396,383,396,47206409,1763,41003127,393,8,17202578,30003831,23800549,-23800549,11,6203282
2020-04-19,416,416,376,391,65789611,2426,60622611,1013,11,51930761,13858850,8691850,-8691850,5,5167000
2020-04-20,395,430,395,430,38576895,1825,38375988,1066,6,33870990,4705905,4504998,-4504998,3,200907
2020-04-21,440,444,431,444,57426901,1595,43725713,795,11,24455994,32970907,19269719,-19269719,5,13701188
2020-04-22,464,464,455,464,42650078,1097,40080078,425,6,15350078,27300000,24730000,-24730000,3,2570000
2020-04-25,487,487,487,487,37162396,785,22072396,258,5,24770636,12391760,-2698240,2698240,2,15090000
2020-04-26,511,536,511,536,63765175,1738,51500175,952,11,40098354,23666821,11401821,-11401821,10,12265000
2020-04-27,555,555,543,555,18983908,974,15873908,528,4,11753908,7230000,4120000,-4120000,3,3110000
2020-04-28,582,582,582,582,20038462,317,17438462,257,4,2613968,17424494,14824494,-14824494,5,2600000
2020-04-29,611,642,611,642,55188546,1110,24288201,252,3,42988546,12200000,-18700345,18700345,10,30900345
2020-05-02,659,659,659,659,36924833,2417,24843029,318,5,30394833,6530000,-5551804,5551804,7,12081804
2020-05-03,692,692,691,692,47294715,2771,27802629,359,5,42234715,5060000,-14432086,14432086,13,19492086
2020-05-04,726,726,657,726,143803168,6926,111507849,1918,11,124183168,19620000,-12675319,12675319,25,32295319
2020-05-05,750,752,680,680,161413593,6121,104193632,2133,6,155218017,6195576,-51024385,51024385,32,57219961
2020-05-06,662,732,662,732,102321520,2107,74428218,2093,14,58309520,44012000,16118698,-16118698,18,27893302
2020-05-09,750,750,750,750,7783212,98,7683212,392,3,4565181,3218031,3118031,-3118031,1,100000
2020-05-10,788,788,788,788,15780901,157,12980901,338,5,4388447,11392454,8592454,-8592454,4,2800000
2020-05-11,827,827,827,827,8346478,90,7471246,353,3,2853527,5492951,4617719,-4617719,8,875232
2020-05-12,869,869,786,856,192785879,5818,122714753,3079,12,169107694,23678185,-46392941,46392941,39,70071126
2020-05-13,826,880,796,880,88631739,3584,66138448,1995,13,60226053,28405686,5912395,-5912395,17,22493291
2020-05-16,896,900,829,829,78871556,2758,29354053,1914,7,72837514,6034042,-43483461,43483461,15,49517503
2020-05-17,794,836,794,810,11531065,304,10156065,678,2,11317065,214000,-1161000,1161000,4,1375000
2020-05-18,842,885,842,885,82410741,3058,52101247,1843,14,29854898,34845795,22246349,-22246349,11,12599446
2020-05-19,911,911,886,911,36134580,2202,31675815,1043,15,16963744,19170836,14712071,-14712071,10,4458765
2020-05-20,956,956,930,956,78477149,3875,48053520,2348,12,56487149,21990000,-8433629,8433629,18,30423629
2020-05-23,905,930,905,905,61282874,1875,16480874,2054,4,60301526,981348,-43820652,43820652,13,44802000
2020-05-26,860,860,860,860,1684925,279,982925,22,0,1684925,0,-702000,702000,4,702000
2020-05-27,842,859,842,842,43341840,1151,21961840,1815,3,39856069,3485771,-17894229,17894229,12,21380000
2020-05-30,846,875,801,802,81278073,4433,50222951,3828,17,67515962,13762111,-17293011,17293011,22,31055122
2020-05-31,789,795,768,768,49048893,2088,17748893,1621,8,45136991,3911902,-27388098,27388098,14,31300000
2020-06-01,742,804,731,791,35901352,2034,23294916,2295,5,31110627,4790725,-7815711,7815711,12,12606436
2020-06-02,804,809,791,809,21647063,509,12497063,792,9,13373360,8273703,-876297,876297,4,9150000
2020-06-06,848,848,831,848,34094277,1958,29798388,1040,10,26257009,7837268,3541379,-3541379,5,4295889
2020-06-07,890,891,869,890,38150104,3135,24885208,1584,17,28122040,10028064,-3236832,3236832,6,13264896
2020-06-08,930,930,842,842,26354568,2168,17954518,1177,3,25293911,1025607,-7339393,7339393,7,8365000
2020-06-09,829,864,821,832,38104135,1893,33744135,1558,9,34588742,3515393,-844607,844607,6,4360000
2020-06-10,826,862,790,822,38744363,2980,38289363,2110,10,37579363,1165000,710000,-710000,4,455000
2020-06-13,843,861,843,861,35370780,2443,23004306,2010,10,29909485,5464306,-6905179,6905179,9,12369485
2020-06-14,896,896,815,836,35597629,3478,31444653,1840,8,33957629,1640000,-2512976,2512976,7,4152976
2020-06-15,863,873,829,861,38224228,2488,38174228,2134,10,26559518,11664710,11614710,-11614710,1,50000
2020-06-16,881,911,874,911,51171328,3962,39382413,1949,16,27297422,23873906,12084991,-12084991,9,11788915
2020-06-20,953,953,930,953,88721027,6231,85798920,1759,12,19715637,69005390,66083283,-66083283,7,2922107
2020-06-21,967,977,906,906,75010990,7968,62704053,3199,12,65136189,9874801,-2432136,2432136,10,12306937
2020-06-22,891,936,878,888,126419740,9610,103619466,4138,13,90220588,36199152,13398878,-13398878,12,22800274
2020-06-23,902,927,883,907,143500873,8068,130180728,4633,17,90305769,53195104,39874959,-39874959,14,13320145
2020-06-24,916,963,897,963,101256026,2273,91979533,2388,18,44037011,57219015,47942522,-47942522,8,9276493
2020-06-27,1007,1007,1007,1007,8309477,218,7909477,633,7,4104677,4204800,3804800,-3804800,2,400000
2020-06-29,1078,1132,1078,1132,26891551,801,26791551,1796,5,20425496,6466055,6366055,-6366055,1,100000
2020-06-30,1184,1184,1184,1184,4932692,83,4582692,896,3,3304692,1628000,1278000,-1278000,3,350000
2020-07-01,1242,1242,1242,1242,5354378,102,5354378,1009,2,3832378,1522000,1522000,-1522000,0,0
2020-07-04,1304,1304,1180,1304,103694617,7376,83003895,3714,9,99712028,3982589,-16708133,16708133,8,20690722
2020-07-05,1353,1353,1353,1353,10561495,302,10561495,763,2,8961495,1600000,1600000,-1600000,0,0
2020-07-06,1421,1421,1421,1421,8501071,137,8001071,625,2,2201071,6300000,5800000,-5800000,3,500000
2020-07-07,1492,1492,1492,1492,5607010,73,5107010,710,4,2949010,2658000,2158000,-2158000,5,500000
2020-07-08,1566,1566,1424,1523,86674213,6297,58091213,2592,9,70624213,16050000,-12533000,12533000,17,28583000
2020-07-11,1490,1635,1490,1635,92665344,8644,87711821,3531,14,46250189,46415155,41461632,-41461632,9,4953523
2020-07-13,1887,1982,1887,1982,104219242,15296,92419420,5030,21,77488742,26730500,14930678,-14930678,15,11799822
2020-07-14,1988,2057,1862,1862,122383450,30256,112691364,5264,17,83213643,39169807,29477721,-29477721,22,9692086
2020-07-15,1866,1866,1866,1866,12821932,4740,9301732,100,1,12721932,100000,-3420200,3420200,4,3520200
2020-07-18,1773,1773,1773,1773,6790710,2732,5490710,122,1,6690710,100000,-1200000,1200000,2,1300000
2020-07-19,1685,1862,1685,1862,137705001,11057,110487901,12351,20,117856533,19848468,-7368632,7368632,15,27217100
2020-07-22,1882,1976,1882,1976,13499818,332,12600042,944,6,11377833,2121985,1222209,-1222209,1,899776
2020-07-25,2050,2050,1985,2039,66364867,5795,37616367,4396,11,55129388,11235479,-17513021,17513021,21,28748500
2020-07-26,2052,2052,1942,1942,86647560,10915,46899944,7464,17,77396009,9251551,-30496065,30496065,22,39747616
2020-07-27,1944,2055,1859,2055,66654661,5060,58250574,8105,20,51905549,13889500,6345025,-6345025,15,7544475
2020-07-28,2094,2094,2094,2094,802454,14,802454,182,2,527454,275000,275000,-275000,0,0
2020-08-02,2118,2118,2118,2118,14542758,40,14542758,1555,4,4698468,9844290,9844290,-9844290,0,0
2020-08-03,2224,2224,2224,2224,12372440,170,11152440,1362,5,3385213,8987227,7767227,-7767227,11,1220000
2020-08-04,2334,2334,2334,2334,22139379,295,20400917,1909,9,5043337,17096042,15357580,-15357580,13,1738462
2020-08-05,2451,2451,2358,2451,143525690,4282,73772093,6148,17,76786022,20168470,-3013929,3013929,24,23182399
2020-08-09,2450,2552,2334,2418,60210753,8678,41104994,9570,15,56023251,4187502,-14918257,14918257,19,19105759
2020-08-10,2410,2516,2315,2463,75358547,5118,44836743,8196,23,58851785,16509960,-14015042,14015042,11,30525002
2020-08-11,2395,2548,2306,2548,45762189,2804,31718808,6670,13,37833514,7928675,-6114706,6114706,6,14043381
2020-08-12,2552,2552,2512,2552,79524701,3187,66858692,2784,11,50740439,28784262,16118253,-16118253,18,12666009
2020-08-15,2551,2553,2424,2505,99304574,5342,54495651,5922,22,85999587,13304987,-31503936,31503936,18,44808923
2020-08-16,2471,2577,2347,2368,71264935,6982,65502342,5596,22,59191152,12073783,6311190,-6311190,12,5762593
2020-08-17,2407,2602,2378,2602,49626818,3954,40370861,5704,17,39990092,9636726,380769,-380769,20,9255957
2020-08-18,2665,2665,2665,2665,14885266,1051,12280150,1433,6,9856126,5029140,2424024,-2424024,3,2605116
2020-08-19,2614,2798,2546,2798,62241909,4658,52620413,4101,6,49449566,12792343,3170847,-3170847,12,9621496
2020-08-22,2877,2877,2729,2768,83222058,9448,64944577,5244,18,60469460,22752598,4475117,-4475117,19,18277481
2020-08-23,2738,2805,2708,2708,16850210,2064,7199740,1153,4,16744459,105751,-9544719,9544719,7,9650470
2020-08-24,2601,2696,2581,2581,63247098,1158,21167098,2841,5,59129046,4118052,-37961948,37961948,12,42080000
2020-08-25,2498,2722,2498,2722,48661254,1978,35045127,5226,14,44396761,4264493,-9351634,9351634,8,13616127
2020-08-26,2737,2761,2602,2761,73624172,10761,65732250,3980,14,61082207,12541965,4650043,-4650043,17,7891922
2020-08-31,2737,2737,2603,2603,26165905,3127,18610847,1714,2,26160853,6111,-7550006,7550006,11,7556117
2020-09-01,2486,2486,2486,2486,20341749,636,3026749,953,1,20336749,5000,-17310000,17310000,6,17315000
2020-09-02,2362,2362,2362,2362,65797887,390,1413462,271,4,62697887,3100000,-61284425,61284425,6,64384425
2020-09-05,2382,2471,2245,2289,68799394,2806,50634572,6373,15,62402974,6396420,-11768402,11768402,12,18164822
2020-09-06,2245,2341,2165,2165,19136266,1725,11886266,2114,8,15416036,3720230,-3529770,3529770,6,7250000
2020-09-07,2089,2089,2089,2089,139077,149,139077,3,0,139077,0,0,0,0,0
2020-09-08,2084,2084,2084,2084,62520,88,62520,1,0,62520,0,0,0,0,0
2020-09-09,2082,2082,2082,2082,908593,450,908593,11,1,808593,100000,100000,-100000,0,0
2020-09-12,2050,2118,2050,2050,13223281,1166,11895303,729,3,11858631,1364650,36672,-36672,3,1327978
2020-09-13,1952,1952,1952,1952,212591,169,212591,4,1,112591,100000,100000,-100000,0,0
2020-09-14,1946,1946,1946,1946,13407957,582,7307957,142,7,12057957,1350000,-4750000,4750000,2,6100000
2020-09-15,1899,2043,1848,2039,92100289,6884,57624017,6940,18,77268695,14831594,-19644678,19644678,24,34476272
2020-09-16,2048,2048,1853,1853,70222809,4216,57491185,4113,8,53130359,17092450,4360826,-4360826,15,12731624
2020-09-19,1830,1841,1793,1793,22566615,901,11851615,1761,3,21929954,636661,-10078339,10078339,8,10715000
2020-09-20,1711,1779,1707,1707,7710746,336,2010746,1090,2,7370746,340000,-5360000,5360000,5,5700000
2020-09-21,1625,1625,1625,1625,339595,119,339595,7,0,339595,0,0,0,0,0
2020-09-22,1619,1697,1618,1686,63541646,1165,22746771,3896,8,57416352,6170339,-34669581,34669581,11,40839920
2020-09-23,1662,1703,1567,1670,31248904,2199,26517497,3549,10,25639355,5609549,878142,-878142,8,4731407
2020-09-26,1670,1744,1608,1677,22665031,1784,17725032,2136,6,20171239,2493792,-2446207,2446207,8,4939999
2020-09-27,1681,1681,1609,1609,4104802,286,2003802,310,0,4104802,0,-2101000,2101000,4,2101000
2020-09-28,1551,1551,1551,1551,97207,55,97207,2,0,97207,0,0,0,0,0
2020-09-29,1549,1574,1549,1549,23893426,542,7895864,1693,6,20733426,3160000,-12837562,12837562,7,15997562
2020-09-30,1497,1608,1473,1588,32041967,1114,21663835,2500,9,28432705,3609262,-6768870,6768870,13,10378132
2020-10-03,1601,1606,1588,1606,17949225,679,17093000,879,7,9138765,8810460,7954235,-7954235,4,856225
2020-10-04,1685,1685,1525,1651,37686066,2345,33019906,1757,6,32186066,5500000,833840,-833840,10,4666160
2020-10-05,1581,1709,1581,1581,18601780,1489,13120668,1185,3,17536592,1065188,-4415924,4415924,7,5481112
2020-10-06,1598,1677,1598,1677,21470357,1501,20328321,1384,8,17975915,3494442,2352406,-2352406,9,1142036
2020-10-07,1755,1755,1663,1748,30983150,3456,24457706,1468,9,28967627,2015523,-4509921,4509921,6,6525444
2020-10-10,1725,1818,1689,1818,25638739,2233,21178739,1560,8,21426667,4212072,-247928,247928,5,4460000
2020-10-11,1883,1883,1745,1838,26237817,3249,20637817,1431,10,21456000,4781817,-818183,818183,5,5600000
2020-10-12,1807,1909,1774,1807,23200258,2586,17286339,2096,1,20200258,3000000,-2913919,2913919,12,5913919
2020-10-13,1743,1779,1725,1725,11556825,1022,4691699,464,1,9849754,1707071,-5158055,5158055,10,6865126
2020-10-14,1643,1643,1643,1643,2197261,351,697261,10,1,1946454,250807,-1249193,1249193,1,1500000
2020-10-18,1598,1598,1598,1598,2466676,145,766448,49,1,2366676,100000,-1600228,1600228,2,1700228
2020-10-19,1549,1549,1549,1549,1128441,99,128441,13,0,1128441,0,-1000000,1000000,1,1000000
2020-10-20,1527,1527,1527,1527,148883,87,148883,1,0,148883,0,0,0,0,0
2020-10-21,1524,1601,1524,1524,35965120,1930,21222055,1799,5,34435277,1529843,-13213222,13213222,10,14743065
2020-10-24,1449,1454,1449,1449,3920358,215,1310358,379,0,3920358,0,-2610000,2610000,4,2610000
2020-10-26,1378,1378,1378,1378,714679,114,204679,9,1,614679,100000,-410000,410000,2,510000
2020-10-27,1366,1366,1366,1366,875520,97,375520,12,0,875520,0,-500000,500000,1,500000
2020-10-28,1352,1352,1352,1352,14655066,382,2638066,808,3,14520917,134149,-11882851,11882851,7,12017000
2020-10-31,1289,1405,1285,1311,29770595,2293,17736943,2520,7,28083596,1686999,-10346653,10346653,12,12033652
2020-11-15,1249,1299,1198,1235,16493683,1177,13835683,1500,4,15500683,993000,-1665000,1665000,3,2658000
2020-11-16,1249,1313,1198,1313,16961016,286,16348647,1151,3,6961016,10000000,9387631,-9387631,2,612369
2020-11-17,1369,1369,1369,1369,10456677,150,9956677,329,4,1156677,9300000,8800000,-8800000,5,500000
2020-11-18,1438,1438,1438,1438,17471038,237,15971038,309,6,1257824,16213214,14713214,-14713214,10,1500000
2020-11-21,1510,1510,1438,1472,62993907,3290,53754714,2276,10,47238339,15755568,6516375,-6516375,10,9239193
2020-11-22,1485,1573,1439,1573,49138661,1488,45943007,1966,12,28855971,20282690,17087036,-17087036,4,3195654
2020-11-23,1627,1627,1627,1627,13066306,154,12466306,366,3,1066306,12000000,11400000,-11400000,6,600000
2020-11-24,1707,1707,1707,1707,36969963,497,35069963,787,7,10064963,26905000,25005000,-25005000,16,1900000
2020-11-25,1792,1792,1724,1792,165455235,7665,153854836,4599,24,121897755,43554951,31957081,-31957081,19,11597870
2020-11-28,1752,1838,1701,1749,59731039,5061,52519906,5016,9,58304697,1426342,-5784791,5784791,16,7211133
2020-11-29,1773,1838,1766,1838,64645747,1756,53611922,1853,10,27693569,36952178,25918353,-25918353,10,11033825
2020-11-30,1909,1926,1869,1926,5186860,529,3769241,367,1,5086860,100000,-1317619,1317619,2,1417619
2020-12-02,1933,1978,1848,1916,37768322,3142,28730209,2407,12,34690630,3077692,-5960421,5960421,9,9038113
2020-12-05,1943,2020,1882,2018,79780550,5704,69589074,2699,22,38398089,41382461,31190985,-31190985,15,10191476
2020-12-06,2074,2087,1923,1960,67392080,8785,55296658,4605,12,64331627,3060453,-9034969,9034969,24,12095422
2020-12-07,1944,2045,1911,1911,51561628,4624,39467216,3797,7,46550659,5010969,-7083443,7083443,17,12094412
2020-12-08,1870,1963,1849,1855,44355469,4480,32869355,3594,6,42760219,1595250,-9890864,9890864,14,11486114
2020-12-09,1875,1968,1874,1968,32950424,1316,31450424,2853,7,17535588,15414836,13914836,-13914836,3,1500000
2020-12-12,2059,2059,1864,2011,61999483,5149,52324410,3384,14,44786161,17213322,7538249,-7538249,15,9675073
2020-12-13,2019,2140,1984,2055,45658461,5033,40904081,4011,16,30922912,14735549,9981169,-9981169,15,4754380
2020-12-14,2140,2145,1977,1977,22728056,2570,15104298,2371,4,22476822,251234,-7372524,7372524,10,7623758
2020-12-15,1929,1929,1929,1929,4526046,243,526046,30,1,4283581,242465,-3757535,3757535,2,4000000
2020-12-16,1833,1923,1833,1847,57965924,3576,46939840,4195,7,53157370,4808554,-6217530,6217530,13,11026084
2020-12-19,1916,1939,1909,1939,51988673,2019,50586338,1928,15,29464877,22523796,21121461,-21121461,4,1402335
2020-12-20,2032,2032,1862,1931,31153155,3317,27941120,2622,4,29735788,1417367,-1794668,1794668,5,3212035
2020-12-21,1940,2049,1894,2049,39387061,1963,36022684,3215,9,30585021,8802040,5437663,-5437663,8,3364377
2020-12-22,2122,2136,2055,2136,14078627,554,13678372,1865,5,8968707,5109920,4709665,-4709665,2,400255
2020-12-23,2237,2237,2131,2217,70005438,6694,68156903,4562,24,49159306,20846132,18997597,-18997597,8,1848535
2020-12-26,2226,2226,2115,2128,45646698,6096,38194518,5100,10,42729929,2916769,-4535411,4535411,11,7452180
2020-12-27,2154,2252,2092,2190,33984369,4524,29869460,4171,4,29740034,4244335,129426,-129426,5,4114909
2020-12-28,2224,2276,2197,2214,32300397,4593,30257527,3528,12,28596871,3703526,1660656,-1660656,6,2042870
2020-12-29,2238,2353,2130,2353,53070015,2686,37446538,3922,13,41111019,11958996,-3664481,3664481,16,15623477
2020-12-30,2380,2380,2174,2190,63346831,8225,52564558,3783,8,53514781,9832050,-950223,950223,13,10782273
2021-01-02,2190,2211,2163,2163,5995513,921,2786845,326,0,5995513,0,-3208668,3208668,2,3208668
2021-01-03,2058,2122,2058,2058,65131800,4052,55710322,1958,5,56231800,8900000,-521478,521478,11,9421478
2021-01-04,2053,2080,1960,1960,69874308,6702,61033968,5063,8,64337180,5537128,-3303212,3303212,24,8840340
2021-01-05,1923,1971,1890,1890,43781723,4589,34484247,3714,6,36223723,7558000,-1739476,1739476,24,9297476
2021-01-06,1855,1950,1811,1908,69353881,5082,56939728,4896,9,64410046,4943835,-7470318,7470318,14,12414153
2021-01-09,1960,1960,1916,1960,63976312,4948,63683632,2626,13,33357477,30618835,30326155,-30326155,7,292680
2021-01-10,2053,2057,1889,1913,80784239,9549,79252752,4825,18,70222667,10561572,9030085,-9030085,12,1531487
2021-01-11,1899,1945,1891,1891,21301254,3296,19081254,1640,2,21091832,209422,-2010578,2010578,8,2220000
2021-01-12,1802,1848,1802,1802,14182266,1175,7307266,784,0,14182266,0,-6875000,6875000,7,6875000
2021-01-13,1712,1712,1712,1712,3167928,544,2166088,60,1,3012596,155332,-846508,846508,3,1001840
2021-01-16,1638,1638,1638,1638,1191009,325,1187089,22,0,1191009,0,-3920,3920,2,3920
2021-01-18,1614,1614,1614,1614,258161,156,258161,6,0,258161,0,0,0,0,0
2021-01-19,1609,1677,1609,1609,68248065,4358,64237929,3561,6,66637065,1611000,-2399136,2399136,14,4010136
2021-01-20,1574,1694,1574,1677,53974833,3538,44452820,3313,6,47731303,6243530,-3278483,3278483,8,9522013
2021-01-23,1670,1744,1629,1684,42569254,4539,33041218,3525,2,41985731,583523,-8944513,8944513,12,9528036
2021-01-24,1681,1759,1597,1597,48781921,4398,42170744,2998,12,44005610,4776311,-1834866,1834866,13,6611177
2021-01-25,1597,1656,1573,1573,31012894,3010,27424186,2628,7,30334131,678763,-2909945,2909945,10,3588708
2021-01-26,1588,1593,1509,1509,11584135,1347,9434135,762,2,9707026,1877109,-272891,272891,3,2150000
2021-01-27,1443,1503,1443,1470,37563273,2401,31346273,3172,3,37059946,503327,-5713673,5713673,14,6217000
2021-01-30,1471,1532,1471,1532,9048607,431,7689026,976,4,7600226,1448381,88800,-88800,6,1359581
2021-01-31,1605,1605,1454,1505,29782779,2913,27958978,2085,4,29160778,622001,-1201800,1201800,8,1823801
2021-02-01,1461,1530,1455,1455,20483710,1570,18257381,1132,3,20223381,260329,-1966000,1966000,5,2226329
2021-02-02,1394,1491,1390,1403,41036018,2700,38558944,2346,7,37288012,3748006,1270932,-1270932,12,2477074
2021-02-03,1437,1465,1352,1352,21873244,1644,15513641,1482,4,21653003,220241,-6139362,6139362,11,6359603
2021-02-06,1369,1369,1306,1306,27197300,1589,19980261,2100,4,25818493,1378807,-5838232,5838232,14,7217039
2021-02-07,1368,1374,1335,1374,4743107,140,4643107,752,0,4743107,0,-100000,100000,1,100000
2021-02-08,1439,1439,1383,1439,45568178,2298,42609506,2300,10,41339532,4228646,1269974,-1269974,8,2958672
2021-02-09,1441,1503,1404,1503,10964093,363,6058093,1058,3,9864093,1100000,-3806000,3806000,5,4906000
2021-02-13,1577,1577,1577,1577,7419672,468,6794351,536,7,3298720,4120952,3495631,-3495631,3,625321
2021-02-14,1619,1649,1546,1546,25413087,2290,23342477,1650,6,24343587,1069500,-1001110,1001110,13,2070610
2021-02-15,1546,1573,1546,1546,13780397,1063,10666354,661,3,13125397,655000,-2459043,2459043,8,3114043
2021-02-16,1518,1545,1517,1517,2291999,292,1864675,224,0,2291999,0,-427324,427324,2,427324
2021-02-17,1500,1517,1500,1500,3553578,335,2553578,273,0,3553578,0,-1000000,1000000,2,1000000
2021-02-20,1475,1475,1475,1475,263074,127,263074,5,0,263074,0,0,0,0,0
2021-02-21,1473,1473,1473,1473,100800,76,100800,2,0,100800,0,0,0,0,0
2021-02-22,1472,1472,1472,1472,113120,46,113120,4,0,113120,0,0,0,0,0
2021-02-23,1471,1471,1471,1471,3814895,247,1693895,57,1,3664895,150000,-1971000,1971000,5,2121000
2021-02-24,1443,1471,1443,1443,4526955,354,3408021,385,1,4326955,200000,-918934,918934,5,1118934
2021-02-27,1416,1416,1416,1416,199842,57,199842,5,0,199842,0,0,0,0,0
2021-02-28,1415,1415,1415,1415,202665,51,202665,3,0,202665,0,0,0,0,0
2021-03-01,1413,1413,1413,1413,200068,80,200068,5,0,200068,0,0,0,0,0
2021-03-02,1412,1412,1412,1412,2709794,184,826456,36,2,2509794,200000,-1683338,1683338,6,1883338
2021-03-03,1393,1393,1393,1393,3324364,433,1628364,48,4,2977641,346723,-1349277,1349277,6,1696000
2021-03-06,1371,1371,1371,1371,1212462,304,712462,14,2,1012462,200000,-300000,300000,1,500000
2021-03-07,1363,1363,1363,1363,6610703,349,2610703,93,5,5910703,700000,-3300000,3300000,1,4000000
2021-03-08,1336,1336,1336,1336,19454244,1160,11592244,101,7,17529244,1925000,-5937000,5937000,6,7862000
2021-03-09,1318,1382,1309,1309,38685652,3086,29328364,2724,7,36547660,2137992,-7219296,7219296,13,9357288
2021-03-10,1302,1367,1299,1322,26807020,2970,19453815,2455,10,22447473,4359547,-2993658,2993658,11,7353205
2021-03-13,1310,1355,1310,1335,41254845,3841,33978317,2644,6,30807823,10447022,3170494,-3170494,9,7276528
2021-04-26,1253,1272,1216,1216,168743846,1321,122047600,378,2,162743846,6000000,-40696246,40696246,5,46696246
2021-04-27,1198,1308,1198,1262,572391086,4930,457155258,2937,18,493252763,79138323,-36097505,36097505,15,115235828
2021-04-28,1281,1318,1272,1318,501229329,2135,484877630,2200,17,369706550,131522779,115171080,-115171080,10,16351699
2021-05-01,1391,1391,1318,1327,758876862,6843,753768617,3493,15,636456880,122419982,117311737,-117311737,12,5108245
2021-05-02,1336,1345,1327,1327,61502834,849,50493598,311,2,60259734,1243100,-9766136,9766136,3,11009236
2021-05-03,1291,1324,1291,1291,234301194,1134,193297626,784,4,202216269,32084925,-8918643,8918643,4,41003568
2021-05-05,1272,1343,1254,1309,343953042,2443,336359430,2577,11,313076332,30876710,23283098,-23283098,6,7593612
2021-05-08,1301,1334,1258,1258,139031314,1299,120831314,647,0,139031314,0,-18200000,18200000,2,18200000
2021-05-09,1228,1228,1228,1228,14275886,261,10775886,38,0,14275886,0,-3500000,3500000,1,3500000
2021-05-10,1219,1272,1219,1258,389576223,2047,322464509,1785,3,380438408,9137815,-57973899,57973899,12,67111714
2021-05-11,1208,1290,1198,1233,362138485,3092,343415259,1724,7,339428648,22709837,3986611,-3986611,9,18723226
2021-05-12,1244,1264,1202,1202,257980427,1982,193753887,1233,6,228073696,29906731,-34319809,34319809,13,64226540
2021-05-15,1189,1243,1161,1187,272953806,2277,191553806,1414,7,262648663,10305143,-71094857,71094857,9,81400000
2021-05-16,1152,1243,1152,1243,555227580,1858,550216647,2562,12,432026001,123201579,118190646,-118190646,6,5010933
2021-05-17,1244,1253,1178,1178,216097855,2149,188052565,921,3,209726818,6371037,-21674253,21674253,6,28045290
2021-05-18,1151,1179,1139,1139,105038381,1236,80764907,405,1,102838381,2200000,-22073474,22073474,6,24273474
2021-05-19,1100,1124,1085,1085,83453200,1141,63453200,444,3,79841200,3612000,-16388000,16388000,1,20000000
2021-05-22,1037,1037,1037,1037,215258216,847,60227947,531,5,192578263,22679953,-132350316,132350316,7,155030269
2021-05-23,985,1026,985,985,159960795,1460,111960795,701,4,153753685,6207110,-41792890,41792890,4,48000000
2021-05-24,946,1004,943,988,154623257,1395,128586215,1440,6,146197530,8425727,-17611315,17611315,4,26037042
2021-05-25,1004,1023,987,1022,273895037,1221,269406165,1561,10,189054166,84840871,80351999,-80351999,5,4488872
2021-05-26,1041,1049,995,1023,136483360,1321,111333360,1544,5,121506630,14976730,-10173270,10173270,3,25150000
2021-05-29,1041,1077,1023,1077,271437510,1678,237276173,965,9,141898761,129538749,95377412,-95377412,13,34161337
2021-05-30,1111,1123,1025,1043,230447004,2901,213684808,1313,9,205720429,24726575,7964379,-7964379,4,16762196
2021-05-31,1040,1064,1024,1024,172177077,1605,123297077,719,3,161766475,10410602,-38469398,38469398,7,48880000
2021-06-01,991,1032,977,977,220510827,1974,150779810,540,3,217957638,2553189,-67177828,67177828,10,69731017
2021-06-02,967,1032,956,1032,214125982,1599,183200719,1553,7,183094885,31031097,105834,-105834,10,30925263
2021-06-07,1049,1062,1032,1062,197183659,1109,168591678,1164,8,115994422,81189237,52597256,-52597256,5,28591981
2021-06-08,1087,1107,1073,1092,338341647,2209,300905647,1730,8,295841647,42500000,5064000,-5064000,11,37436000
2021-06-09,1083,1151,1073,1115,186603855,1705,171276151,1418,3,177771202,8832653,-6495051,6495051,7,15327704
2021-06-12,1120,1143,1072,1096,109433295,1259,98413295,1057,1,109432633,662,-11019338,11019338,2,11020000
2021-06-13,1079,1151,1077,1137,145093516,1360,129560615,1353,6,141189077,3904439,-11628462,11628462,8,15532901
2021-06-14,1138,1175,1138,1175,282154415,1528,267674690,1604,10,242125352,40029063,25549338,-25549338,11,14479725
2021-06-15,1197,1214,1116,1128,222826551,2427,202192281,1439,2,222678570,147981,-20486289,20486289,8,20634270
2021-06-16,1120,1179,1113,1133,112451729,1277,95767507,1030,3,103752929,8698800,-7985422,7985422,6,16684222
2021-06-19,1161,1179,1110,1155,120704872,1249,115548360,928,5,101823431,18881441,13724929,-13724929,4,5156512
2021-06-20,1161,1161,1101,1115,104635463,1163,99213856,903,1,104507963,127500,-5294107,5294107,3,5421607
2021-06-21,1120,1175,1090,1175,209441410,1167,199833283,1438,6,183141410,26300000,16691873,-16691873,4,9608127
2021-06-22,1186,1216,1175,1197,217381179,1996,188037224,1131,4,205036919,12344260,-16999695,16999695,10,29343955
2021-06-23,1198,1252,1170,1227,224977786,1943,184499460,1628,8,211424620,13553166,-26925160,26925160,14,40478326
2021-06-26,1255,1283,1207,1244,193022184,2587,175627085,1606,9,147698543,45323641,27928542,-27928542,10,17395099
2021-06-27,1261,1309,1230,1280,197713261,2181,193641346,1649,10,168799286,28913975,24842060,-24842060,6,4071915
2021-06-28,1281,1297,1225,1241,159979100,2048,149663117,1489,4,158550681,1428419,-8887564,8887564,7,10315983
2021-06-29,1257,1271,1222,1237,116190218,1538,101477980,919,2,114098290,2091928,-12620310,12620310,7,14712238
2021-06-30,1261,1276,1241,1246,98434348,1329,80287004,914,5,81243533,17190815,-956529,956529,6,18147344
2021-07-04,1272,1309,1254,1273,186941374,1592,183941374,1343,8,153488933,33452441,30452441,-30452441,1,3000000
2021-07-05,1262,1304,1256,1276,130687548,1423,116575823,1223,5,121649940,9037608,-5074117,5074117,4,14111725
2021-07-06,1289,1340,1284,1305,238543921,1784,221504842,1904,6,205937376,32606545,15567466,-15567466,9,17039079
2021-07-07,1316,1330,1265,1279,120790898,1703,113323425,1258,3,116683018,4107880,-3359593,3359593,7,7467473
2021-07-14,1325,1353,1316,1353,132893634,610,132893634,1071,5,101770521,31123113,31123113,-31123113,0,0
2021-07-17,1405,1411,1373,1410,929633626,3676,827675036,3258,29,541485008,388148618,286190028,-286190028,17,101958590
2021-07-18,1391,1440,1358,1410,483354713,2904,387284817,2591,8,427821653,55533060,-40536836,40536836,12,96069896
2021-07-28,1333,1351,1286,1317,122334862,1280,95336159,762,5,110500823,11834039,-15164664,15164664,7,26998703
2021-07-31,1277,1357,1277,1295,239392659,2210,173845628,1540,9,238557532,835127,-64711904,64711904,9,65547031
2021-08-01,1288,1342,1272,1319,196691739,1858,172567283,1567,4,191852030,4839709,-19284747,19284747,6,24124456
2021-08-02,1319,1369,1312,1324,182742259,1670,132982814,1369,4,177592259,5150000,-44609445,44609445,10,49759445
2021-08-03,1339,1339,1268,1278,242482838,2312,185734490,1220,3,234471911,8010927,-48737421,48737421,10,56748348
2021-08-04,1280,1311,1234,1275,162560564,1462,121059351,1369,4,155948496,6612068,-34889145,34889145,12,41501213
2021-08-07,1277,1319,1275,1299,143464297,1132,102088675,1219,3,142643519,820778,-40554844,40554844,8,41375622
2021-08-08,1313,1328,1281,1291,138079113,1039,121328821,1072,4,124470374,13608739,-3141553,3141553,9,16750292
2021-08-09,1284,1341,1282,1325,277025386,1452,245950389,1624,10,236490033,40535353,9460356,-9460356,14,31074997
2021-08-10,1342,1361,1306,1322,207280892,1662,141400869,1314,6,188658980,18621912,-47258111,47258111,17,65880023
2021-08-11,1333,1342,1299,1337,247175965,1523,199849112,1973,7,230078381,17097584,-30229269,30229269,13,47326853
2021-08-14,1338,1388,1338,1388,311252225,303,172196492,1558,9,177159892,134092333,-4963400,4963400,6,139055733
2021-08-15,1455,1455,1455,1455,121438767,109,105638767,855,5,70510603,50928164,35128164,-35128164,3,15800000
2021-08-22,1527,1527,1527,1527,93444790,239,87044790,554,6,19462010,73982780,67582780,-67582780,9,6400000
2021-08-23,1603,1603,1560,1603,1444619699,5532,1082451359,4579,31,1047720764,396898935,34730595,-34730595,37,362168340
2021-08-24,1615,1679,1569,1679,550605094,2152,451107601,2298,20,394405064,156200030,56702537,-56702537,19,99497493
2021-08-25,1737,1747,1629,1720,755105771,5553,712587514,3687,25,481898573,273277198,230688941,-230688941,14,42588257
2021-08-28,1746,1802,1719,1750,594815513,6454,530463440,3091,13,514591018,80224495,15872422,-15872422,27,64352073
2021-08-29,1751,1756,1660,1660,490552780,4584,313679690,3216,10,450928716,39624064,-137249026,137249026,22,176873090
2021-08-30,1625,1658,1625,1625,268800734,1712,175800734,1127,9,251280886,17519848,-75480152,75480152,8,93000000
2021-08-31,1545,1624,1545,1545,374500093,3049,313229270,2266,3,338253307,36246786,-25024037,25024037,14,61270823
2021-09-01,1530,1632,1484,1611,285997334,2775,228752245,2228,12,246619983,39377351,-17867738,17867738,13,57245089
2021-09-04,1615,1647,1586,1613,174270408,2035,138416373,1590,5,169846898,4423510,-31430525,31430525,7,35854035
2021-09-05,1610,1690,1561,1690,489182394,2200,445372444,2946,19,331269227,157913167,114103217,-114103217,17,43809950
2021-09-06,1709,1757,1674,1699,380295833,2977,283730897,3139,19,297156916,83138917,-13426019,13426019,11,96564936
2021-09-07,1672,1709,1652,1660,226941918,1471,107744757,2469,7,177525023,49416895,-69780266,69780266,12,119197161
2021-09-08,1685,1723,1662,1684,99101085,1222,88635496,2899,6,97893667,1207418,-9258171,9258171,6,10465589
2021-09-11,1714,1714,1601,1606,181380714,1820,96410714,1406,2,170644986,10735728,-74234272,74234272,6,84970000
2021-09-12,1615,1633,1566,1570,193832255,2150,104221608,1186,7,181722255,12110000,-77500647,77500647,15,89610647
2021-09-13,1605,1652,1528,1624,215708164,1668,163224183,1941,7,186647164,29061000,-23422981,23422981,9,52483981
2021-09-14,1643,1684,1615,1662,160646291,1251,123881657,2071,10,120386154,40260137,3495503,-3495503,7,36764634
2021-09-15,1680,1709,1623,1680,263913035,1310,152580767,2954,8,234313368,29599667,-81732601,81732601,14,111332268
2021-09-18,1682,1685,1592,1592,205768584,1755,103885391,1178,6,178799963,26968621,-74914572,74914572,7,101883193
2021-09-19,1572,1625,1535,1599,147486509,1118,106522109,1657,4,145646794,1839715,-39124685,39124685,8,40964400
2021-09-20,1618,1618,1560,1572,108235300,1027,77352907,992,4,99216419,9018881,-21863512,21863512,13,30882393
2021-09-21,1596,1596,1509,1509,182616341,1241,109214874,1068,7,156526341,26090000,-47311467,47311467,12,73401467
2021-09-22,1470,1521,1439,1516,190061182,1669,106490076,1662,4,162968051,27093131,-56477975,56477975,14,83571106
2021-09-25,1493,1552,1493,1552,206195416,1489,174812627,1154,5,126456988,79738428,48355639,-48355639,7,31382789
2021-09-26,1549,1567,1502,1557,130676390,831,112205925,1044,5,109032938,21643452,3172987,-3172987,3,18470465
2021-09-28,1549,1607,1531,1607,227526273,925,201301050,1652,8,195145526,32380747,6155524,-6155524,4,26225223
2021-09-29,1620,1666,1598,1655,225419924,1518,169129352,1566,9,208454299,16965625,-39324947,39324947,6,56290572
2021-10-02,1671,1689,1642,1650,174332670,1452,147511201,1634,3,173059711,1272959,-25548510,25548510,3,26821469
2021-10-03,1660,1741,1656,1741,606253991,1955,527040832,2970,19,382179191,224074800,144861641,-144861641,11,79213159
2021-10-04,1765,1803,1740,1770,346409643,2722,323991691,2322,10,328771276,17638367,-4779585,4779585,9,22417952
2021-10-06,1783,1849,1746,1819,271463592,2110,250808579,2598,7,255818759,15644833,-5010180,5010180,3,20655013
2021-10-09,1801,1807,1717,1717,238635095,1775,121515095,1367,2,224671823,13963272,-103156728,103156728,10,117120000
2021-10-10,1705,1724,1666,1718,254534367,1581,162151308,1816,4,252918271,1616096,-90766963,90766963,15,92383059
2021-10-11,1737,1754,1680,1689,156709211,1320,104295462,1037,3,154488871,2220340,-50193409,50193409,4,52413749
2021-10-12,1644,1671,1618,1619,217460911,997,139146641,1076,3,215294584,2166327,-76147943,76147943,11,78314270
2021-10-13,1602,1652,1541,1603,327365939,1473,197159584,1360,3,326099680,1266259,-128940096,128940096,11,130206355
2021-10-16,1613,1649,1613,1649,149149132,504,148740232,888,7,98107503,51041629,50632729,-50632729,4,408900
2021-10-17,1662,1701,1600,1624,179039799,1138,127357461,1116,4,165849799,13190000,-38492338,38492338,6,51682338
2021-10-18,1642,1667,1599,1651,128189611,1014,79028059,1042,2,120740748,7448863,-41712689,41712689,7,49161552
2021-10-19,1652,1711,1631,1664,159323639,1316,153425166,1298,7,145728489,13595150,7696677,-7696677,9,5898473
2021-10-20,1684,1690,1627,1662,108931153,751,63206299,856,3,104219683,4711470,-41013384,41013384,4,45724854
2021-10-23,1643,1662,1562,1605,183542307,1213,108227827,1013,6,154672606,28869701,-46444779,46444779,8,75314480
2021-10-25,1585,1615,1506,1514,124026946,1079,84359543,1105,5,116111119,7915827,-31751576,31751576,7,39667403
2021-10-26,1522,1567,1507,1513,121809857,960,75762960,950,4,121348986,460871,-45586026,45586026,5,46046897
2021-10-27,1522,1561,1516,1535,85294753,865,67853730,841,3,81619291,3675462,-13765561,13765561,3,17441023
2021-10-30,1540,1562,1460,1476,125568798,748,72049677,1229,4,124151039,1417759,-52101362,52101362,4,53519121
2021-10-31,1438,1483,1429,1429,186862115,634,31462115,591,3,172777420,14084695,-141315305,141315305,10,155400000
2021-11-01,1493,1505,1483,1505,165808835,571,157108835,883,9,135002510,30806325,22106325,-22106325,3,8700000
2021-11-02,1525,1579,1504,1579,90551698,424,84551698,728,6,78714469,11837229,5837229,-5837229,1,6000000
2021-11-03,1624,1641,1582,1641,226428012,1052,203430286,1077,9,155728012,70700000,47702274,-47702274,10,22997726
2021-11-06,1719,1719,1719,1719,85170159,140,81370159,448,5,20151553,65018606,61218606,-61218606,6,3800000
2021-11-07,1804,1804,1690,1756,873970781,3780,745431640,3523,19,693883902,180086879,51547738,-51547738,24,128539141
2021-11-08,1774,1854,1715,1733,570746742,3433,444492376,2600,10,463801824,106944918,-19309448,19309448,16,126254366
2021-11-09,1714,1779,1695,1695,396076027,3010,291918960,1996,4,344811344,51264683,-52892384,52892384,22,104157067
2021-11-10,1784,1799,1751,1799,293057444,626,262872444,1719,10,179227359,113830085,83645085,-83645085,5,30185000
2021-11-13,1707,1707,1707,1707,47941591,612,20791591,128,4,46341591,1600000,-25550000,25550000,3,27150000
2021-11-14,1765,1802,1737,1802,829063781,3229,676313105,3847,19,672628429,156435352,3684676,-3684676,21,152750676
2021-11-15,1825,1858,1737,1793,339584916,2426,217161692,2301,9,315662747,23922169,-98501055,98501055,15,122423224
2021-11-16,1784,1849,1760,1811,198575865,1787,176149045,1589,4,186883578,11692287,-10734533,10734533,11,22426820
2021-11-17,1812,1900,1812,1900,467016700,2027,435755931,3104,13,332077052,134939648,103678879,-103678879,10,31260769
2021-11-20,1925,1952,1854,1940,363560085,2590,271499966,2704,13,318368521,45191564,-46868555,46868555,17,92060119
2021-11-21,1963,1994,1925,1994,629036650,3336,528219765,3074,23,398927862,230108788,129291903,-129291903,21,100816885
2021-11-22,2018,2034,1942,1964,399952368,3469,261881922,2806,8,364376118,35576250,-102494196,102494196,24,138070446
2021-11-23,1964,1990,1902,1931,177084576,1940,118542593,2138,5,172351861,4732715,-53809268,53809268,13,58541983
2021-11-24,1948,2025,1860,2010,529740045,3805,479640045,3477,13,469841752,59898293,9798293,-9798293,15,50100000
2021-11-27,1896,1999,1892,1922,252878616,2593,211125885,1860,4,244751603,8127013,-33625718,33625718,12,41752731
2021-11-28,1924,2001,1920,1971,155336570,1414,119771539,1543,9,132524126,22812444,-12752587,12752587,10,35565031
2021-11-29,1995,2034,1927,1943,148383605,1823,133335605,1330,5,134238554,14145051,-902949,902949,6,15048000
2021-11-30,1942,2016,1906,1929,170620328,1625,139169579,1252,9,146618428,24001900,-7448849,7448849,12,31450749
2021-12-01,1909,1944,1848,1869,223661446,1953,180231810,1356,4,195507815,28153631,-15276005,15276005,11,43429636
2021-12-04,1870,1896,1772,1811,242630729,1787,128438541,1506,7,197458740,45171989,-69020199,69020199,11,114192188
2021-12-05,1784,1849,1740,1815,103065322,1260,88641045,1145,3,101983584,1081738,-13342539,13342539,7,14424277
2021-12-06,1804,1868,1803,1822,86655791,1102,79131366,1039,6,83558115,3097676,-4426749,4426749,5,7524425
2021-12-07,1839,1863,1802,1814,54679509,815,39022414,771,0,54679509,0,-15657095,15657095,6,15657095
2021-12-08,1822,1913,1822,1906,402996893,2113,360976893,2102,16,283861951,119134942,77114942,-77114942,15,42020000
2021-12-11,1925,1951,1817,1821,203361204,1627,135956204,1237,4,189113942,14247262,-53157738,53157738,8,67405000
2021-12-12,1821,1858,1782,1782,198374559,1404,96924559,913,4,192146559,6228000,-95222000,95222000,10,101450000
2021-12-13,1737,1817,1695,1695,178515490,1412,93174172,1047,3,174317697,4197793,-81143525,81143525,14,85341318
2021-12-14,1690,1727,1631,1663,125702533,1086,105426422,1196,0,125702533,0,-20276111,20276111,13,20276111
2021-12-15,1671,1727,1644,1687,92347527,941,82509961,867,1,88347527,4000000,-5837566,5837566,6,9837566
2021-12-18,1718,1758,1704,1758,151962216,918,150471872,1208,7,141935756,10026460,8536116,-8536116,3,1490344
2021-12-19,1782,1793,1669,1713,118765081,1179,97896549,994,0,118765081,0,-20868532,20868532,4,20868532
2021-12-20,1699,1763,1675,1736,70232908,664,55731798,807,4,66416114,3816794,-10684316,10684316,11,14501110
2021-12-21,1779,1802,1756,1777,56444778,552,45329277,602,2,56273949,170829,-10944672,10944672,8,11115501
2021-12-22,1811,1868,1802,1868,148028269,809,135096881,1212,9,121674969,26353300,13421912,-13421912,8,12931388
2021-12-25,1879,1915,1784,1821,132022731,1450,104420674,1244,8,123685329,8337402,-19264655,19264655,9,27602057
2021-12-26,1820,1831,1779,1821,88440653,924,73477249,839,2,87040653,1400000,-13563404,13563404,5,14963404
2021-12-27,1814,1894,1814,1840,97252983,1080,88672746,1069,5,91992539,5260444,-3319793,3319793,11,8580237
2021-12-28,1849,1918,1806,1887,110333437,932,86081076,1067,3,107127609,3205828,-21046533,21046533,8,24252361
2021-12-29,1888,1962,1863,1878,100009079,994,74527846,1121,6,90267948,9741131,-15740102,15740102,4,25481233
2022-01-01,1879,1887,1809,1840,100533167,886,53771675,822,2,100337617,195550,-46565942,46565942,7,46761492
2022-01-02,1848,1863,1804,1840,72965458,707,37922176,646,1,72565458,400000,-34643282,34643282,8,35043282
2022-01-03,1835,1855,1806,1809,53336503,613,28380518,615,1,53316503,20000,-24935985,24935985,5,24955985
2022-01-04,1823,1831,1751,1781,130847935,888,59439242,631,4,124789345,6058590,-65350103,65350103,9,71408693
2022-01-05,1802,1823,1784,1819,83068537,558,64254520,704,2,78467998,4600539,-14213478,14213478,11,18814017
2022-01-08,1821,1892,1784,1874,116549479,1005,98192775,1509,6,113146094,3403385,-14953319,14953319,11,18356704
2022-01-09,1868,1904,1802,1848,75026653,760,55707393,863,3,73102103,1924550,-17394710,17394710,7,19319260
2022-01-10,1858,1934,1818,1914,137603053,939,109267525,1468,6,121161384,16441669,-11893859,11893859,13,28335528
2022-01-11,1915,1959,1868,1900,100174658,987,75542433,1087,5,97302452,2872206,-21760019,21760019,7,24632225
2022-01-12,1887,1927,1871,1896,80301271,621,42557320,923,5,74022647,6278624,-31465327,31465327,11,37743951
2022-01-15,1887,1895,1808,1826,122968845,1055,56829085,667,2,112918845,10050000,-56089760,56089760,7,66139760
2022-01-18,1731,1759,1731,1745,65900441,628,32416581,394,1,54100441,11800000,-21683860,21683860,7,33483860
2022-01-19,1702,1793,1690,1750,71733723,821,64538521,806,2,71543441,190282,-7004920,7004920,6,7195202
2022-01-22,1746,1789,1714,1715,50078880,548,29337419,724,7,48273113,1805767,-18935694,18935694,6,20741461
2022-01-23,1694,1736,1650,1671,105416438,826,69607669,736,6,96691518,8724920,-27083849,27083849,9,35808769
2022-01-24,1648,1699,1629,1649,108885883,816,53532914,693,7,70572616,38313267,-17039702,17039702,7,55352969
2022-01-25,1644,1670,1586,1587,157105130,889,71283806,535,3,150705130,6400000,-79421324,79421324,10,85821324
2022-01-26,1615,1671,1594,1651,113001166,924,92215935,715,2,111305369,1695797,-19089434,19089434,6,20785231
2022-01-29,1648,1701,1625,1701,64946819,491,53544493,721,7,59476283,5470536,-5931790,5931790,5,11402326
2022-01-30,1741,1756,1662,1699,113827676,876,66261168,834,6,108227445,5600231,-41966277,41966277,9,47566508
2022-01-31,1668,1784,1663,1784,165355490,444,139893127,1040,14,106947167,58408323,32945960,-32945960,7,25462363
2022-02-01,1812,1831,1746,1772,182588051,1242,122217816,874,5,144295292,38292759,-22077476,22077476,9,60370235
2022-02-02,1774,1798,1737,1759,85775869,705,50152065,788,2,77831450,7944419,-27679385,27679385,9,35623804
2022-02-05,1800,1812,1738,1742,55606274,593,35064139,719,3,53364493,2241781,-18300354,18300354,3,20542135
2022-02-06,1765,1765,1678,1678,54877452,577,33277452,233,3,31736133,23141319,1541319,-1541319,4,21600000
2022-02-07,1628,1660,1608,1616,175790815,1584,107909137,836,1,172652638,3138177,-64743501,64743501,10,67881678
2022-02-08,1619,1695,1619,1659,118707878,779,96802073,979,6,105150190,13557688,-8348117,8348117,5,21905805
2022-02-09,1643,1737,1643,1700,93276029,913,75951286,1213,3,93107810,168219,-17156524,17156524,11,17324743
2022-02-12,1693,1716,1632,1648,53010366,655,42659460,700,1,52690366,320000,-10030906,10030906,7,10350906
2022-02-13,1649,1649,1615,1633,80162461,433,45858482,595,5,75932013,4230448,-30073531,30073531,8,34303979
2022-02-14,1616,1671,1616,1646,42476554,431,25667931,444,1,41941554,535000,-16273623,16273623,6,16808623
2022-02-16,1661,1661,1623,1637,47185076,396,27139358,480,1,47006087,178989,-19866729,19866729,5,20045718
2022-02-19,1662,1689,1630,1647,71430212,726,39708281,585,4,55113767,16316445,-15405486,15405486,10,31721931
2022-02-20,1656,1662,1617,1652,62432443,616,42987939,533,5,37311053,25121390,5676886,-5676886,7,19444504
2022-02-21,1643,1723,1643,1723,310940585,849,214459880,1249,12,137950253,172990332,76509627,-76509627,16,96480705
2022-02-22,1756,1756,1690,1712,75549074,720,51704642,713,3,72719074,2830000,-21014432,21014432,13,23844432
2022-02-23,1712,1759,1692,1743,79020623,451,39928220,657,7,61353950,17666673,-21425730,21425730,11,39092403
2022-02-26,1673,1713,1652,1657,137982426,1085,65039286,687,5,120497826,17484600,-55458540,55458540,17,72943140
2022-02-27,1657,1690,1615,1662,49535678,595,40284088,425,4,41295678,8240000,-1011590,1011590,7,9251590
2022-02-28,1671,1689,1649,1660,34858211,456,32038211,426,4,29158211,5700000,2880000,-2880000,4,2820000
2022-03-02,1626,1659,1587,1616,62982466,671,49088342,570,4,56974466,6008000,-7886124,7886124,11,13894124
2022-03-05,1645,1701,1645,1701,215875824,832,142480356,1112,11,113673833,102201991,28806523,-28806523,11,73395468
2022-03-06,1709,1756,1677,1732,122063118,793,81972876,966,3,114030603,8032515,-32057727,32057727,15,40090242
2022-03-07,1704,1753,1672,1695,114924250,818,62439250,823,3,110541679,4382571,-48102429,48102429,16,52485000
2022-03-08,1690,1690,1626,1636,75701556,855,52183745,478,3,62214510,13487046,-10030765,10030765,11,23517811
2022-03-09,1649,1717,1636,1693,111900263,834,101915040,786,8,83143187,28757076,18771853,-18771853,5,9985223
2022-03-12,1595,1623,1595,1622,129825280,1156,83831983,673,5,114628924,15196356,-30796941,30796941,12,45993297
2022-03-13,1613,1614,1569,1599,68077374,748,42798989,516,6,57939348,10138026,-15140359,15140359,10,25278385
2022-03-14,1571,1614,1571,1587,40424412,443,29828402,466,4,39749073,675339,-9920671,9920671,8,10596010
2022-03-15,1574,1653,1574,1619,69057575,452,41579523,629,6,55429865,13627710,-13850342,13850342,6,27478052
2022-03-16,1672,1711,1672,1711,194605032,473,152870809,941,9,116113593,78491439,36757216,-36757216,9,41734223
2022-03-19,1795,1795,1751,1795,172912880,548,127864714,859,8,113371101,59541779,14493613,-14493613,8,45048166
2022-03-26,1801,1849,1746,1773,222381305,1487,132750267,1116,8,213064579,9316726,-80314312,80314312,10,89631038
2022-03-27,1737,1831,1718,1788,199421938,1289,145592286,1059,8,179754538,19667400,-34162252,34162252,15,53829652
2022-03-28,1774,1866,1756,1840,187941447,1434,153810356,1217,11,162589610,25351837,-8779254,8779254,11,34131091
2022-03-29,1822,1855,1732,1732,211534627,2117,157442577,1007,6,180177514,31357113,-22734937,22734937,16,54092050
2022-03-30,1727,1795,1695,1760,138356237,1365,107043329,941,3,133900237,4456000,-26856908,26856908,11,31312908
2022-04-03,1747,1831,1746,1789,204858990,1491,179893544,1099,9,153348229,51510761,26545315,-26545315,12,24965446
2022-04-04,1791,1835,1706,1737,308937729,2569,260063525,1499,13,265289059,43648670,-5225534,5225534,13,48874204
2022-04-05,1718,1781,1705,1736,161553929,1511,143790265,1078,8,142721930,18831999,1068335,-1068335,9,17763664
2022-04-06,1765,1766,1663,1680,293987412,2775,221439976,1250,6,265353973,28633439,-43913997,43913997,18,72547436
2022-04-09,1662,1774,1635,1774,220370640,1173,219375989,1447,10,122893888,97476752,96482101,-96482101,4,994651
2022-04-10,1829,1829,1829,1829,132132313,391,126932313,719,6,39832313,92300000,87100000,-87100000,12,5200000
2022-04-11,1920,1920,1897,1920,1450899943,5337,1236496908,5054,55,884163385,566736558,352333523,-352333523,43,214403035
2022-04-12,1925,1934,1823,1825,564884374,3567,391919044,2564,17,508040774,56843600,-116121730,116121730,27,172965330
2022-04-13,1841,1948,1841,1948,727312148,2759,700457148,3142,25,444346040,282966108,256111108,-256111108,11,26855000
2022-04-16,2000,2036,1924,1934,320673670,2994,285333565,2092,10,280956981,39716689,4376584,-4376584,14,35340105
2022-04-17,1939,1939,1863,1914,367045048,3510,259597274,1943,7,350730530,16314518,-91133256,91133256,27,107447774
2022-04-18,1925,1957,1839,1885,363892873,3012,277910023,1736,21,305537493,58355380,-27627470,27627470,26,85982850
2022-04-19,1867,1920,1833,1899,214672879,2107,196780212,1549,13,181685855,32987024,15094357,-15094357,11,17892667
2022-04-20,1892,1936,1857,1916,214094257,1990,185698573,1655,14,202230872,16240108,-16532299,16532299,13,32772407
2022-04-24,1940,1940,1884,1891,116939479,1303,93021510,897,3,115385117,1554362,-22363607,22363607,12,23917969
2022-04-25,1892,1923,1880,1898,128089139,1627,115232792,1247,2,127489139,600000,-12256347,12256347,12,12856347
2022-04-26,1897,2009,1897,1957,388638446,2901,343889186,2858,18,329940085,58698361,13949101,-13949101,17,44749260
2022-04-27,1971,2032,1925,1935,218534880,2136,175175587,2202,12,198506131,20028749,-23330544,23330544,18,43359293
2022-04-30,1968,1968,1883,1906,171402790,1861,120778167,1293,5,160773550,10629240,-39995383,39995383,15,50624623
2022-05-01,1906,1934,1878,1888,138448854,1679,118235774,1108,6,127719588,10729266,-9483814,9483814,11,20213080
2022-05-02,1918,1919,1876,1890,165582161,1857,157839161,1012,5,130328550,35253611,27510611,-27510611,9,7743000
2022-05-07,1919,1925,1874,1877,177400792,1996,159995717,1342,6,173887963,3512829,-13892246,13892246,12,17405075
2022-05-08,1879,1923,1878,1896,243823567,2048,198250897,1282,11,227859029,15964538,-29608132,29608132,10,45572670
2022-05-09,1890,1922,1848,1849,203733593,1678,141372795,1265,12,168672314,35061279,-27299519,27299519,16,62360798
2022-05-10,1859,1888,1831,1885,167851909,1284,81855132,1187,11,124469374,43382535,-42614242,42614242,16,85996777
2022-05-11,1896,1917,1879,1896,179804850,1293,140767850,1236,5,157444850,22360000,-16677000,16677000,17,39037000
2022-05-14,1887,1896,1783,1807,399364731,4011,327152087,2537,12,374560321,24804410,-47408234,47408234,27,72212644
2022-05-15,1808,1849,1743,1845,226260763,2307,206827495,1787,11,188134772,38125991,18692723,-18692723,12,19433268
2022-05-16,1877,1909,1868,1885,274458072,2521,259064886,2224,10,259461226,14996846,-396340,396340,12,15393186
2022-05-17,1887,1887,1820,1840,119160918,1271,90457266,1023,7,103392353,15768565,-12935087,12935087,9,28703652
2022-05-18,1845,1878,1797,1836,140326099,1522,122844320,1037,4,135141063,5185036,-12296743,12296743,10,17481779
2022-05-21,1833,1843,1786,1807,114835788,1278,98343851,909,7,81529800,33305988,16814051,-16814051,8,16491937
2022-05-22,1815,1843,1795,1817,79188771,869,56918929,766,5,71435137,7753634,-14516208,14516208,11,22269842
2022-05-23,1821,1821,1708,1741,218408718,2168,138417289,1406,6,183594880,34813838,-45177591,45177591,16,79991429
2022-05-24,1731,1774,1714,1746,74478850,984,55824278,878,3,72445387,2033463,-16621109,16621109,8,18654572
2022-05-25,1751,1774,1730,1755,143747485,1454,89023210,803,5,81401492,62345993,7621718,-7621718,8,54724275
2022-05-28,1756,1770,1663,1686,155713703,1378,112204799,1203,8,123185588,32528115,-10980789,10980789,12,43508904
2022-05-29,1671,1776,1644,1765,169492302,1412,137597850,1378,7,135494356,33997946,2103494,-2103494,16,31894452
2022-05-30,1765,1784,1710,1743,102492234,1068,84085867,1088,5,90019469,12472765,-5933602,5933602,9,18406367
2022-05-31,1735,1777,1729,1744,96157927,613,83640098,704,4,85350149,10807778,-1710051,1710051,4,12517829
2022-06-01,1781,1830,1759,1799,121924153,877,88236319,1051,6,108213184,13710969,-19976865,19976865,7,33687834
2022-06-06,1802,1821,1704,1737,127558360,619,51320214,1094,7,107812814,19745546,-56492600,56492600,11,76238146
2022-06-07,1718,1772,1718,1756,69148148,429,38828452,707,7,57192618,11955530,-18364166,18364166,7,30319696
2022-06-11,1690,1729,1689,1705,61406162,306,25206162,337,3,60212162,1194000,-35006000,35006000,4,36200000
2022-06-12,1692,1737,1676,1727,79671132,710,66458878,791,3,73880042,5791090,-7421164,7421164,11,13212254
2022-06-13,1737,1802,1699,1766,83961608,746,73112675,805,3,80821608,3140000,-7708933,7708933,6,10848933
2022-06-14,1766,1782,1727,1769,129441863,776,65890919,828,5,112252664,17189199,-46361745,46361745,8,63550944
2022-06-15,1753,1753,1692,1719,58597390,522,30792688,524,4,48442972,10154418,-17650284,17650284,5,27804702
2022-06-18,1714,1719,1667,1697,74464655,648,38032122,633,1,74276162,188493,-36244040,36244040,10,36432533
2022-06-19,1671,1698,1671,1680,107076178,670,38955501,619,4,105768224,1307954,-66812723,66812723,14,68120677
2022-06-20,1680,1741,1675,1691,67170162,664,52372698,637,0,67170162,0,-14797464,14797464,8,14797464
2022-06-21,1692,1699,1650,1690,94420038,623,47967823,619,4,93710691,709347,-45742868,45742868,9,46452215
2022-06-22,1699,1701,1648,1676,105781557,980,83712762,594,6,85843433,19938124,-2130671,2130671,6,22068795
2022-06-25,1692,1748,1690,1709,120028852,1036,99497977,934,4,113769871,6258981,-14271894,14271894,3,20530875
2022-06-26,1722,1722,1649,1652,89729053,741,57646914,625,5,70342476,19386577,-12695562,12695562,9,32082139
2022-06-27,1652,1680,1644,1672,98919587,758,43807479,597,8,66844160,32075427,-23036681,23036681,9,55112108
2022-06-28,1691,1707,1662,1675,112305625,591,51743801,522,5,87618296,24687329,-35874495,35874495,11,60561824
2022-06-29,1698,1698,1634,1680,82945786,636,40151588,548,3,73221136,9724650,-33069548,33069548,7,42794198
2022-07-02,1671,1671,1596,1618,76152293,695,45941695,635,1,71752293,4400000,-25810598,25810598,9,30210598
2022-07-03,1610,1618,1578,1606,65484637,663,36927214,531,4,64311237,1173400,-27384023,27384023,8,28557423
2022-07-04,1596,1639,1594,1626,79301780,732,45993239,521,5,74091289,5210491,-28098050,28098050,10,33308541
2022-07-05,1606,1630,1596,1597,63343461,625,55521385,488,3,57527162,5816299,-2005777,2005777,4,7822076
2022-07-06,1598,1598,1566,1568,88302651,623,55612062,480,6,73063890,15238761,-17451828,17451828,11,32690589
2022-07-11,1566,1566,1484,1493,141609308,1085,58210632,726,6,130341121,11268187,-72130489,72130489,12,83398676
2022-07-12,1493,1572,1464,1510,96342491,722,59269362,671,7,91737141,4605350,-32467779,32467779,11,37073129
2022-07-13,1558,1599,1552,1578,106326281,652,66291853,694,5,104722720,1603561,-38430867,38430867,11,40034428
2022-07-16,1576,1585,1511,1532,156320188,696,52230819,780,3,142965716,13354472,-90734897,90734897,6,104089369
2022-07-24,1499,1499,1499,1499,8768139,21,968139,35,1,8687285,80854,-7719146,7719146,3,7800000
2022-07-25,1499,1499,1439,1442,149527632,1017,62611397,769,8,104796682,44730950,-42185285,42185285,12,86916235
2022-07-26,1451,1476,1429,1446,52424206,413,20418843,490,3,44859206,7565000,-24440363,24440363,7,32005363
2022-07-27,1449,1475,1426,1443,47406480,478,36279640,401,2,37157547,10248933,-877907,877907,5,11126840
2022-07-30,1459,1461,1377,1386,64609313,587,40748269,524,5,55105739,9503574,-14357470,14357470,6,23861044
2022-07-31,1372,1419,1339,1344,67587138,638,48271096,512,6,61470162,6116976,-13199066,13199066,10,19316042
2022-08-01,1414,1432,1386,1413,74967601,567,66035656,556,2,52012034,22955567,14023622,-14023622,5,8931945
2022-08-02,1419,1445,1373,1432,76195498,502,38697040,539,3,60240781,15954717,-21543741,21543741,10,37498458
2022-08-03,1434,1494,1415,1494,102667888,565,77263708,784,5,96427888,6240000,-19164180,19164180,5,25404180
2022-08-06,1510,1564,1510,1564,88647261,311,82465498,586,4,51361076,37286185,31104422,-31104422,2,6181763
2022-08-09,1564,1635,1510,1577,130590111,818,102887099,928,7,114017923,16572188,-11130824,11130824,13,27703012
2022-08-10,1556,1623,1524,1615,123947285,483,81908776,872,4,103460444,20486841,-21551668,21551668,5,42038509
2022-08-13,1624,1678,1624,1678,88058769,354,88058769,666,14,44499360,43559409,43559409,-43559409,0,0
2022-08-14,1771,1771,1653,1666,135816379,1072,126916379,1108,9,117717833,18098546,9198546,-9198546,4,8900000
2022-08-15,1666,1801,1666,1762,227471135,1271,192087774,1304,9,157086397,70384738,35001377,-35001377,12,35383361
2022-08-16,1772,1807,1697,1708,139073801,917,125367036,995,11,127875912,11116196,-2508876,2508876,8,13625072
2022-08-17,1739,1820,1739,1762,207577846,1213,161503917,1065,19,148993925,58083921,12509992,-12509992,12,45573929
2022-08-20,1744,1763,1665,1683,101992467,771,62622489,863,3,100537679,1454788,-37915190,37915190,10,39369978
2022-08-21,1683,1741,1659,1676,93887982,595,53202435,618,2,93307982,580000,-40105547,40105547,11,40685547
2022-08-22,1687,1721,1647,1650,75980721,570,44661872,523,3,72511326,3469395,-27849454,27849454,8,31318849
2022-08-23,1663,1699,1655,1659,80887638,690,67154906,449,4,77968138,2919500,-10813232,10813232,12,13732732
2022-08-24,1653,1694,1628,1674,59707796,694,53892884,604,3,59286692,421104,-5393808,5393808,7,5814912
2022-08-27,1696,1697,1604,1612,59617676,808,52382900,507,2,58943565,674111,-6560665,6560665,7,7234776
2022-08-28,1604,1656,1588,1602,81875963,761,63637389,534,0,81875963,0,-18238574,18238574,9,18238574
2022-08-29,1604,1653,1603,1614,113111929,893,108568468,431,3,57291308,55820621,51277160,-51277160,4,4543461
2022-08-30,1631,1635,1547,1556,88562771,823,57796945,462,4,61314763,27248008,-3517818,3517818,11,30765826
2022-08-31,1581,1597,1546,1583,41888234,566,40075775,379,1,41702542,185692,-1626767,1626767,4,1812459
2022-09-03,1558,1573,1509,1536,42857843,451,29465908,428,2,42495710,362133,-13029802,13029802,10,13391935
2022-09-04,1520,1556,1520,1542,42478106,474,33749445,329,3,40083258,2394848,-6333813,6333813,7,8728661
2022-09-05,1562,1563,1523,1531,33451869,352,25870595,354,1,28465049,4986820,-2594454,2594454,5,7581274
2022-09-06,1542,1612,1542,1556,29172983,299,28122983,303,2,27698147,1474836,424836,-424836,3,1050000
2022-09-07,1548,1591,1516,1523,58144943,539,53828553,455,4,39722453,18422490,14106100,-14106100,6,4316390
2022-09-10,1499,1527,1490,1500,56087061,458,26323911,400,5,53607814,2479247,-27283903,27283903,13,29763150
2022-09-11,1487,1513,1463,1476,63127000,417,30221390,335,5,47729110,15397890,-17507720,17507720,12,32905610
2022-09-12,1465,1504,1461,1492,41087859,437,30202504,316,3,32755016,8332843,-2552512,2552512,7,10885355
2022-09-13,1490,1554,1481,1526,61700352,529,57076613,413,4,39398947,22301405,17677666,-17677666,4,4623739
2022-09-14,1537,1543,1499,1521,28503898,346,22821814,377,0,28503898,0,-5682084,5682084,10,5682084
2022-09-18,1473,1509,1470,1474,36607779,455,29367313,311,1,36407779,200000,-7040466,7040466,9,7240466
2022-09-19,1474,1498,1452,1453,35457635,443,23582516,303,3,35009812,447823,-11427296,11427296,6,11875119
2022-09-20,1461,1471,1443,1456,24779656,203,9867232,225,2,24028124,751532,-14160892,14160892,8,14912424
2022-09-21,1452,1490,1431,1437,55773121,422,34527908,287,3,53280177,2492944,-18752269,18752269,10,21245213
2022-09-24,1430,1433,1360,1370,56300204,569,47115466,406,3,54602266,1697938,-7486800,7486800,6,9184738
2022-09-26,1386,1443,1358,1424,69777060,573,60850147,421,4,53842937,15934123,7007210,-7007210,4,8926913
2022-09-28,1432,1475,1414,1432,60386404,498,57824487,403,5,46308944,14077460,11515543,-11515543,2,2561917
2022-10-01,1425,1431,1348,1351,72030123,734,61258597,404,2,69130123,2900000,-7871526,7871526,8,10771526
2022-10-02,1370,1384,1320,1364,58044319,483,44623146,439,6,44489796,13554523,133350,-133350,8,13421173
2022-10-03,1377,1377,1325,1326,40332871,465,32202569,352,4,38497335,1835536,-6294766,6294766,6,8130302
2022-10-04,1344,1385,1328,1372,55689812,360,51929481,379,5,44954581,10735231,6974900,-6974900,6,3760331
2022-10-08,1372,1406,1367,1379,41119237,298,33898283,454,3,36529737,4589500,-2631454,2631454,6,7220954
2022-10-09,1377,1400,1319,1329,77782766,553,48988940,345,4,69465547,8317219,-20476607,20476607,6,28793826
2022-10-10,1338,1348,1319,1332,36778039,346,28312884,260,2,36307639,470400,-7994755,7994755,5,8465155
2022-10-11,1334,1355,1330,1339,36021744,348,35012823,254,2,26829605,9192139,8183218,-8183218,3,1008921
2022-10-12,1334,1361,1331,1339,35624491,233,22496142,256,2,33621799,2002692,-11125657,11125657,7,13128349
2022-10-15,1332,1356,1318,1339,35823865,358,25373465,288,3,30891865,4932000,-5518400,5518400,5,10450400
2022-10-16,1321,1335,1301,1322,62716485,342,24760512,318,2,59466485,3250000,-34705973,34705973,5,37955973
2022-10-17,1311,1338,1311,1324,57474782,309,21054904,271,2,40474782,17000000,-19419878,19419878,7,36419878
2022-10-18,1323,1347,1321,1324,48609227,268,13039663,258,1,24405813,24203414,-11366150,11366150,5,35569564
2022-10-19,1334,1346,1325,1327,23472136,229,14103634,271,1,23202136,270000,-9098502,9098502,5,9368502
2022-10-22,1329,1343,1320,1321,41450039,282,22768396,343,2,39516379,1933660,-16747983,16747983,2,18681643
2022-10-23,1322,1346,1318,1321,55398345,382,32556304,282,1,39598345,15800000,-7042041,7042041,8,22842041
2022-10-24,1321,1329,1272,1275,64936847,548,34736847,357,2,54797518,10139329,-20060671,20060671,6,30200000
2022-10-25,1300,1300,1232,1245,71895600,612,42193494,521,3,70607396,1288204,-28413902,28413902,7,29702106
2022-10-26,1233,1245,1170,1177,57417887,701,42607718,442,1,56963887,454000,-14356169,14356169,8,14810169
2022-10-29,1170,1244,1170,1190,81446547,323,29247668,427,2,79282547,2164000,-50034879,50034879,8,52198879
2022-10-30,1216,1220,1195,1213,45654730,244,19359204,358,3,43422453,2232277,-24063249,24063249,4,26295526
2022-10-31,1194,1291,1194,1291,102346889,457,91038836,567,7,86150042,16196847,4888794,-4888794,3,11308053
2022-11-01,1307,1329,1287,1318,70568682,402,70384142,508,7,66042861,4525821,4341281,-4341281,1,184540
2022-11-02,1320,1325,1288,1321,63529994,264,43825783,506,0,63529994,0,-19704211,19704211,2,19704211
2022-11-05,1365,1393,1332,1346,45225839,426,37922678,457,3,41678232,4095783,-3755554,3755554,3,7851337
2022-11-06,1325,1443,1325,1443,182216165,662,151791999,965,6,125378001,56838164,26413998,-26413998,9,30424166
2022-11-07,1471,1519,1453,1519,198525060,705,159832764,827,12,131500560,67024500,28332204,-28332204,12,38692296
2022-11-08,1556,1584,1480,1484,205685321,1086,153175586,1120,10,169592327,36092994,-16416741,16416741,14,52509735
2022-11-09,1478,1587,1478,1540,157329630,859,117417104,944,10,112419989,44909641,4997115,-4997115,12,39912526
2022-11-12,1520,1556,1481,1493,139327864,917,87274453,725,5,88100272,51227592,-825819,825819,11,52053411
2022-11-13,1490,1536,1490,1500,74163376,465,45163994,569,3,58509071,15654305,-13345077,13345077,8,28999382
2022-11-14,1509,1527,1481,1500,74435710,259,34749116,498,2,59976596,14459114,-25227480,25227480,7,39686594
2022-11-21,1565,1569,1557,1564,23073093,54,9873093,158,2,22516675,556418,-12643582,12643582,3,13200000
2022-11-22,1538,1630,1525,1602,356539415,1280,270120548,1569,26,207642764,148896651,62477784,-62477784,18,86418867
2022-11-23,1607,1622,1570,1575,125639234,755,80208503,727,8,102238902,24200332,-22030399,22030399,14,46230731
2022-11-26,1611,1616,1573,1574,80014571,472,55411568,432,6,58981162,21033409,-3569594,3569594,4,24603003
2022-11-27,1575,1612,1559,1593,113477362,497,84527479,499,8,57979896,55497466,26547583,-26547583,12,28949883
2022-11-28,1612,1612,1561,1575,92389007,445,44861997,529,5,76050697,16338310,-31188700,31188700,12,47527010
2022-11-29,1571,1597,1562,1570,56260153,351,21135160,396,2,45519475,10740678,-24384315,24384315,6,35124993
2022-11-30,1565,1589,1543,1563,38182818,349,22757551,337,1,37182818,1000000,-14425267,14425267,5,15425267
2022-12-03,1547,1574,1527,1546,70351629,439,38674849,428,3,55518890,14832739,-16844041,16844041,10,31676780
2022-12-04,1525,1597,1525,1576,127870169,681,97410910,557,9,87091158,40779011,10319752,-10319752,11,30459259
2022-12-05,1588,1603,1541,1555,64409668,413,39387908,380,4,56475663,7934005,-17087755,17087755,10,25021760
2022-12-06,1537,1592,1537,1568,72741107,432,56347955,500,6,53972926,18768181,2375029,-2375029,7,16393152
2022-12-07,1565,1640,1562,1564,145517088,892,123917088,618,7,108939885,36577203,14977203,-14977203,10,21600000
2022-12-10,1537,1556,1492,1518,50167004,446,35229185,349,3,49021124,1145880,-13791939,13791939,8,14937819
2022-12-11,1535,1536,1495,1511,85796108,550,32551577,365,3,41900899,43895209,-9349322,9349322,13,53244531
2022-12-12,1526,1629,1510,1629,809230720,1156,641608132,1446,21,326857276,482373444,314750856,-314750856,21,167622588
2022-12-13,1640,1708,1631,1665,319576514,1726,272446445,1431,8,303477214,16099300,-31030769,31030769,16,47130069
2022-12-14,1688,1739,1667,1690,99937141,683,82420156,802,10,86107749,13829392,-3687593,3687593,11,17516985
2022-12-17,1714,1714,1669,1669,120566546,995,99922584,685,6,108678502,11888044,-8755918,8755918,10,20643962
2022-12-18,1696,1742,1678,1703,152269358,863,125336158,843,11,124152854,28116504,1183304,-1183304,11,26933200
2022-12-19,1706,1725,1659,1669,67201860,681,45080858,448,3,63565942,3635918,-18485084,18485084,12,22121002
2022-12-20,1665,1676,1598,1647,143595870,1082,90423710,582,8,119451923,24143947,-29028213,29028213,13,53172160
2022-12-21,1631,1669,1622,1626,90125255,730,68563776,476,3,80022985,10102270,-11459209,11459209,9,21561479
2022-12-24,1661,1716,1650,1703,150804225,777,85565401,853,6,126544952,24259273,-40979551,40979551,14,65238824
2022-12-25,1716,1788,1697,1752,208465059,966,109818092,1172,14,151989985,56475074,-42171893,42171893,18,98646967
2022-12-26,1768,1871,1737,1846,450319775,1732,300942868,2269,22,320315898,130003877,-19373030,19373030,16,149376907
2022-12-28,1848,1952,1848,1857,314616515,2035,228584651,1547,13,222805604,91810911,5779047,-5779047,19,86031864
2022-12-31,1763,1853,1758,1822,214563505,1243,119434758,1277,6,163663644,50899861,-44228886,44228886,25,95128747
2023-01-01,1838,1838,1728,1776,171665013,943,94137693,1106,5,167694053,3970960,-73556360,73556360,12,77527320
2023-01-02,1773,1880,1773,1880,378706845,1027,250828231,1218,15,190113532,188593313,60714699,-60714699,23,127878614
2023-01-03,1964,2001,1886,1909,594680581,3210,390704647,2799,32,431382785,163297796,-40678138,40678138,27,203975934
2023-01-04,1886,1947,1871,1933,225763774,1486,167513514,1382,11,172224372,53539402,-4710858,4710858,17,58250260
2023-01-07,1956,2050,1956,1995,288940129,1950,214796135,1986,21,204263289,84676840,10532846,-10532846,13,74143994
2023-01-08,2027,2039,1968,1989,354477468,2544,210574120,2002,11,291066867,63410601,-80492747,80492747,21,143903348
2023-01-09,1971,2136,1970,2136,598131910,1812,340495233,2588,34,302719991,297266919,37775242,-37775242,29,259491677
2023-01-10,2168,2220,2168,2220,948929619,1933,746533599,3007,52,488309130,460620489,258224469,-258224469,30,202396020
2023-01-11,2253,2336,2131,2218,638225863,3551,429131413,2856,28,511690170,126535693,-82558757,82558757,32,209094450
2023-01-14,2089,2282,2089,2263,360999240,2227,236482780,2282,16,299278021,61721219,-62795241,62795241,28,124516460
2023-01-16,2291,2337,2290,2337,597562797,1877,532222316,2115,38,277200219,320362578,255022097,-255022097,16,65340481
2023-01-17,2423,2450,2295,2329,503776773,2969,344566336,2130,25,346810166,156966607,-2243830,2243830,26,159210437
2023-01-18,2335,2430,2292,2322,274209727,1760,182889946,1642,23,204542616,69667111,-21652670,21652670,19,91319781
2023-01-21,2319,2357,2193,2197,348335476,2732,224104876,1967,13,297503565,50831911,-73398689,73398689,20,124230600
2023-01-22,2225,2282,2102,2192,229284793,1459,147813840,1470,17,187764252,41520541,-39950412,39950412,16,81470953
2023-01-23,2225,2235,2034,2074,226216589,1560,133901934,838,7,216367726,9848863,-82465792,82465792,16,92314655
2023-01-24,2102,2168,2069,2134,158999771,1124,120127997,1127,10,132034999,26964772,-11907002,11907002,11,38871774
2023-01-25,2168,2168,1975,2008,295465878,1526,131164166,1461,18,256316681,39149197,-125152515,125152515,20,164301712
2023-01-28,2036,2051,1886,1924,297119118,1285,98345716,1272,10,245082353,52036765,-146736637,146736637,17,198773402
2023-01-29,1822,1834,1822,1822,231346958,1028,104773611,858,8,202174457,29172501,-97400846,97400846,17,126573347
2023-01-30,1758,1864,1731,1859,233884633,1124,118553431,1347,13,209590199,24294434,-91036768,91036768,21,115331202
2023-01-31,1895,1920,1795,1911,103771956,913,89968456,810,11,82936976,20834980,7031480,-7031480,7,13803500
2023-02-01,1911,1914,1838,1857,88643070,811,69699872,587,9,80238612,8404458,-10538740,10538740,5,18943198
2023-02-05,1874,1876,1733,1733,261719365,1273,110202688,925,19,204917955,56801410,-94715267,94715267,7,151516677
2023-02-06,1679,1741,1678,1708,68518923,858,58805120,697,4,66726935,1791988,-7921815,7921815,10,9713803
2023-02-07,1791,1831,1750,1831,219916595,916,185811469,791,12,86955895,132960700,98855574,-98855574,6,34105126
2023-02-08,1954,1954,1876,1923,337349374,2136,278661770,1361,22,208986001,128363373,69675769,-69675769,11,58687604
2023-02-12,1952,1954,1870,1890,126745570,818,75393257,837,11,105111853,21633717,-29718596,29718596,13,51352313
2023-02-20,1942,1989,1941,1970,213686477,1170,178908697,403,13,149187989,64498488,29720708,-29720708,13,34777780
2023-02-21,1980,2039,1872,1885,828612672,5114,712016519,2987,41,640952399,187660273,71064120,-71064120,32,116596153
2023-02-22,1886,1902,1820,1840,242809442,2617,199347934,1304,14,205679250,37130192,-6331316,6331316,17,43461508
2023-02-25,1876,1970,1867,1970,455807958,3251,418686831,2254,27,346034094,109773864,72652737,-72652737,16,37121127
2023-02-26,1935,1946,1803,1834,317160106,2620,253948132,1380,14,264415380,52744726,-10467248,10467248,7,63211974
2023-02-27,1979,1979,1888,1910,376968413,2404,347162171,1904,20,284025040,92943373,63137131,-63137131,14,29806242
2023-02-28,1910,1911,1832,1859,247350319,2542,228313829,1167,6,232757717,14592602,-4443888,4443888,13,19036490
2023-03-01,1841,1864,1757,1774,262087619,2379,198190462,1203,6,256041029,6046590,-57850567,57850567,8,63897157
2023-03-04,1782,1842,1754,1810,205014424,1588,179566970,967,11,131876482,73137942,47690488,-47690488,11,25447454
2023-03-05,1830,1890,1801,1805,181294929,1733,168141547,880,8,162253636,19041293,5887911,-5887911,11,13153382
2023-03-06,1807,1840,1780,1787,180893046,1494,146972618,806,8,139440488,41452558,7532130,-7532130,12,33920428
2023-03-07,1829,1838,1756,1785,267554408,2591,214033111,986,11,165920713,101633695,48112398,-48112398,15,53521297
2023-03-11,1810,1847,1774,1780,176144032,1658,149104325,981,7,148515212,27628820,589113,-589113,10,27039707
2023-03-12,1777,1816,1735,1756,170277316,1321,144711725,1094,8,145903931,24373385,-1192206,1192206,9,25565591
2023-03-13,1782,1813,1747,1759,132203814,871,96251572,1136,5,124728965,7474849,-28477393,28477393,10,35952242
2023-03-14,1774,1791,1734,1744,156536116,1535,131568391,1936,8,103607463,52928653,27960928,-27960928,12,24967725
2023-03-15,1757,1809,1757,1793,183462496,2125,133644213,892,6,167449576,16012920,-33805363,33805363,14,49818283
2023-03-18,1829,1915,1821,1915,302078211,1832,207412640,1628,25,211759875,90318336,-4347235,4347235,19,94665571
2023-03-19,1980,1980,1876,1913,208085548,2008,201086444,1537,6,200378416,7707132,708028,-708028,5,6999104
2023-03-25,1923,1998,1867,1912,301819904,2669,275719224,1753,9,274438589,27381315,1280635,-1280635,14,26100680
2023-03-26,1929,1952,1850,1857,228121054,2370,212603022,1311,8,211560268,16560786,1042754,-1042754,10,15518032
2023-03-27,1867,1958,1857,1950,200506919,1972,158123996,1499,10,175355900,25151019,-17231904,17231904,7,42382923
2023-03-28,1971,2013,1928,1971,212806727,1915,158988233,1408,15,162644003,50162724,-3655770,3655770,17,53818494
2023-03-29,2006,2104,1971,2104,467768496,2838,386642178,2618,18,372386148,95382348,14256030,-14256030,15,81126318
2023-04-03,2145,2208,2027,2208,352790458,1928,284619859,2166,13,241507992,111282466,43111867,-43111867,15,68170599
2023-04-04,2328,2328,2112,2165,283414326,3057,224180615,2173,11,253577971,29836355,-29397356,29397356,11,59233711
2023-04-05,2171,2254,2112,2244,283543547,2375,235213756,1826,13,168440219,115103328,66773537,-66773537,12,48329791
2023-04-08,2169,2316,2159,2195,310211382,3359,275246001,2466,16,289878638,20332744,-14632637,14632637,10,34965381
2023-04-09,2199,2366,2199,2329,348125578,3644,323700235,2474,21,280602565,67523013,43097670,-43097670,13,24425343
2023-04-10,2366,2404,2159,2180,358450290,4413,312869191,2491,14,329632799,28817491,-16763608,16763608,15,45581099
2023-04-11,2168,2319,2168,2262,333489375,3230,284644427,2317,18,260655400,72833975,23989027,-23989027,16,48844948
2023-04-15,2356,2407,2313,2407,484027860,3149,382514594,2949,21,329317590,154710270,53197004,-53197004,15,101513266
2023-04-16,2461,2507,2357,2414,267080464,3259,244668042,2328,15,210678506,56401958,33989536,-33989536,9,22412422
2023-04-17,2441,2498,2352,2454,224502077,3012,212233586,2213,11,205058750,19443327,7174836,-7174836,4,12268491
2023-04-18,2492,2607,2454,2503,333050195,3180,277642440,2422,23,272163716,60886479,5478724,-5478724,17,55407755
2023-04-19,2546,2630,2470,2507,263220639,2710,190190807,2026,12,232689685,30530954,-42498878,42498878,16,73029832
2023-04-24,2574,2574,2437,2489,283793982,3178,252525646,2027,9,230847583,52946399,21678063,-21678063,10,31268336
2023-04-25,2517,2591,2444,2451,274272039,2432,229001994,2142,13,236171923,38100116,-7169929,7169929,10,45270045
2023-04-26,2442,2544,2404,2424,291504656,2819,216402570,2162,10,273472680,18031976,-57070110,57070110,14,75102086
2023-04-29,2467,2523,2405,2451,283280690,2654,191312884,2283,11,231214674,52066016,-39901790,39901790,17,91967806
2023-04-30,2498,2620,2472,2602,437908768,4166,374583121,2596,15,299303708,138605060,75279413,-75279413,21,63325647
2023-05-01,2633,2665,2536,2574,423728766,3878,271195577,2034,22,205099546,218629220,66096031,-66096031,17,152533189
2023-05-02,2550,2692,2550,2678,309603686,3079,271503392,2325,11,248594328,61009358,22909064,-22909064,9,38100294
2023-05-03,2726,2804,2606,2772,581770055,4557,468290037,3354,23,458439304,123330751,9850733,-9850733,14,113480018
2023-05-06,2876,2919,2847,2919,438920845,2625,358750089,1791,14,140511368,298409477,218238721,-218238721,20,80170756
2023-05-07,3016,3016,2713,2713,394106694,3738,245483992,2805,9,378540367,15566327,-133056375,133056375,18,148622702
2023-05-08,2569,2593,2569,2569,230609949,1311,72399949,2047,4,206326091,24283858,-133926142,133926142,11,158210000
2023-05-09,2555,2602,2418,2488,345752213,2488,237959899,2502,12,266837823,78914390,-28877924,28877924,11,107792314
2023-05-10,2544,2555,2333,2357,478139129,2252,182194463,2795,8,462506512,15632617,-280312049,280312049,16,295944666
2023-05-13,2244,2329,2205,2211,300511552,1860,156124536,2661,7,287185703,13325849,-131061167,131061167,19,144387016
2023-05-14,2211,2362,2188,2355,172009637,1764,158666417,1443,14,134749429,37260208,23916988,-23916988,9,13343220
2023-05-15,2442,2442,2251,2332,152221988,1325,114410192,1360,7,137963941,14258047,-23553749,23553749,13,37811796
2023-05-17,2329,2485,2305,2450,173227813,1239,166811413,1401,12,129237240,43990573,37574173,-37574173,10,6416400
2023-05-20,2451,2480,2310,2356,151076955,1774,110965060,1407,4,147609370,3467585,-36644310,36644310,9,40111895
2023-05-21,2348,2428,2311,2366,96423022,1030,88059956,919,11,71092845,25330177,16967111,-16967111,9,8363066
2023-05-22,2376,2442,2340,2407,201006434,1654,161230976,1216,12,142697913,58308521,18533063,-18533063,13,39775458
2023-05-23,2404,2536,2366,2366,167494513,1579,141122259,1155,15,110597200,56897313,30525059,-30525059,15,26372254
2023-05-24,2414,2447,2348,2354,116578026,1258,85129879,1057,9,100383693,16194333,-15253814,15253814,11,31448147
2023-05-27,2366,2422,2291,2294,112639500,1084,75295361,1279,9,92623115,20016385,-17327754,17327754,7,37344139
2023-05-28,2242,2328,2174,2183,218122216,2203,140392268,1089,4,214509295,3612921,-74117027,74117027,20,77729948
2023-05-29,2183,2247,2172,2191,123440032,1112,99750664,798,8,104826989,18613043,-5076325,5076325,9,23689368
2023-05-30,2192,2252,2192,2212,124645029,922,99121086,850,9,90063246,34581783,9057840,-9057840,11,25523943
2023-05-31,2202,2274,2183,2236,105769549,955,89921103,950,9,88333453,17436096,1587650,-1587650,7,15848446
2023-06-03,2216,2294,2216,2293,72083361,612,65920562,901,9,61281700,10801661,4638862,-4638862,7,6162799
2023-06-06,2300,2416,2263,2416,389292636,1190,344862711,1653,14,142288129,247004507,202574582,-202574582,16,44429925
2023-06-07,2451,2460,2353,2358,236027577,1601,150247127,1358,6,225447808,10579769,-75200681,75200681,5,85780450
2023-06-10,2282,2308,2235,2235,217611391,1166,88574022,1127,6,210082681,7528710,-121508659,121508659,11,129037369
2023-06-11,2191,2288,2191,2222,52794453,671,43013393,1377,5,49476298,3318155,-6462905,6462905,10,9781060
2023-06-12,2332,2373,2178,2262,190949408,1604,174391750,1603,13,150975487,39973921,23416263,-23416263,9,16557658
2023-06-13,2295,2355,2243,2257,120908962,1038,103843143,798,11,91944644,28964318,11898499,-11898499,12,17065819
2023-06-14,2263,2385,2263,2282,108240552,787,86255494,909,11,92211033,16029519,-5955539,5955539,6,21985058
2023-06-17,2291,2342,2245,2250,82372826,744,55484969,841,7,78536977,3835849,-23052008,23052008,8,26887857
2023-06-18,2263,2291,2178,2220,71039235,750,47021075,743,7,64082839,6956396,-17061764,17061764,7,24018160
2023-06-19,2187,2252,2121,2121,109830945,1012,82029460,820,4,105514522,4316423,-23485062,23485062,6,27801485
2023-06-20,2159,2223,2099,2198,78479276,629,40295589,762,9,66552782,11926494,-26257193,26257193,7,38183687
2023-06-21,2187,2232,2150,2183,75474456,596,49642036,647,8,64508659,10965797,-14866623,14866623,8,25832420
2023-06-24,2178,2197,2102,2121,52271700,856,42442587,611,6,49717707,2553993,-7275120,7275120,7,9829113
2023-06-25,2140,2164,2092,2101,69813550,658,29301299,365,2,30997478,544284,-1696179,1696179,2,2240463
2023-06-26,2112,2224,2085,2117,110239036,786,60455788,833,6,67511662,42727374,-7055874,7055874,9,49783248
2023-06-27,2178,2178,2078,2078,25602169,703,23472717,310,1,24802562,799607,-1329845,1329845,5,2129452
2023-06-28,2113,2147,2079,2095,48681423,601,31617357,409,4,39429374,9252049,-7812017,7812017,8,17064066
2023-07-01,2079,2119,2047,2049,76922696,813,53457159,611,4,64998964,11923732,-11541805,11541805,7,23465537
2023-07-02,2044,2150,2044,2111,70584741,737,63711086,619,7,55184246,15400495,8526840,-8526840,10,6873655
2023-07-03,2131,2187,2084,2159,88035728,803,79651362,733,5,72933281,15102447,6718081,-6718081,13,8384366
2023-07-04,2159,2205,2135,2154,61775803,621,50878404,615,3,51335003,10440800,-456599,456599,13,10897399
2023-07-05,2150,2187,2124,2125,49096549,605,39676272,479,3,40500569,8595980,-824297,824297,8,9420277
2023-07-08,2161,2196,2119,2131,55446498,602,50296785,609,3,47146498,8300000,3150287,-3150287,7,5149713
2023-07-09,2140,2158,2078,2102,70021505,684,44988780,539,4,62348525,7672980,-17359745,17359745,13,25032725
2023-07-10,2121,2131,2038,2043,61735614,600,33438550,481,6,44923470,16812144,-11484920,11484920,7,28297064
2023-07-11,2093,2149,2003,2007,168994873,1232,136665613,1022,13,120317938,48676935,16347675,-16347675,11,32329260
2023-07-18,2034,2060,1923,2036,185316942,1615,150113676,903,9,170321640,14995302,-20207964,20207964,11,35203266
2023-07-19,2045,2139,1958,1983,140141631,1063,119459043,1107,8,113133614,27008017,6325429,-6325429,10,20682588
2023-07-22,1911,1982,1911,1911,135811298,1192,62960154,641,6,126478616,9332682,-63518462,63518462,17,72851144
2023-07-23,1872,1919,1872,1887,1082081,14,1013081,15,1,750800,331281,262281,-262281,1,69000
2023-07-25,2044,2044,1787,1872,56536089,571,49285256,475,5,46360993,10175096,2924263,-2924263,6,7250833
2023-07-26,1920,1968,1873,1940,73693513,532,71392913,567,6,49521787,24171726,21871126,-21871126,4,2300600
2023-07-29,1940,1987,1895,1895,46817526,423,33741690,427,6,39289757,7527769,-5548067,5548067,6,13075836
2023-07-31,1911,1945,1843,1901,87190252,619,61150753,470,4,82265691,4924561,-21114938,21114938,9,26039499
2023-08-01,1920,1954,1857,1879,50540560,395,35371900,460,4,41262885,9277675,-5890985,5890985,5,15168660
2023-08-05,2031,2031,1968,2007,110900766,588,105937638,689,13,68100683,42800083,37836955,-37836955,7,4963128
2023-08-06,2045,2045,1971,2000,65097573,445,38335627,542,9,57203749,7893824,-18868122,18868122,9,26761946
2023-08-07,1986,2109,1986,2016,94187192,571,81620910,786,12,73590129,20597063,8030781,-8030781,7,12566282
2023-08-08,2026,2051,1956,1963,63764580,512,35833817,423,5,58507668,5256912,-22673851,22673851,5,27930763
2023-08-09,1951,2010,1891,1909,78429460,589,47707582,344,8,29657897,48771563,18049685,-18049685,7,30721878
2023-08-12,1911,1919,1803,1820,96798381,594,39145684,576,5,92690962,4107419,-53545278,53545278,14,57652697
2023-08-13,1820,1837,1760,1800,56848025,612,47642098,369,4,52068732,4779293,-4426634,4426634,8,9205927
2023-08-14,1837,1872,1779,1783,37901267,370,32079359,361,5,34377783,3523484,-2298424,2298424,4,5821908
2023-08-15,1778,1814,1738,1781,48059623,357,24050552,416,2,46638011,1421612,-22587459,22587459,6,24009071
2023-08-16,1814,1819,1732,1767,28396084,344,23066307,374,2,27006256,1389828,-3939949,3939949,5,5329777
2023-08-19,1767,1792,1690,1694,57269155,599,32366851,356,6,56899915,369240,-24533064,24533064,9,24902304
2023-08-20,1725,1776,1700,1733,54327151,468,29997614,409,4,50420352,3906799,-20422738,20422738,7,24329537
2023-08-22,1724,1725,1641,1652,67742956,462,27059535,302,6,45244667,22498289,-18185132,18185132,11,40683421
2023-08-23,1660,1757,1656,1744,69053996,549,48360769,440,7,56372156,12681840,-8011387,8011387,12,20693227
2023-08-26,1756,1818,1720,1818,113688262,638,109003050,562,11,62943347,50744915,46059703,-46059703,4,4685212
2023-08-27,1890,1912,1834,1852,98584734,796,88630833,542,9,76265083,22319651,12365750,-12365750,9,9953901
2023-08-28,1959,1967,1877,1883,94448252,666,90451844,561,10,68918572,25529680,21533272,-21533272,5,3996408
2023-08-29,1935,1977,1892,1901,108536010,618,62286487,598,9,87909021,20626989,-25622534,25622534,8,46249523
2023-08-30,1920,1943,1867,1908,79225138,724,59133557,577,5,54362221,24862917,4771336,-4771336,11,20091581
2023-08-30,1894,1920,1875,1877,27819,724,59133557,577,5,54362221,24862917,4771336,-4771336,11,20091581
2023-09-02,1873,1927,1845,1853,35113089,551,31536796,371,3,33299911,1813178,-1763115,1763115,8,3576293
2023-09-03,1884,1909,1849,1878,57174269,324,31146036,421,5,49106399,8067870,-17960363,17960363,8,26028233
2023-09-04,1904,1922,1863,1913,95420543,612,65110626,412,8,50139082,45281461,14971544,-14971544,7,30309917
2023-09-05,1919,1994,1904,1906,89225332,644,68623314,590,8,64553091,24672241,4070223,-4070223,13,20602018
2023-09-09,1916,1926,1845,1872,59972649,361,32324006,515,6,48514302,11458347,-16190296,16190296,5,27648643
2023-09-10,1846,1920,1831,1859,29627839,294,19473148,353,6,27218465,2409374,-7745317,7745317,10,10154691
2023-09-11,1857,2010,1857,2010,378644907,1369,367567012,1302,16,203114868,175530039,164452144,-164452144,9,11077895
2023-09-12,2045,2054,1989,1991,165762438,971,134873951,797,7,146868105,18894333,-11994154,11994154,8,30888487
2023-09-13,2016,2036,1974,2007,117194594,598,52597506,644,5,114602662,2591932,-62005156,62005156,6,64597088
2023-09-17,1983,2031,1970,1985,92432494,415,39717909,522,6,48375169,44057325,-8657260,8657260,8,52714585
2023-09-18,1978,2013,1944,1946,57110027,445,30864455,446,5,55219569,1890458,-24355114,24355114,5,26245572
2023-09-19,1976,1976,1919,1921,47652622,458,32417197,316,5,39541867,9179755,-7124670,7124670,4,16304425
2023-09-20,1938,1964,1906,1915,61278822,348,39776196,326,7,47658779,13620043,-7882583,7882583,7,21502626
2023-09-23,1933,1940,1909,1930,35507582,295,25764056,304,5,29610396,5897186,-3846340,3846340,7,9743526
2023-09-25,1936,1948,1893,1895,27568162,249,17551167,204,5,25357683,2210479,-7806516,7806516,4,10016995
2023-09-26,1909,1909,1853,1862,47763271,627,39933037,345,3,43318399,4444872,-3385362,3385362,6,7830234
2023-09-27,1854,1880,1814,1814,159392402,1364,96703860,548,7,149384702,10007700,-52680842,52680842,9,62688542
2023-09-30,1839,1839,1762,1773,109651622,919,63822378,525,7,98841296,10810326,-35018918,35018918,11,45829244
2023-10-01,1777,1777,1738,1759,52121043,473,43001219,378,4,49062415,3058628,-6061196,6061196,5,9119824
2023-10-02,1765,1805,1756,1781,51653469,426,45384969,229,4,48319677,3333792,-2934708,2934708,5,6268500
2023-10-04,1815,1823,1767,1783,41058849,441,38765841,291,5,31211432,9847417,7554409,-7554409,6,2293008
2023-10-07,1785,1785,1709,1709,43945964,516,34669535,358,2,43656338,289626,-8986803,8986803,4,9276429
2023-10-08,1727,1727,1633,1633,118596696,1224,74028751,546,11,96852639,21744057,-22823888,22823888,10,44567945
2023-10-09,1633,1681,1599,1631,57883837,510,29799781,377,4,49138343,8745494,-19338562,19338562,8,28084056
2023-10-10,1612,1680,1612,1678,42141567,298,29867996,320,6,36618348,5523219,-6750352,6750352,3,12273571
2023-10-11,1689,1689,1641,1654,19887892,272,17253422,223,2,18386759,1501133,-1133337,1133337,3,2634470
2023-10-14,1632,1649,1589,1606,45864352,377,16453151,299,9,39552057,6312295,-23098906,23098906,8,29411201
2023-10-15,1587,1652,1587,1624,26786678,244,20730494,306,3,20983678,5803000,-253184,253184,2,6056184
2023-10-16,1608,1688,1608,1652,32294329,332,32294329,351,1,29338534,2955795,2955795,-2955795,0,0
2023-10-17,1678,1689,1626,1626,36115198,396,27094201,263,4,24837356,11277842,2256845,-2256845,5,9020997
2023-10-18,1615,1632,1556,1590,44745239,480,26658625,275,2,41690985,3054254,-15032360,15032360,6,18086614
2023-10-21,1589,1656,1589,1611,23101857,301,19564898,297,3,22350566,751291,-2785668,2785668,3,3536959
2023-10-22,1647,1647,1598,1605,28390838,405,25652072,208,7,25018348,3372490,633724,-633724,5,2738766
2023-10-23,1642,1647,1601,1616,33374363,398,31097966,347,7,28957228,4417135,2140738,-2140738,3,2276397
2023-10-24,1605,1629,1554,1575,39737595,531,34764999,278,6,24054842,15682753,10710157,-10710157,5,4972596
2023-10-25,1604,1621,1585,1594,27982524,316,27249978,234,7,23586939,4395585,3663039,-3663039,1,732546
2023-10-28,1536,1559,1483,1485,135419021,982,68712303,493,6,120247093,15171928,-51534790,51534790,11,66706718
2023-10-29,1483,1527,1480,1509,55194661,408,44617015,317,8,38074969,17119692,6542046,-6542046,3,10577646
2023-10-30,1557,1575,1517,1555,64449783,402,58113545,367,9,31112352,33337431,27001193,-27001193,5,6336238
2023-10-31,1575,1582,1529,1535,52499487,355,40466553,318,6,35265153,17234334,5201400,-5201400,6,12032934
2023-11-01,1545,1566,1471,1536,51397071,304,24639687,359,3,40970723,10426348,-16331036,16331036,10,26757384
2023-11-04,1616,1616,1559,1606,67424466,329,57067405,436,5,53273223,14151243,3794182,-3794182,5,10357061
2023-11-05,1653,1656,1602,1620,65716604,307,60806552,402,6,51238542,14478062,9568010,-9568010,4,4910052
2023-11-06,1638,1666,1604,1629,61164655,413,58309276,308,7,41928947,19235708,16380329,-16380329,4,2855379
2023-11-07,1685,1727,1633,1702,76179683,413,72549276,567,6,72002939,4176744,546337,-546337,3,3630407
2023-11-08,1720,1722,1661,1666,34598032,333,29909959,262,3,33839832,758200,-3929873,3929873,4,4688073
2023-11-11,1681,1704,1642,1659,51729077,449,41832967,315,1,51725431,3646,-9892464,9892464,3,9896110
2023-11-13,1767,1767,1715,1724,104702980,413,100752541,614,9,92070835,12632145,8681706,-8681706,4,3950439
2023-11-14,1732,1738,1695,1717,59526660,282,55077529,385,8,44015337,15511323,11062192,-11062192,2,4449131
2023-11-15,1725,1737,1702,1702,44375532,283,39106060,293,4,42832753,1542779,-3726693,3726693,3,5269472
2023-11-18,1692,1728,1675,1695,28092860,259,22829051,264,6,26857241,1235619,-4028190,4028190,7,5263809
2023-11-19,1728,1752,1691,1700,55472092,334,39888708,322,6,52145976,3326116,-12257268,12257268,5,15583384
2023-11-20,1716,1716,1676,1684,39010640,288,18174301,282,4,37644654,1365986,-19470353,19470353,9,20836339
2023-11-21,1698,1718,1678,1702,17727290,137,7394920,196,3,17186512,540778,-9791592,9791592,6,10332370
2023-11-22,1713,1726,1690,1716,39941925,208,17162063,259,5,35233224,4708701,-18071161,18071161,5,22779862
2023-11-25,1748,1748,1685,1686,32864599,277,17802454,262,3,30573470,2291129,-12771016,12771016,6,15062145
2023-11-26,1738,1738,1708,1720,52015609,262,41687427,286,3,49009448,3006161,-7322021,7322021,5,10328182
2023-11-27,1716,1746,1692,1725,67377609,254,57149245,370,9,52429269,14948340,4719976,-4719976,4,10228364
2023-11-28,1726,1764,1726,1760,59892506,293,58792506,467,8,54574841,5317665,4217665,-4217665,1,1100000
2023-11-29,1796,1844,1776,1823,87767776,397,62580176,592,11,56055165,31712611,6525011,-6525011,9,25187600
2023-12-02,1856,1905,1829,1844,97749071,499,54159157,652,12,78932817,18816254,-24773660,24773660,15,43589914
2023-12-03,1872,1994,1850,1993,206783792,829,157981399,1315,18,163098852,43684940,-5117453,5117453,20,48802393
2023-12-04,2016,2016,1935,1959,143643301,534,107653795,794,8,131542277,12101024,-23888482,23888482,9,35989506
2023-12-05,1988,2108,1944,2034,269344714,1329,152113653,1470,22,193533335,75811379,-41419682,41419682,15,117231061
2023-12-06,2067,2081,2002,2025,76380178,492,46787737,619,7,72413801,3966377,-25626064,25626064,5,29592441
2023-12-09,2088,2141,2038,2049,135185193,775,123423076,1020,15,125845295,9339898,-2422219,2422219,6,11762117
2023-12-10,2055,2091,2026,2050,87942472,434,49606573,551,3,76450435,11492037,-26843862,26843862,8,38335899
2023-12-11,2079,2079,2031,2033,51809882,309,33747913,471,3,50913155,896727,-17165242,17165242,4,18061969
2023-12-12,2045,2062,2021,2026,62637804,254,30326384,416,8,56750800,5887004,-26424416,26424416,3,32311420
2023-12-13,2041,2041,1985,1989,58020182,327,25900799,434,3,57941479,78703,-32040680,32040680,7,32119383
2023-12-16,2005,2009,1970,1976,64493579,423,43399903,439,6,51462319,13031260,-8062416,8062416,5,21093676
2023-12-18,2012,2036,1978,1997,115286865,445,72497650,465,12,83210262,32076603,-10712612,10712612,7,42789215
2023-12-19,2013,2016,1959,1976,37109673,276,30951956,251,4,29582473,7527200,1369483,-1369483,5,6157717
2023-12-20,1993,1993,1866,1892,563203450,1713,221366435,991,29,288771687,274431763,-67405252,67405252,21,341837015
2023-12-23,1872,1940,1808,1887,185135523,1229,100607588,938,9,163302411,21833112,-62694823,62694823,18,84527935
2023-12-24,1888,1988,1888,1920,150935536,779,92818126,791,15,93390590,57544946,-572464,572464,16,58117410
2024-01-06,1911,1976,1894,1949,85972232,475,65044037,587,10,78120591,7851641,-13076554,13076554,9,20928195
2024-01-07,1949,1949,1895,1901,65210853,539,40611736,519,5,61718405,3492448,-21106669,21106669,9,24599117
2024-01-08,1920,1926,1867,1868,69929120,448,31729294,439,10,48329598,21599522,-16600304,16600304,10,38199826
2024-01-09,1911,1911,1862,1866,54680481,351,31951004,363,8,39212043,15468438,-7261039,7261039,9,22729477
2024-01-10,1896,1919,1865,1871,62929572,499,48839559,374,7,32532670,30396902,16306889,-16306889,9,14090013
2024-01-13,1872,1930,1847,1873,96380640,455,50636324,538,9,59897755,36568885,-9261431,9261431,10,45830316
2024-01-14,1863,1935,1863,1889,82052283,434,45395734,447,8,73067640,8434643,-27671906,27671906,8,36106549
2024-01-15,1864,1904,1864,1871,44138695,255,20516013,380,5,39406674,4732021,-18890661,18890661,7,23622682
2024-01-16,1853,1901,1844,1861,40774058,253,18489349,372,4,37476267,3297791,-18986918,18986918,9,22284709
2024-01-17,1898,1920,1850,1916,94951409,491,78471576,566,9,66200503,28750906,12271073,-12271073,17,16479833
2024-01-20,1895,1969,1840,1845,65265243,397,42289849,479,6,41535063,23730180,754786,-754786,9,22975394
2024-01-21,1842,1882,1827,1842,96365003,381,55321368,315,2,47916409,48448594,7404959,-7404959,12,41043635
2024-01-22,1910,1914,1781,1824,89222937,397,32265339,379,7,37098283,51574654,-4832944,4832944,10,56407598
2024-01-23,1835,1855,1770,1798,48381255,309,21694271,362,6,31800803,16580452,-10106532,10106532,10,26686984
2024-01-24,1824,1847,1795,1804,30583827,270,20248150,241,3,24589586,5994241,-4341436,4341436,8,10335677
2024-01-27,1853,1853,1790,1808,27291834,294,14839877,283,6,25235317,2056517,-10395440,10395440,8,12451957
2024-01-28,1832,1835,1796,1833,56984357,341,25653395,306,6,34518369,22465988,-8864974,8864974,11,31330962
2024-01-29,1808,1820,1777,1815,39175238,337,19660732,305,7,29826905,9348333,-10166173,10166173,11,19514506
2024-01-30,1781,1803,1728,1728,60856070,477,26526969,366,5,53104429,7751641,-26577460,26577460,10,34329101
2024-01-31,1762,1800,1711,1753,102162996,532,52658251,365,6,54891779,47271217,-2233528,2233528,8,49504745
2024-02-03,1767,1825,1750,1792,51502600,280,26400106,406,9,46882576,4620024,-20482470,20482470,8,25102494
2024-02-04,1863,1863,1785,1797,30954547,175,21176427,292,8,27145677,3808870,-5969250,5969250,7,9778120
2024-02-05,1822,1822,1770,1781,50601482,301,43636301,278,8,36649565,13951917,6986736,-6986736,7,6965181
2024-02-06,1799,1800,1754,1755,36782898,358,25878696,198,6,23935305,12847593,1943391,-1943391,6,10904202
2024-02-07,1778,1805,1757,1782,36486478,269,25495401,296,8,29977655,6508823,-4482254,4482254,4,10991077
2024-02-10,1768,1815,1764,1773,20824364,199,16005604,221,4,16873387,3950977,-867783,867783,2,4818760
2024-02-12,1758,1790,1753,1763,34837100,211,17373105,254,6,25973225,8863875,-8600120,8600120,4,17463995
2024-02-13,1757,1771,1736,1742,33946268,223,22715429,203,6,31665914,2280354,-8950485,8950485,3,11230839
2024-02-14,1759,1759,1724,1726,32020080,291,11122011,253,7,20607108,11412972,-9485097,9485097,5,20898069
2024-02-17,1726,1744,1686,1689,40858861,425,32186519,251,5,36741906,4116955,-4555387,4555387,6,8672342
2024-02-18,1708,1744,1706,1720,18337923,235,15350555,190,3,16310056,2027867,-959501,959501,5,2987368
2024-02-19,1746,1756,1712,1715,31288494,312,29449295,191,5,25458242,5830252,3991053,-3991053,2,1839199
2024-02-20,1748,1748,1712,1712,29400733,277,21115050,178,6,17924125,15049471,3190925,-3190925,1,11858546
2024-02-21,1710,1743,1708,1719,28521576,250,20774415,182,5,18566029,9955547,2208386,-2208386,3,7747161
2024-02-24,1709,1728,1661,1690,27118654,244,20569591,209,8,18161166,8957488,2408425,-2408425,3,6549063
2024-02-26,1714,1714,1643,1644,44517820,419,27059235,287,6,26843867,17673953,215368,-215368,4,17458585
2024-02-27,1652,1719,1650,1671,34632777,263,24114204,233,7,21660784,12971993,2453420,-2453420,4,10518573
2024-02-28,1690,1731,1683,1690,31834993,173,27224993,204,5,20254476,11580517,6970517,-6970517,4,4610000
2024-03-02,1769,1811,1769,1811,102530819,509,85625524,457,8,57940345,44590474,27685179,-27685179,9,16905295
2024-03-03,1864,1932,1864,1896,163754569,903,125312848,808,12,123007588,40746981,2305260,-2305260,10,38441721
2024-03-04,1918,1957,1854,1863,66116686,564,47582984,620,3,61141011,4975675,-13558027,13558027,6,18533702
2024-03-05,1868,1955,1865,1883,63461507,384,41012963,454,5,51857619,11603888,-10844656,10844656,9,22448544
2024-03-06,1901,1930,1880,1890,34248490,219,15192708,317,4,29246777,5001713,-14054069,14054069,4,19055782
2024-03-11,1904,2018,1886,1934,96770209,454,71534921,671,11,79598295,17171914,-8063374,8063374,8,25235288
2024-03-12,1957,1973,1861,1877,80793860,545,53460065,471,9,49413819,31380041,4046246,-4046246,6,27333795
2024-03-13,1863,1900,1813,1815,64427173,469,41944864,418,3,46106580,18320593,-4161716,4161716,9,22482309
2024-03-16,1815,1847,1769,1769,49030011,431,41875584,499,3,35844083,13185928,6031501,-6031501,8,7154427
2024-03-17,1820,1871,1804,1823,24206633,334,19579079,222,3,18284734,5921899,1294345,-1294345,8,4627554
2024-03-18,1852,1881,1824,1860,36803709,253,28829124,278,5,29181122,7622587,-351998,351998,3,7974585
2024-03-24,1892,1945,1877,1944,46944563,324,38238229,369,2,41585260,5359303,-3347031,3347031,6,8706334
2024-03-25,1949,2016,1900,1919,93273654,481,71339988,448,12,61957476,31316178,9382512,-9382512,3,21933666
2024-03-26,1919,1952,1892,1907,48336577,393,36884479,259,5,21502781,26833796,15381698,-15381698,11,11452098
2024-03-27,1917,1930,1887,1900,48129057,327,33490667,262,5,22659288,25469769,10831379,-10831379,7,14638390
2024-03-30,1930,1930,1866,1903,44131837,359,39324379,247,3,23425802,20706035,15898577,-15898577,5,4807458
2024-04-02,1882,1882,1801,1844,36616393,335,34651050,291,0,36616393,0,-1965343,1965343,4,1965343
2024-04-03,1901,1901,1814,1845,39067459,296,27170750,305,2,31505857,7561602,-4335107,4335107,2,11896709
2024-04-06,1853,1853,1757,1771,60681140,426,33985999,453,1,57681140,3000000,-23695141,23695141,1,26695141
2024-04-07,1794,1821,1750,1761,83167336,499,42730689,270,6,24983258,58184078,17747431,-17747431,8,40436647
2024-04-08,1796,1817,1756,1761,35937778,352,30186501,199,6,13173710,22764068,17012791,-17012791,3,5751277
2024-04-09,1794,1794,1754,1774,73945273,342,31003478,234,7,33011321,40933952,-2007843,2007843,5,42941795
2024-04-13,1728,1763,1644,1644,186848651,765,67636064,390,7,85054070,101794581,-17418006,17418006,14,119212587
2024-04-14,1642,1642,1642,1642,11427480,124,10827480,3,1,200914,11226566,10626566,-10626566,1,600000
2024-04-15,1647,1671,1647,1671,76571046,333,71571046,174,7,19768926,56802120,51802120,-51802120,1,5000000
2024-04-16,1654,1671,1654,1654,53148206,332,27098881,153,4,26242880,26905326,856001,-856001,6,26049325
2024-04-17,1666,1671,1642,1654,16490787,230,15240787,178,1,15627980,862807,-387193,387193,2,1250000
2024-04-20,1728,1772,1683,1772,81282364,392,78382364,372,6,63106605,18175759,15275759,-15275759,3,2900000
2024-04-21,1853,1853,1766,1821,474170426,1460,442717622,619,11,194148249,280025431,248569373,-248569373,10,31456058
2024-04-22,1824,1838,1776,1776,102084494,762,89700974,437,3,99124247,2960247,-9423273,9423273,6,12383520
2024-04-23,1815,1833,1761,1810,80174196,562,68983825,452,5,67990899,12183297,992926,-992926,7,11190371
2024-04-24,1824,1844,1785,1793,54655621,435,42860466,304,5,39966309,14689312,2894157,-2894157,3,11795155
2024-04-27,1823,1836,1766,1766,106415860,541,91049180,386,5,52581431,53834429,38467749,-38467749,6,15366680
2024-04-28,1767,1786,1702,1710,80257858,771,69364858,257,5,66479962,13777896,2884896,-2884896,6,10893000
2024-04-29,1714,1796,1709,1709,52380676,430,49482104,280,8,35022543,17358133,14459561,-14459561,2,2898572
2024-04-30,1733,1738,1684,1712,39200073,360,30662788,218,3,34175046,5025027,-3512258,3512258,1,8537285
2024-05-01,1733,1746,1709,1709,21421291,203,19734174,204,3,17321291,4100000,2412883,-2412883,2,1687117
2024-05-05,1719,1748,1690,1690,28994172,352,25594172,249,4,28220402,773770,-2626230,2626230,2,3400000
2024-05-06,1680,1742,1679,1686,48269855,352,23944224,297,2,29937676,18332179,-5993452,5993452,4,24325631
2024-05-07,1700,1719,1670,1680,31479671,312,16740049,208,2,21113987,10365684,-4373938,4373938,3,14739622
2024-05-08,1680,1692,1635,1639,37113978,457,35570381,168,4,21036016,16077962,14534365,-14534365,3,1543597
2024-05-11,1671,1719,1632,1637,26554996,394,22554996,248,4,24655416,1899580,-2100420,2100420,1,4000000
2024-05-12,1632,1677,1606,1611,43692485,467,30789657,232,7,34950332,8742153,-4160675,4160675,3,12902828
2024-05-13,1604,1639,1556,1580,44135310,427,29010675,282,2,41690866,2444444,-12680191,12680191,1,15124635
2024-05-14,1622,1630,1567,1573,25744763,328,23099784,201,3,19230897,6513866,3868887,-3868887,4,2644979
2024-05-15,1593,1622,1550,1575,45755709,424,36763257,258,1,38670907,7084802,-1907650,1907650,3,8992452
2024-05-18,1580,1627,1556,1564,31675135,289,30850431,210,1,19358716,12316419,11491715,-11491715,2,824704
2024-05-19,1547,1549,1475,1504,74253516,685,72438302,229,7,54123328,20130188,18314974,-18314974,5,1815214
2024-05-21,1475,1527,1474,1527,49006572,182,38856572,243,6,32498952,16507620,6357620,-6357620,3,10150000
2024-05-25,1536,1549,1491,1491,45691295,447,45674495,221,3,37102103,8589192,8572392,-8572392,2,16800
2024-05-26,1517,1517,1473,1473,21222615,246,18419303,94,2,13486402,7736213,4932901,-4932901,2,2803312
2024-05-27,1463,1488,1461,1461,53973575,355,40209618,113,4,47966173,6007402,-7756555,7756555,7,13763957
2024-05-28,1450,1490,1450,1490,84342652,336,74081100,218,6,67266192,17076460,6814908,-6814908,6,10261552
2024-05-29,1509,1512,1494,1512,52824041,183,39712831,136,1,39804864,13019177,-92033,92033,5,13111210
2024-06-01,1541,1541,1489,1501,60792787,342,49884880,297,4,47934933,12857854,1949947,-1949947,9,10907907
2024-06-02,1501,1539,1487,1536,40197073,240,36959331,260,5,31760183,8436890,5199148,-5199148,6,3237742
2024-06-05,1500,1539,1480,1480,22429896,250,22405630,133,4,14354178,8075718,8051452,-8051452,1,24266
2024-06-08,1479,1479,1479,1479,9462072,112,4182867,23,0,9462072,0,-5279205,5279205,2,5279205
2024-06-09,1474,1517,1474,1506,84107568,401,45547847,311,1,84107568,0,-38559721,38559721,6,38559721
2024-06-10,1488,1510,1480,1491,34277851,228,31057052,230,3,31910338,2367513,-853286,853286,3,3220799
2024-06-11,1525,1525,1480,1489,16240528,55,6840528,89,1,15840528,400000,-9000000,9000000,3,9400000
2024-06-12,1489,1531,1478,1487,25871072,178,17034462,206,5,20638199,5232873,-3603737,3603737,4,8836610
2024-06-15,1471,1506,1467,1467,37724336,153,7327691,116,1,37354336,370000,-30026645,30026645,3,30396645
2024-06-16,1448,1479,1448,1448,29117353,239,19036876,179,2,25900656,3216697,-6863780,6863780,5,10080477
2024-06-18,1476,1487,1434,1434,48616191,265,24946946,185,6,31044441,17571750,-6097495,6097495,3,23669245
2024-06-19,1434,1472,1434,1472,31436984,104,19762829,194,3,20519222,10474502,-756393,756393,5,11230895
2024-06-22,1483,1483,1470,1483,163887473,308,122277161,246,6,109351723,54535750,12925438,-12925438,5,41610312
2024-06-23,1506,1511,1483,1511,90525121,275,81066742,298,4,54508491,36016630,26558251,-26558251,4,9458379
2024-06-24,1527,1531,1511,1531,24146535,120,20346535,155,2,22001535,2145000,-1655000,1655000,3,3800000
2024-06-26,1544,1544,1544,1544,14489546,12,12670970,89,0,14489546,0,-1818576,1818576,1,1818576
2024-06-29,1608,1613,1557,1581,136819269,348,127866759,507,6,104989847,31829422,22876912,-22876912,3,8952510
2024-06-30,1561,1581,1513,1513,67420198,428,49149024,274,1,66805198,615000,-17656174,17656174,4,18271174
2024-07-01,1470,1570,1470,1536,36412137,242,24842197,212,1,36172137,240000,-11329940,11329940,3,11569940
2024-07-02,1564,1584,1535,1551,26414754,186,21152968,196,3,24357228,2057526,-3204260,3204260,9,5261786
2024-07-03,1546,1593,1535,1584,39029422,150,21944359,260,3,38569828,459594,-16625469,16625469,7,17085063
2024-07-06,1654,1654,1654,1654,22806040,41,21606040,152,3,16226340,6579700,5379700,-5379700,1,1200000
2024-07-07,1697,1697,1668,1697,220502917,478,185953150,639,9,173260469,47242448,12692681,-12692681,15,34549767
2024-07-08,1696,1748,1649,1726,114793318,369,86558997,637,10,95777564,19015754,-9218567,9218567,7,28234321
2024-07-09,1791,1796,1734,1749,118029700,501,108592700,654,16,87971703,30057997,20620997,-20620997,7,9437000
2024-07-10,1766,1766,1681,1701,42424754,362,32115639,386,2,42354629,70125,-10238990,10238990,5,10309115
2024-07-13,1704,1718,1666,1681,36180636,228,18861280,255,3,34970534,1210102,-16109254,16109254,6,17319356
2024-07-14,1704,1716,1661,1706,44387856,244,38786509,349,5,43713089,674767,-4926580,4926580,3,5601347
2024-07-22,1650,1730,1620,1700,111811335,308,49376421,390,7,98157259,13654076,-48780838,48780838,4,62434914
2024-07-23,1724,1735,1639,1650,40225999,245,31234656,238,6,35880750,4345249,-4646094,4646094,4,8991343
2024-07-24,1687,1690,1630,1668,37493849,203,23287006,187,4,35351953,2141896,-12064947,12064947,2,14206843
2024-07-27,1679,1679,1591,1625,64456648,369,43769767,224,2,63976648,480000,-20206881,20206881,6,20686881
2024-07-29,1626,1646,1521,1525,84684969,677,72906630,208,4,83019881,1665088,-10113251,10113251,5,11778339
2024-07-30,1545,1563,1525,1552,30658607,197,20852311,246,5,24563406,6095201,-3711095,3711095,4,9806296
2024-07-31,1452,1500,1449,1476,170407956,526,69014431,341,7,166245354,4162602,-97230923,97230923,8,101393525
2024-08-03,1481,1481,1370,1370,73428550,454,44130747,203,2,72663868,764682,-28533121,28533121,5,29297803
2024-08-04,1362,1386,1362,1362,52864304,333,33318647,148,3,45899948,6964356,-12581301,12581301,5,19545657
2024-08-05,1356,1356,1351,1351,27808770,238,24070763,164,6,25919038,1889732,-1848275,1848275,3,3738007
2024-08-06,1360,1370,1344,1344,45517564,202,15459829,153,6,17504502,28013062,-2044673,2044673,5,30057735
2024-08-10,1359,1365,1350,1353,30603952,171,29626191,170,3,20430422,10173530,9195769,-9195769,2,977761
2024-08-11,1369,1369,1343,1356,28998683,141,28992683,129,3,26918683,2080000,2074000,-2074000,1,6000
2024-08-12,1366,1367,1343,1343,12465330,132,12065330,43,2,8395708,4069622,3669622,-3669622,1,400000
2024-08-13,1341,1341,1341,1341,3725999,74,3725999,5,2,1325999,2400000,2400000,-2400000,0,0
2024-08-14,1340,1366,1340,1366,82589552,321,62460030,198,4,38769552,43820000,23690478,-23690478,3,20129522
2024-08-17,1388,1389,1376,1389,34183140,148,34183140,123,5,15203734,18979406,18979406,-18979406,0,0
2024-08-18,1406,1406,1406,1406,27256170,87,27256170,108,7,10643808,16612362,16612362,-16612362,0,0
2024-08-19,1420,1420,1366,1366,62432153,272,37624266,242,10,39336153,23096000,-1711887,1711887,4,24807887
2024-08-20,1367,1395,1360,1360,32911241,249,27507197,95,5,24899608,8011633,2607589,-2607589,5,5404044
2024-08-21,1345,1380,1344,1380,31669685,231,26950083,136,6,22734422,8935263,4215661,-4215661,5,4719602
2024-08-24,1380,1385,1351,1371,53417456,318,52570008,120,1,43017456,10400000,9552552,-9552552,2,847448
2024-08-26,1398,1398,1370,1393,91680662,198,31801305,300,4,65104117,26576545,-33302812,33302812,6,59879357
2024-08-27,1400,1420,1386,1399,28638953,178,24298139,166,7,19827970,8810983,4470169,-4470169,5,4340814
2024-08-28,1415,1424,1389,1424,79621139,139,29232654,173,5,33175568,46445571,-3942914,3942914,5,50388485
2024-09-01,1451,1451,1437,1451,52232365,168,34741654,196,2,41093638,11138727,-6351984,6351984,6,17490711
2024-09-03,1471,1471,1431,1445,37105075,196,28710311,175,4,32346896,4758179,-3636585,3636585,5,8394764
2024-09-07,1448,1491,1448,1491,59159132,99,53631471,302,5,50432482,8726650,3198989,-3198989,2,5527661
2024-09-08,1489,1529,1447,1463,37211295,211,31567534,178,4,33291553,3919742,-1724019,1724019,4,5643761
2024-09-09,1465,1525,1461,1525,90894996,177,59687007,273,5,51617123,39277873,8069884,-8069884,7,31207989
2024-09-10,1550,1550,1508,1530,40157051,222,29949726,194,4,26213543,13943508,3736183,-3736183,5,10207325
2024-09-11,1550,1575,1525,1574,59838767,269,42145529,266,5,40940696,18898071,1204833,-1204833,6,17693238
2024-09-14,1590,1599,1535,1567,81219982,291,52683157,378,4,73726573,7493409,-21043416,21043416,8,28536825
2024-09-15,1560,1570,1539,1539,18194507,264,17644507,106,0,18194507,0,-550000,550000,1,550000
2024-09-16,1539,1595,1525,1531,41415258,347,39671182,247,3,40265258,1150000,-594076,594076,2,1744076
2024-09-17,1558,1604,1528,1604,78774852,229,34957688,345,4,52178652,26596200,-17220964,17220964,10,43817164
2024-09-18,1570,1618,1570,1607,43789541,179,20915200,210,4,39075941,4713600,-18160741,18160741,11,22874341
2024-09-22,1605,1605,1556,1559,19201481,203,16308455,145,5,15277058,3924423,1031397,-1031397,3,2893026
2024-09-23,1570,1635,1547,1635,120377373,227,46353060,406,8,88891404,31485969,-42538344,42538344,14,74024313
2024-09-24,1660,1669,1623,1669,79856941,89,28591320,284,4,36815342,43041599,-8224022,8224022,5,51265621
2024-09-25,1699,1699,1618,1640,51550145,248,35223823,338,3,47050145,4500000,-11826322,11826322,8,16326322
2024-09-28,1638,1640,1638,1638,131213463,66,9213463,171,7,65369522,65843941,-56156059,56156059,2,122000000
2024-09-29,1622,1635,1622,1635,110449475,167,32049475,266,8,76615682,33833793,-44566207,44566207,5,78400000
2024-09-30,1637,1637,1607,1607,13517895,137,11123621,99,2,11717895,1800000,-594274,594274,2,2394274
2024-10-01,1603,1603,1603,1603,2249010,37,1849010,5,1,1449010,800000,400000,-400000,1,400000
2024-10-02,1602,1602,1602,1602,1258926,18,1258926,2,0,1258926,0,0,0,0,0
2024-10-05,1602,1602,1602,1602,2960105,34,2960105,5,1,2685638,274467,274467,-274467,0,0
2024-10-06,1601,1601,1601,1601,585746,13,585746,2,1,410000,175746,175746,-175746,0,0
2024-10-07,1601,1601,1601,1601,48193542,41,3388584,197,5,41564330,6629212,-38175746,38175746,2,44804958
2024-10-08,1587,1600,1587,1587,44920976,188,29917210,101,7,16664975,28256001,13252235,-13252235,3,15003766
2024-10-09,1575,1597,1575,1575,104034842,254,32434842,159,5,72564865,31469977,-40130023,40130023,4,71600000
2024-10-12,1541,1598,1529,1565,52966198,245,26985867,203,3,42366198,10600000,-15380331,15380331,2,25980331
2024-10-13,1559,1600,1514,1538,28922389,177,14841504,212,6,18840597,10081792,-3999093,3999093,4,14080885
2024-10-14,1518,1560,1504,1504,43265086,127,9337387,143,5,32135288,11129798,-22797901,22797901,9,33927699
2024-10-15,1472,1499,1472,1472,49385770,210,22641303,186,3,41463291,7922479,-18821988,18821988,8,26744467
2024-10-16,1436,1495,1432,1435,38937781,269,30409297,174,7,26275860,12661921,4133437,-4133437,9,8528484
2024-10-19,1411,1430,1407,1407,56788432,215,18537183,146,6,43512278,13276154,-24975095,24975095,9,38251249
2024-10-20,1366,1370,1366,1368,51893896,252,22889870,213,5,41196863,10697033,-18306993,18306993,7,29004026
2024-10-21,1329,1389,1329,1365,38418538,247,28995459,239,5,25553129,12865409,3442330,-3442330,3,9423079
2024-10-22,1339,1392,1326,1326,32853136,328,30103136,95,4,14511455,18341681,15591681,-15591681,3,2750000
2024-10-23,1308,1310,1308,1308,37768091,258,16682183,129,7,21909062,15859029,-5226879,5226879,5,21085908
2024-10-26,1359,1359,1359,1359,11044181,25,6857959,109,1,7444181,3600000,-586222,586222,1,4186222
2024-10-27,1367,1367,1367,1367,25785033,27,21985033,73,3,3273878,22511155,18711155,-18711155,4,3800000
2024-10-28,1387,1387,1387,1387,30332715,37,24373715,142,2,17688555,12644160,6685160,-6685160,2,5959000
2024-10-29,1388,1395,1343,1350,49167573,262,36309295,253,4,41875263,7292310,-5565968,5565968,7,12858278
2024-10-30,1371,1405,1343,1405,68214212,203,41188022,240,5,53105739,15108473,-11917717,11917717,9,27026190
2024-11-02,1411,1433,1390,1420,78327293,167,54327293,387,7,62733069,15594224,-8405776,8405776,7,24000000
2024-11-03,1394,1395,1390,1390,6415998,110,6415998,51,1,6115998,300000,300000,-300000,0,0
2024-11-04,1385,1412,1385,1397,70318803,290,56302930,127,3,25466728,44852075,30836202,-30836202,7,14015873
2024-11-05,1404,1419,1351,1396,40240879,157,21325812,156,5,23352890,16887989,-2027078,2027078,3,18915067
2024-11-06,1371,1402,1342,1369,48948806,318,33883875,169,5,30158018,18790788,3725857,-3725857,7,15064931
2024-11-09,1402,1409,1399,1409,26078911,63,20600519,142,5,11747961,14330950,8852558,-8852558,1,5478392
2024-11-10,1429,1429,1429,1429,28254087,60,27854087,71,3,2904087,25350000,24950000,-24950000,1,400000
2024-11-11,1452,1452,1452,1452,49665289,112,46865289,121,4,8599595,41065694,38265694,-38265694,6,2800000
2024-11-12,1492,1492,1492,1492,64785800,76,53185800,180,3,14785800,50000000,38400000,-38400000,9,11600000
2024-11-13,1530,1536,1506,1536,103927255,104,73587236,337,5,88327255,15600000,-14740019,14740019,9,30340019
2024-11-16,1577,1577,1577,1577,50906025,106,45407025,116,2,5906025,45000000,39501000,-39501000,10,5499000
2024-11-17,1622,1622,1603,1622,201650100,214,152528100,504,11,124005399,77644701,28522701,-28522701,15,49122000
2024-11-18,1670,1670,1670,1670,48649652,98,43849652,138,2,8649652,40000000,35200000,-35200000,8,4800000
2024-11-19,1714,1714,1671,1714,401149367,741,270729474,763,19,238801806,162347561,31927668,-31927668,19,130419893
2024-11-20,1717,1759,1717,1759,299207906,381,204419424,693,16,194183429,105024477,10235995,-10235995,10,94788482
2024-11-23,1780,1809,1766,1809,240586019,521,160456526,602,10,156135989,84450030,4320537,-4320537,15,80129493
2024-11-24,1855,1857,1811,1857,162527563,407,114920269,434,12,100712505,61815058,14207764,-14207764,11,47607294
2024-11-25,1911,1911,1911,1911,54329122,52,24268193,199,4,12303055,42026067,11965138,-11965138,6,30060929
2024-11-26,1968,1968,1854,1854,484235927,1420,300691909,1039,23,311293862,172942065,-10601953,10601953,28,183544018
2024-12-01,1860,1869,1805,1859,252147741,706,134624624,410,10,201930666,50217075,-67306042,67306042,11,117523117
2024-12-02,1889,1891,1887,1891,63580410,136,44285036,355,4,43080410,20500000,1204626,-1204626,7,19295374
2024-12-03,1924,1925,1840,1864,284701686,1231,222752515,717,13,243897420,40804266,-21144905,21144905,9,61949171
2024-12-04,1851,1883,1824,1859,323027850,1266,223606477,586,7,262954878,60072972,-39348401,39348401,15,99421373
2024-12-07,1821,1821,1797,1797,483703274,697,80064586,499,17,341381191,142322083,-261316605,261316605,9,403638688
2024-12-08,1751,1817,1744,1806,218476167,633,90296822,571,9,125905762,92570405,-35608940,35608940,13,128179345
2024-12-09,1825,1826,1807,1826,172253483,428,129015791,337,12,59249794,113003689,69765997,-69765997,7,43237692
2024-12-10,1845,1857,1772,1780,226785653,1012,113183855,483,10,126986723,99798930,-13802868,13802868,10,113601798
2024-12-11,1780,1838,1751,1838,126341197,430,93440183,565,10,112415395,13925802,-18975212,18975212,6,32901014
2024-12-14,1855,1865,1852,1865,95575448,184,66579710,375,5,57693781,37881667,8885929,-8885929,8,28995738
2024-12-15,1920,1920,1850,1882,276266489,875,139019879,867,14,201099684,75166805,-62079805,62079805,12,137246610
2024-12-16,1880,1899,1826,1826,188699463,698,79959520,612,13,153179077,35520386,-73219557,73219557,14,108739943
2024-12-17,1800,1840,1797,1797,121332616,442,43221952,350,9,74083573,47249043,-30861621,30861621,11,78110664
2024-12-18,1747,1826,1747,1807,117871022,508,72222567,736,11,104523211,13347811,-32300644,32300644,11,45648455
2024-12-21,1831,1831,1830,1831,107247489,208,72447489,278,11,43091944,64155545,29355545,-29355545,5,34800000
2024-12-22,1853,1853,1777,1837,112679155,538,73820931,446,8,98787901,13891254,-24966970,24966970,5,38858224
2024-12-23,1820,1865,1778,1865,179468284,176,121068284,506,6,101096239,78372045,19972045,-19972045,5,58400000
2024-12-24,1918,1918,1873,1918,273974617,594,155764776,769,14,178484225,95490392,-22719449,22719449,15,118209841
2024-12-25,1931,1971,1880,1971,455724463,775,279030837,1100,11,213798367,241926096,65232470,-65232470,13,176693626
2024-12-28,1980,2019,1970,2019,381187957,714,189093419,1017,19,262153206,119486751,-73059787,73059787,16,192546538
2024-12-29,2020,2020,1955,1957,189010872,811,129677318,700,6,174382869,14628003,-44705551,44705551,14,59333554
2024-12-30,1925,1979,1908,1917,161857549,499,47750636,687,11,123325057,38532492,-75574421,75574421,12,114106913
2024-12-31,1929,1965,1882,1932,86074842,326,35414079,608,10,69826582,16248260,-34412503,34412503,10,50660763
2025-01-01,1927,1980,1886,1980,123217901,307,56553361,1113,11,75373926,47843975,-18820565,18820565,10,66664540
2025-01-04,2000,2018,1976,2018,153640008,435,65874954,578,11,76663807,76976201,-10788853,10788853,11,87765054
2025-01-05,2000,2076,2000,2076,425710427,280,372898648,651,13,79639581,346070846,293259067,-293259067,11,52811779
2025-01-07,2135,2135,2135,2135,80161971,82,80161971,242,7,10788119,69373852,69373852,-69373852,0,0
2025-01-08,2199,2199,2162,2199,656809383,1091,554458274,1088,22,434987357,221822026,119470917,-119470917,20,102351109
2025-01-11,2263,2263,2198,2220,548740502,1866,437705184,1584,16,399173832,149566670,38531352,-38531352,23,111035318
2025-01-12,2182,2219,2182,2182,285093797,866,134312431,697,10,230384655,54709142,-96072224,96072224,15,150781366
2025-01-13,2175,2232,2130,2169,174364173,922,120838042,698,12,109079365,65284808,11758677,-11758677,6,53526131
2025-01-15,2170,2225,2121,2130,188810278,805,62043493,665,5,162108784,26701494,-100065291,100065291,16,126766785
2025-01-18,2120,2150,2086,2087,185222956,551,41520814,593,5,169998211,15224745,-128477397,128477397,14,143702142
2025-01-19,2034,2148,2030,2090,81171918,669,61974171,469,7,71212253,9959665,-9238082,9238082,8,19197747
2025-01-20,2127,2135,2023,2023,151660000,498,47371547,415,7,118448873,33211127,-71077326,71077326,10,104288453
2025-01-21,2030,2097,1981,2049,81948698,511,56726517,408,2,61571859,20376839,-4845342,4845342,6,25222181
2025-01-22,2095,2102,2047,2090,142778676,458,52200338,379,2,65000991,6811003,-12800653,12800653,4,19611656
2025-01-25,2100,2131,2047,2098,73742109,400,52369579,503,6,54225097,19517012,-1855518,1855518,4,21372530
2025-01-26,2065,2156,2065,2097,75395879,457,55135054,577,8,61676016,13719863,-6540962,6540962,7,20260825
2025-01-27,2184,2184,2134,2151,359310405,940,249120337,855,18,179006153,180304252,70114184,-70114184,17,110190068
2025-01-29,2176,2184,2121,2175,92116408,471,44012281,599,6,80506220,11610188,-36493939,36493939,8,48104127
2025-02-01,2083,2125,2083,2093,135856377,386,36001249,441,10,120556603,15299774,-84555354,84555354,4,99855128
2025-02-02,2093,2129,2044,2090,103724601,312,27887564,435,7,58829110,44895491,-30941546,30941546,3,75837037
2025-02-03,2118,2149,2070,2149,99069882,331,78191014,569,11,80462490,18607392,-2271476,2271476,5,20878868
2025-02-04,2169,2172,2155,2172,101406700,292,91856700,407,8,52671791,48734909,39184909,-39184909,5,9550000
2025-02-05,2159,2215,2107,2209,98506043,578,62625503,519,5,94566043,3940000,-31940540,31940540,7,35880540
2025-02-09,2196,2196,2120,2132,172725628,709,149304603,743,11,122148359,50577269,27156244,-27156244,13,23421025
2025-02-11,2174,2174,2113,2113,174256432,332,34771432,487,5,171999754,2256678,-137228322,137228322,9,139485000
2025-02-15,2057,2057,2057,2057,8237764,86,4984330,6,0,8237764,0,-3253434,3253434,4,3253434
2025-02-16,2047,2050,2047,2047,171257348,271,31481953,503,5,137520966,33736382,-106039013,106039013,4,139775395
2025-02-17,2019,2067,1987,2047,95638277,394,49437188,496,12,82474717,13163560,-33037529,33037529,8,46201089
2025-02-18,2047,2047,1964,1985,81132956,474,46843229,295,4,43309187,37823769,3534042,-3534042,8,34289727
2025-02-19,1981,2011,1969,1986,69848820,247,18780057,286,10,60998976,8849844,-42218919,42218919,7,51068763
2025-02-22,1986,1986,1927,1958,99746107,315,25413317,433,3,69887069,29859038,-44473752,44473752,7,74332790
2025-02-23,2003,2003,1992,2003,117149481,365,113744481,281,9,19041970,98107511,94702511,-94702511,2,3405000
2025-02-24,2060,2063,2040,2063,141080253,354,130480253,258,13,42276702,98803551,88203551,-88203551,2,10600000
2025-02-25,2124,2124,2050,2063,197779122,900,175067408,572,18,95100065,102679057,79967343,-79967343,5,22711714
2025-02-26,2100,2118,2046,2046,189027249,561,82334716,533,4,140297847,48729402,-57963131,57963131,6,106692533
2025-03-01,2018,2095,2012,2074,127570214,377,34779858,489,8,111807353,15762861,-77027495,77027495,8,92790356
2025-03-02,2055,2116,2039,2096,117793823,368,77682032,507,17,61457602,56336221,16224430,-16224430,8,40111791
2025-03-03,2036,2036,2036,2036,9637413,156,9434893,12,1,8837413,800000,597480,-597480,2,202520
2025-03-04,2026,2117,2025,2025,107177507,461,56936703,347,7,82862037,24315470,-25925334,25925334,7,50240804
2025-03-05,1973,2030,1972,2028,100926269,404,42513161,404,5,91292203,9634066,-48779042,48779042,9,58413108
2025-03-08,2019,2024,1927,1927,114922251,300,24039350,458,6,112801242,2121009,-88761892,88761892,7,90882901
2025-03-09,1888,1946,1888,1925,96469708,293,24953536,365,9,66587260,29882448,-41633724,41633724,8,71516172
2025-03-10,1880,1929,1842,1887,77189961,282,28348725,366,11,53638925,23551036,-25290200,25290200,5,48841236
2025-03-11,1869,1869,1813,1813,31800153,278,21327234,87,1,30545350,1254803,-9218116,9218116,4,10472919
2025-03-12,1836,1871,1815,1836,59147591,238,50533170,288,8,36013607,23133984,14519563,-14519563,9,8614421
2025-03-15,1866,1889,1866,1889,80504323,172,57277236,239,13,24866562,55637761,32410674,-32410674,4,23227087
2025-03-16,1920,1930,1849,1894,68496129,248,37715446,277,8,41770664,26725465,-4055218,4055218,9,30780683
2025-03-17,1860,1927,1852,1860,61464985,211,42481982,227,9,39884544,21580441,2597438,-2597438,5,18983003
2025-03-18,1840,1840,1840,1840,19788092,177,10314310,22,1,16715427,3072665,-6401117,6401117,2,9473782
2025-03-25,1868,1929,1868,1921,51931447,242,43559237,193,7,38174430,13757017,5384807,-5384807,3,8372210
2025-03-26,1921,1939,1891,1900,36864308,166,18061041,215,8,23730246,13134062,-5669205,5669205,6,18803267
2025-03-29,1880,1919,1870,1888,24329020,170,13618408,239,3,19483668,4845352,-5865260,5865260,5,10710612
2025-03-30,1860,1927,1860,1890,80013160,310,53842658,222,5,36595681,43417479,17246977,-17246977,5,26170502
2025-04-05,1906,1919,1870,1881,53154067,332,47249767,260,3,36691809,16462258,10557958,-10557958,5,5904300
2025-04-06,1866,1900,1837,1898,71639533,306,21005227,288,3,66039533,5600000,-45034306,45034306,7,50634306
2025-04-07,1850,1886,1820,1829,66479446,202,24942293,215,7,36019307,30460139,-11077014,11077014,7,41537153
2025-04-08,1888,1889,1885,1889,37041521,108,37041521,77,3,25951521,11090000,11090000,-11090000,0,0
