Date,Open,High,Low,Close,Volume,person_buyer_count,company_buyer_count,person_buy_volume,company_buy_volume,person_seller_count,company_seller_count,person_sell_volume,company_sell_volume,person_owner_change,company_owner_change
2015-06-23,575,576,562,570,2334748,154,1,2299748,35000,92,2,1503566,831182,796182,-796182
2015-06-24,565,587,559,576,2231124,140,1,2225124,6000,130,3,1770908,460216,454216,-454216
2015-06-27,574,584,567,567,1353970,102,2,1299970,54000,56,2,1169699,184271,130271,-130271
2015-06-28,577,577,553,553,953610,72,1,753610,200000,45,0,953610,0,-200000,200000
2015-06-29,545,576,545,570,970647,59,1,910647,60000,63,0,970647,0,-60000,60000
2015-06-30,574,596,571,596,4636945,242,6,3592323,1044622,163,5,3100945,1536000,491378,-491378
2015-07-01,600,617,580,600,3718284,248,2,3286691,431593,109,5,1210057,2508227,2076634,-2076634
2015-07-04,617,631,617,631,8291899,578,3,7988699,303200,116,10,1481173,6810726,6507526,-6507526
2015-07-05,653,653,624,632,5383344,392,2,5233044,150300,159,7,2503312,2880032,2729732,-2729732
2015-07-06,641,652,635,645,3825179,330,3,3717857,107322,101,6,1517502,2307677,2200355,-2200355
2015-07-07,647,675,647,675,11361927,608,4,11051927,310000,207,12,2906946,8454981,8144981,-8144981
2015-07-11,659,681,647,666,5528116,365,4,5017116,511000,178,5,3470008,2058108,1547108,-1547108
2015-07-12,677,701,675,678,7497007,436,2,5611558,1210000,183,7,4605371,2216187,1006187,-1006187
2015-07-13,720,722,701,717,10893562,707,3,10703562,190000,181,8,4086037,6807525,6617525,-6617525
2015-07-14,739,739,688,708,9101504,667,8,8166404,935100,302,8,7485081,1616423,681323,-681323
2015-07-15,747,747,684,699,8648497,441,14,6264896,2383601,423,2,7928497,720000,-1663601,1663601
2015-07-20,680,706,678,678,4153888,246,10,2587692,1566196,249,1,4093888,60000,-1506196,1506196
2015-07-21,683,694,647,647,4595955,437,6,4278955,317000,264,1,4395955,200000,-117000,117000
2015-07-22,647,647,626,626,3939052,363,8,3299052,640000,178,1,3839052,100000,-540000,540000
2015-07-25,614,623,598,598,1913688,227,1,1813688,100000,139,0,1913688,0,-100000,100000
2015-07-26,582,618,582,610,6660318,434,6,6186423,473895,319,1,6505118,155200,-318695,318695
2015-07-27,606,612,579,591,3236502,278,2,3192524,43978,146,2,3113887,122615,78637,-78637
2015-07-28,588,618,584,618,2793834,237,3,2287559,506275,217,2,2597217,196617,-309658,309658
2015-07-29,624,637,620,637,5037401,220,2,4627401,410000,252,4,4101604,935797,525797,-525797
2015-08-01,658,665,643,643,4837448,252,1,3269014,100000,277,4,3106453,262561,162561,-162561
2015-08-02,639,659,624,639,3639037,227,2,2647665,991372,253,3,3575116,63921,-927451,927451
2015-08-03,646,654,644,647,2111583,139,5,1128761,982822,156,0,2111583,0,-982822,982822
2015-08-04,650,670,628,657,4226479,167,6,1912987,2313492,274,1,4216479,10000,-2303492,2303492
2015-08-05,651,660,650,658,1627176,120,1,1515901,111275,149,1,1527176,100000,-11275,11275
2015-08-08,657,658,631,654,3264800,172,2,1514800,1750000,192,0,3264800,0,-1750000,1750000
2015-08-09,645,655,639,645,2801131,99,1,834121,1965010,165,3,2623622,175509,-1789501,1789501
2015-08-10,653,658,641,641,1645550,84,3,588943,1056607,130,3,1584308,61242,-995365,995365
2015-08-12,650,655,635,640,1076441,78,1,1075864,577,59,1,1062941,13500,12923,-12923
2015-08-15,653,653,633,638,1250964,133,1,1151541,99423,105,1,1214464,36500,-62923,62923
2015-08-16,640,654,640,651,2346938,71,2,885538,1461400,167,1,2321938,25000,-1436400,1436400
2015-08-17,653,664,647,652,3008155,57,4,791131,2217024,190,7,2699986,308169,-1908855,1908855
2015-08-18,654,658,647,649,950518,32,1,201596,300000,39,0,501596,0,-300000,300000
2015-08-19,647,651,640,641,888969,84,4,635284,253685,70,1,730650,158319,-95366,95366
2015-08-22,647,651,637,638,590598,66,3,492575,98023,45,2,538598,52000,-46023,46023
2015-08-23,643,643,618,630,1466522,137,6,973010,493512,89,0,1466522,0,-493512,493512
2015-08-24,633,635,618,620,1298754,47,4,229190,1069564,89,0,1298754,0,-1069564,1069564
2015-08-25,630,630,596,624,2971555,115,5,959825,2011730,157,3,2769146,202409,-1809321,1809321
2015-08-26,622,630,613,627,1644512,46,1,394512,1250000,103,1,1634512,10000,-1240000,1240000
2015-08-29,630,639,622,622,1349881,74,1,921398,428483,60,0,1349881,0,-428483,428483
2015-08-30,631,634,621,633,1524188,41,2,187235,1336953,89,3,984188,540000,-796953,796953
2015-08-31,632,632,617,617,725877,59,1,502981,222896,42,1,615926,109951,-112945,112945
2015-09-01,629,634,624,626,907980,22,3,148001,759979,76,1,857980,50000,-709979,709979
2015-09-02,628,634,627,630,962467,21,2,128147,834320,69,0,962467,0,-834320,834320
2015-09-05,633,644,633,633,716077,70,1,702577,13500,60,1,666077,50000,36500,-36500
2015-09-06,639,639,631,635,1743703,39,3,367196,1376507,65,1,1625963,117740,-1258767,1258767
2015-09-07,638,643,629,629,869593,48,2,472308,397285,97,0,869593,0,-397285,397285
2015-09-08,635,647,634,647,1493196,42,2,233228,1259968,127,0,1493196,0,-1259968,1259968
2015-09-09,647,647,638,641,792287,59,1,491324,300963,52,0,792287,0,-300963,300963
2015-09-12,643,657,639,641,884692,40,3,388310,496382,77,1,801550,83142,-413240,413240
2015-09-13,644,644,613,618,719872,119,2,637372,82500,54,0,719872,0,-82500,82500
2015-09-14,621,647,618,646,2634491,43,3,422455,2212036,169,2,2440267,194224,-2017812,2017812
2015-09-15,645,645,621,625,534469,62,0,534469,0,43,1,499469,35000,35000,-35000
2015-09-16,624,637,619,624,628386,79,0,628386,0,66,0,628386,0,0,0
2015-09-19,618,647,618,624,1954735,58,2,904735,1050000,92,2,1568656,386079,-663921,663921
2015-09-20,624,624,605,605,1561177,166,0,1559477,0,37,2,874732,684745,684745,-684745
2015-09-21,615,643,582,612,4230387,182,5,1654789,2575598,199,3,3767465,462922,-2112676,2112676
2015-09-22,624,624,609,623,675264,53,1,494104,181160,59,1,667243,8021,-173139,173139
2015-09-23,622,623,612,612,1021348,55,1,877591,143757,50,0,1021348,0,-143757,143757
2015-09-26,614,624,611,615,3836562,31,2,330856,3505706,91,1,3744583,91979,-3413727,3413727
2015-09-27,628,635,616,634,1222419,65,4,492682,729737,129,1,1208419,14000,-715737,715737
2015-09-28,635,640,622,639,5946518,103,2,5826518,120000,113,2,1247307,4699211,4579211,-4579211
2015-09-29,641,641,626,626,696625,70,1,416719,279906,44,0,696625,0,-279906,279906
2015-09-30,635,638,627,627,794592,25,2,235320,559272,67,1,694592,100000,-459272,459272
2015-10-03,634,638,626,628,2270460,19,2,75890,2194570,126,1,1970460,300000,-1894570,1894570
2015-10-04,635,641,628,635,1772747,27,2,423258,1349489,154,1,1762747,10000,-1339489,1339489
2015-10-05,641,641,634,634,811390,32,2,168845,642545,66,0,811390,0,-642545,642545
2015-10-06,641,653,635,645,2038246,23,3,59978,1978268,153,3,1878041,160205,-1818063,1818063
2015-10-07,647,647,642,643,979830,38,1,274525,705305,66,3,773508,206322,-498983,498983
2015-10-10,653,653,643,647,1033418,35,2,242830,790588,61,2,657215,376203,-414385,414385
2015-10-11,647,647,644,644,644904,38,1,316870,328034,76,1,540982,103922,-224112,224112
2015-10-12,647,651,644,644,900582,44,4,442431,458151,83,0,900582,0,-458151,458151
2015-10-13,647,647,646,646,1330846,56,2,698093,632753,68,1,1250846,80000,-552753,552753
2015-10-14,647,657,644,644,2035351,122,4,1112601,922750,64,2,1985988,49363,-873387,873387
2015-10-17,652,671,647,659,4890767,269,6,3573471,1317296,181,5,2884109,2006658,689362,-689362
2015-10-18,665,668,647,652,1786661,127,4,759813,1026848,134,2,1596812,189849,-836999,836999
2015-10-19,655,664,652,656,2957438,94,8,1134666,1822772,221,0,2957438,0,-1822772,1822772
2015-11-01,664,664,658,658,1126254,43,3,267296,858958,60,2,1125154,1100,-857858,857858
2015-11-02,661,661,640,640,734196,60,3,513295,220901,50,1,730853,3343,-217558,217558
2015-11-03,652,653,637,640,417828,56,1,358124,59704,48,3,389818,28010,-31694,31694
2015-11-04,632,640,627,635,1170564,147,2,1152860,17704,56,0,1170564,0,-17704,17704
2015-11-07,639,639,624,625,960801,126,0,960801,0,53,0,960801,0,0,0
2015-11-08,634,652,622,652,1391825,100,2,729962,661863,94,1,1091825,300000,-361863,361863
2015-11-09,629,638,626,628,667374,85,2,610874,51500,34,2,501361,161013,109513,-109513
2015-11-10,628,640,626,626,586929,62,1,581929,5000,33,2,509757,77172,72172,-72172
2015-11-11,628,628,619,622,808816,111,2,713816,95000,39,0,808816,0,-95000,95000
2015-11-14,619,640,617,632,1602022,60,2,398022,1204000,120,1,1502022,100000,-1104000,1104000
2015-11-15,639,654,628,646,2268421,35,3,327505,1940916,166,4,2048342,220079,-1720837,1720837
2015-11-16,652,652,637,640,1968415,60,1,1960415,8000,49,2,1600969,367446,359446,-359446
2015-11-17,640,651,634,639,1007089,58,2,848584,158505,47,2,791102,215987,57482,-57482
2015-11-18,635,646,623,633,2828767,48,3,285767,2543000,48,2,2468767,360000,-2183000,2183000
2015-11-21,627,637,627,630,336673,33,2,134673,202000,34,0,336673,0,-202000,202000
2015-11-22,628,634,624,633,539192,77,2,437192,102000,33,0,539192,0,-102000,102000
2015-11-23,625,628,623,624,812948,99,3,656104,156844,27,0,812948,0,-156844,156844
2015-11-24,634,639,622,625,890665,53,3,335665,555000,37,3,585947,304718,-250282,250282
2015-11-25,623,640,623,628,1474386,29,2,168386,1306000,73,2,1015257,459129,-846871,846871
2015-11-28,639,639,622,623,667241,59,2,563241,104000,31,2,417241,250000,146000,-146000
2015-11-29,632,638,620,623,1125372,39,2,121172,1004000,77,3,874972,250200,-753800,753800
2015-11-30,622,627,620,621,445852,51,2,395752,50100,37,0,445852,0,-50100,50100
2015-12-01,622,626,619,626,223211,25,1,173211,50000,36,0,223211,0,-50000,50000
2015-12-05,624,633,624,624,350952,43,1,350852,100,26,0,350952,0,-100,100
2015-12-06,624,624,608,609,492209,91,2,387209,105000,41,0,492209,0,-105000,105000
2015-12-07,608,619,601,604,496754,96,0,496754,0,38,0,496754,0,0,0
2015-12-08,604,622,604,610,640566,32,2,171194,469372,51,1,589533,51033,-418339,418339
2015-12-09,621,621,604,613,399346,42,2,156433,62677,14,0,219110,0,-62677,62677
2015-12-13,610,617,606,610,503055,28,2,406405,96650,35,0,503055,0,-96650,96650
2015-12-14,608,618,604,605,664131,68,2,544131,120000,43,0,664131,0,-120000,120000
2015-12-15,616,618,610,613,719240,61,0,719240,0,53,0,719240,0,0,0
2015-12-16,614,617,613,613,575946,35,2,445125,130821,54,1,545329,30617,-100204,100204
2015-12-19,606,610,583,600,462107,59,0,462107,0,30,0,462107,0,0,0
2015-12-20,597,597,578,578,809834,108,0,809834,0,35,0,809834,0,0,0
2015-12-21,569,599,569,582,975267,64,2,440041,535226,73,0,975267,0,-535226,535226
2015-12-22,571,585,564,570,1460087,150,0,1460087,0,69,1,1341737,118350,118350,-118350
2015-12-23,585,590,574,586,799629,36,4,123253,676376,93,0,799629,0,-676376,676376
2015-12-26,590,604,579,604,2060089,34,3,107367,1952722,106,1,1011258,1048831,-903891,903891
2015-12-27,603,605,588,591,926708,85,3,763806,162902,41,2,532980,393728,230826,-230826
2015-12-28,595,597,583,583,355780,58,3,260297,95483,31,1,349966,5814,-89669,89669
2015-12-30,600,604,591,594,1206049,99,1,1080564,125485,57,1,852057,353992,228507,-228507
2016-01-02,601,602,581,582,960696,63,3,412080,548616,76,1,957922,2774,-545842,545842
2016-01-03,595,596,585,586,454460,48,3,292499,161961,39,0,454460,0,-161961,161961
2016-01-04,596,596,575,582,929509,113,4,849367,80142,63,0,929509,0,-80142,80142
2016-01-05,580,616,577,602,3773853,201,4,3599470,174383,123,5,1999908,1773945,1599562,-1599562
2016-01-06,604,618,592,592,2662877,160,3,2478877,184000,94,1,2209841,453036,269036,-269036
2016-01-09,604,610,587,592,810883,95,2,782331,28552,80,0,810883,0,-28552,28552
2016-01-10,598,598,584,588,601150,81,3,532753,68397,44,0,601150,0,-68397,68397
2016-01-11,592,616,588,603,2448498,145,5,2022250,426248,144,1,1666047,782451,356203,-356203
2016-01-12,607,638,607,638,5490441,131,3,3540441,1950000,226,8,2898880,2591561,641561,-641561
2016-01-13,651,654,651,654,2931244,28,3,941070,1990174,119,4,1279669,1651575,-338599,338599
2016-01-16,686,686,686,686,3271047,40,4,2671047,600000,56,2,521699,2749348,2149348,-2149348
2016-01-17,720,720,689,702,27247851,773,11,18277851,8970000,726,25,16468165,10779686,1809686,-1809686
2016-01-18,713,732,692,725,9376067,213,2,3401004,5975063,415,5,6013741,3362326,-2612737,2612737
2016-01-19,725,735,714,716,7364911,291,6,3152090,4212821,233,5,3916824,3448087,-764734,764734
2016-01-20,725,733,719,721,5836167,432,3,4846167,990000,170,6,3554954,2281213,1291213,-1291213
2016-01-23,713,725,709,719,4678762,247,4,1985011,2693751,218,6,3446762,1232000,-1461751,1461751
2016-01-24,719,721,704,707,4759635,217,3,3110055,1649580,223,3,4367609,392026,-1257554,1257554
2016-01-25,702,739,697,732,6548956,353,8,4193315,2355641,370,4,5795368,753588,-1602053,1602053
2016-01-26,739,740,725,739,7144862,568,5,6934862,210000,231,5,4360044,2784818,2574818,-2574818
2016-01-27,737,737,701,713,3341872,274,5,2039241,1302631,261,0,3341872,0,-1302631,1302631
2016-01-30,719,730,701,701,2278995,144,3,994685,1284310,139,1,2078167,200828,-1083482,1083482
2016-01-31,708,732,692,712,3289099,124,4,756513,2532586,231,3,2908099,381000,-2151586,2151586
2016-02-01,714,728,703,707,3061334,236,5,2104334,957000,191,3,2885236,176098,-780902,780902
2016-02-02,713,721,709,709,2786790,127,2,1073084,1713706,193,2,2561790,225000,-1488706,1488706
2016-02-03,709,731,704,731,3715408,83,5,805629,2909779,219,4,2751665,963743,-1946036,1946036
2016-02-06,725,740,713,719,4307857,284,2,3592857,715000,216,5,3282857,1025000,310000,-310000
2016-02-07,725,733,713,719,4004588,213,3,3342588,662000,213,3,3819632,184956,-477044,477044
2016-02-08,713,724,710,713,5978022,343,7,3853887,2124135,227,6,3545442,2432580,308445,-308445
2016-02-09,722,748,706,724,13846058,731,9,10536058,3310000,401,13,7325106,6520952,3210952,-3210952
2016-02-10,708,738,708,712,2575266,200,4,1790438,784828,213,2,2456192,119074,-665754,665754
2016-02-13,725,725,689,707,3280243,169,5,1098143,2182100,166,0,3280243,0,-2182100,2182100
2016-02-14,713,725,696,725,3215936,112,7,864117,2351819,234,3,2689182,526754,-1825065,1825065
2016-02-15,724,755,719,755,41365943,1474,35,32915643,8450300,482,15,8197396,33168547,24718247,-24718247
2016-02-16,772,789,745,773,66088278,1625,27,53425375,12662903,835,20,18775287,47312991,34650088,-34650088
2016-02-17,785,803,778,779,11909849,777,12,8276849,3633000,549,4,11633090,276759,-3356241,3356241
2016-02-20,779,779,748,748,6920028,459,7,5483008,1437020,353,1,6720028,200000,-1237020,1237020
2016-02-21,749,761,718,725,13409375,448,10,4613182,8796193,561,8,11986375,1423000,-7373193,7373193
2016-02-22,747,755,725,732,5574686,366,6,3569071,2005615,275,5,5266186,308500,-1697115,1697115
2016-02-23,725,743,703,726,7388844,318,4,3939617,3449227,348,0,7388844,0,-3449227,3449227
2016-02-24,715,734,707,711,4802917,237,7,2499962,2302955,226,0,4802917,0,-2302955,2302955
2016-02-27,725,732,712,718,2967511,194,18,2105711,861800,175,3,2817511,150000,-711800,711800
2016-02-28,716,724,701,708,4821593,261,5,1941590,2880003,259,2,3371593,1450000,-1430003,1430003
2016-02-29,721,725,701,707,4427738,114,1,1129238,3298500,186,3,4059738,368000,-2930500,2930500
2016-03-01,722,724,707,709,5105612,128,6,954908,4150704,192,4,4787312,318300,-3832404,3832404
2016-03-02,723,749,708,749,9542232,136,10,533335,9008897,288,5,8060232,1482000,-7526897,7526897
2016-03-05,747,747,713,713,1404563,183,0,1404563,0,131,2,1352563,52000,52000,-52000
2016-03-06,710,724,707,710,2961028,173,3,1839636,1121392,214,2,2908671,52357,-1069035,1069035
2016-03-07,707,723,703,714,4308747,114,3,853985,3454762,237,4,3980247,328500,-3126262,3126262
2016-03-08,707,716,689,698,3924280,139,7,2258286,1665994,170,2,3758130,166150,-1499844,1499844
2016-03-09,695,718,695,701,3402044,162,3,1962785,1439259,178,3,2898194,503850,-935409,935409
2016-03-12,707,715,690,707,5749101,142,5,884648,4864453,250,6,4999101,750000,-4114453,4114453
2016-03-14,701,714,690,700,3386178,147,2,1607495,1778683,267,3,2836178,550000,-1228683,1228683
2016-03-15,695,702,695,698,2723720,94,3,768014,1955706,187,4,2389298,334422,-1621284,1621284
2016-03-16,684,702,679,684,3975529,146,1,834350,3141179,207,2,3227886,747643,-2393536,2393536
2016-03-26,693,701,684,700,592916,73,2,474149,118767,66,0,592916,0,-118767,118767
2016-03-27,695,703,687,689,471694,73,2,221776,249918,55,0,471694,0,-249918,249918
2016-03-28,693,694,687,687,1207537,71,2,261117,946420,67,2,660537,547000,-399420,399420
2016-03-29,689,703,677,689,1377105,70,3,267700,1109405,138,0,1377105,0,-1109405,1109405
2016-03-30,704,723,691,723,3927746,61,2,3663871,263875,200,3,3217846,709900,446025,-446025
2016-04-02,731,750,727,740,5537172,209,5,2256356,3280816,375,5,5162377,374795,-2906021,2906021
2016-04-03,725,755,713,741,6451283,111,4,557054,5894229,290,4,3679348,2771935,-3122294,3122294
2016-04-04,725,761,725,761,6436362,61,5,467769,5968593,367,7,5206347,1230015,-4738578,4738578
2016-04-05,748,749,726,731,1796179,99,7,884516,911663,81,3,1557633,238546,-673117,673117
2016-04-06,731,745,725,742,1876083,45,4,587621,1288462,164,1,1823083,53000,-1235462,1235462
2016-04-09,726,739,725,729,2044856,57,4,359164,1685692,109,2,1311856,733000,-952692,952692
2016-04-10,737,758,725,729,5575489,89,5,889489,4686000,263,7,2802735,2772754,-1913246,1913246
2016-04-11,725,743,725,725,564240,63,5,248426,315814,62,1,534240,30000,-285814,285814
2016-04-12,726,743,719,722,861542,62,2,274505,587037,60,1,475215,386327,-200710,200710
2016-04-13,725,749,713,731,6148835,39,3,143325,6005510,163,19,2443835,3705000,-2300510,2300510
2016-04-16,731,731,707,707,1506397,81,3,708258,798139,90,1,1406397,100000,-698139,698139
2016-04-17,683,735,683,713,4745483,84,1,419372,4326111,92,1,1676378,3069105,-1257006,1257006
2016-04-18,705,736,705,725,1084286,46,3,469644,614642,91,2,964286,120000,-494642,494642
2016-04-19,713,719,708,708,260576,35,0,260576,0,37,0,260576,0,0,0
2016-04-20,707,738,692,738,3627585,87,2,364663,3262922,119,1,1827585,1800000,-1462922,1462922
2016-04-23,735,736,713,715,345299,31,1,295299,50000,51,1,336299,9000,-41000,41000
2016-04-24,719,721,709,709,429081,77,0,429081,0,50,0,429081,0,0,0
2016-04-25,710,725,701,713,849754,100,1,413684,436070,52,3,619754,230000,-206070,206070
2016-04-26,707,730,702,713,6926491,59,2,541915,6384576,110,2,1925440,5001051,-1383525,1383525
2016-04-27,719,719,704,706,598912,82,0,598912,0,47,1,548912,50000,50000,-50000
2016-04-30,703,718,697,702,686034,83,0,686034,0,44,1,664734,21300,21300,-21300
2016-05-01,695,710,695,700,608505,52,1,558505,50000,63,0,608505,0,-50000,50000
2016-05-02,700,701,692,697,434732,53,0,434732,0,51,0,434732,0,0,0
2016-05-03,694,697,689,689,592854,88,1,562854,30000,45,2,539591,53263,23263,-23263
2016-05-04,686,720,686,708,5094136,67,4,679550,4414586,128,4,1877576,3216560,-1198026,1198026
2016-05-07,695,735,695,722,6158315,23,3,166980,5991335,226,1,3858315,2300000,-3691335,3691335
2016-05-08,714,724,707,716,930410,24,1,851904,78506,82,1,922000,8410,-70096,70096
2016-05-09,707,719,701,711,575844,23,2,228046,347798,46,0,575844,0,-347798,347798
2016-05-10,701,743,701,743,3838840,20,3,110800,3728040,204,0,3838840,0,-3728040,3728040
2016-05-11,712,725,709,712,444251,26,1,305251,139000,41,0,444251,0,-139000,139000
2016-05-14,707,722,704,722,307612,41,1,249128,58484,36,2,228474,79138,20654,-20654
2016-05-15,706,712,686,706,731419,71,0,731419,0,39,1,620713,110706,110706,-110706
2016-05-17,677,701,672,677,651476,88,2,597466,54010,43,1,637031,14445,-39565,39565
2016-05-18,692,699,689,689,228132,40,1,169696,58436,27,0,228132,0,-58436,58436
2016-05-21,700,700,666,678,705669,101,2,642740,62929,37,0,705669,0,-62929,62929
2016-05-23,685,685,674,677,615350,78,2,432125,183225,50,0,615350,0,-183225,183225
2016-05-24,673,714,671,714,2568730,69,3,248882,2319848,137,2,2532997,35733,-2284115,2284115
2016-05-25,706,722,684,702,3201915,45,4,227313,2974602,89,3,1071915,2130000,-844602,844602
2016-05-28,701,712,695,706,589298,19,1,166895,422403,78,0,589298,0,-422403,422403
2016-05-29,695,701,690,691,725564,29,1,238512,487052,33,0,725564,0,-487052,487052
2016-05-30,709,719,689,701,3672164,38,3,107338,3564826,79,2,1322164,2350000,-1214826,1214826
2016-05-31,711,711,690,692,1202892,26,3,665817,537075,18,3,178429,1024463,487388,-487388
2016-06-01,690,701,683,686,573527,69,0,573527,0,37,2,317320,256207,256207,-256207
2016-06-05,682,691,677,680,481899,43,1,281899,200000,34,0,481899,0,-200000,200000
2016-06-06,680,682,677,679,252860,32,0,252860,0,30,0,252860,0,0,0
2016-06-07,676,681,674,674,428478,45,0,428478,0,29,1,394585,33893,33893,-33893
2016-06-08,671,703,671,695,4639927,31,1,332589,4307338,109,2,1197912,3442015,-865323,865323
2016-06-11,684,684,663,664,584028,67,0,584028,0,36,0,584028,0,0,0
2016-06-12,660,668,659,660,294828,72,1,258428,36400,21,1,206841,87987,51587,-51587
2016-06-13,658,698,650,653,7203633,104,2,1200633,6003000,113,4,3487545,3716088,-2286912,2286912
2016-06-14,654,657,652,653,344566,62,2,276843,67723,36,0,344566,0,-67723,67723
2016-06-15,652,693,645,664,5858991,106,2,1040970,4818021,116,5,2537133,3321858,-1496163,1496163
2016-06-18,678,681,650,653,361483,44,3,194916,166567,39,1,360583,900,-165667,165667
2016-06-19,653,673,648,650,170992,19,2,169282,1710,30,0,170992,0,-1710,1710
2016-06-20,652,652,640,646,427023,39,3,284801,142222,40,1,424523,2500,-139722,139722
2016-06-21,646,646,633,640,1730703,98,2,1578477,152226,37,1,361078,1369625,1217399,-1217399
2016-06-22,605,661,605,644,2673578,80,2,477226,2196352,58,3,771738,1901840,-294512,294512
2016-06-25,628,666,628,646,2665310,17,4,61495,2603815,86,3,932180,1733130,-870685,870685
2016-06-26,650,664,637,650,435276,24,2,67833,367443,32,1,221231,214045,-153398,153398
2016-06-28,662,662,643,657,578706,48,1,260832,317874,54,3,373614,205092,-112782,112782
2016-06-29,656,658,637,644,324666,37,1,215522,109144,27,2,179564,145102,35958,-35958
2016-07-02,640,651,627,640,898042,64,1,694742,203300,37,2,323005,575037,371737,-371737
2016-07-03,628,640,617,627,341841,46,1,230153,111688,28,2,231741,110100,-1588,1588
2016-07-04,615,659,615,640,4475059,41,2,245738,4229321,110,3,1503178,2971881,-1257440,1257440
2016-07-05,640,640,623,638,167482,17,2,59829,107653,27,2,154091,13391,-94262,94262
2016-07-09,638,640,622,631,232013,34,1,224057,7956,20,1,231261,752,-7204,7204
2016-07-10,622,635,619,626,413237,44,1,338552,74685,24,0,413237,0,-74685,74685
2016-07-11,622,622,610,616,532251,72,2,486861,45390,31,0,532251,0,-45390,45390
2016-07-12,622,622,604,613,482946,76,1,436916,46030,34,0,482946,0,-46030,46030
2016-07-13,604,632,598,608,3111110,45,2,297457,2813653,90,1,1111110,2000000,-813653,813653
2016-07-16,615,615,597,604,437272,71,1,326677,110595,35,0,437272,0,-110595,110595
2016-07-17,604,613,604,613,728679,43,2,362379,366300,53,0,728679,0,-366300,366300
2016-07-18,612,612,598,598,444833,34,1,210854,233979,35,1,444333,500,-233479,233479
2016-07-19,599,604,596,604,266260,31,1,138257,128003,33,0,266260,0,-128003,128003
2016-07-20,595,616,595,604,1128004,49,1,365588,762416,67,4,909161,218843,-543573,543573
2016-07-23,614,614,600,614,1278330,88,2,533002,745328,58,1,1271165,7165,-738163,738163
2016-07-24,614,614,607,614,466202,46,2,205510,260692,35,2,416122,50080,-210612,210612
2016-07-25,608,611,605,610,380166,27,1,142443,237723,39,0,380166,0,-237723,237723
2016-07-26,608,613,604,609,328725,28,1,209272,119453,24,3,156011,172714,53261,-53261
2016-07-27,608,611,600,610,636053,42,1,237389,398664,41,3,425553,210500,-188164,188164
2016-07-31,608,612,604,609,524985,29,2,187509,337476,40,2,457035,67950,-269526,269526
2016-08-01,608,611,604,608,688479,28,1,190538,497941,57,0,688479,0,-497941,497941
2016-08-02,609,611,606,608,679472,22,1,241469,438003,54,1,649472,30000,-408003,408003
2016-08-03,611,611,608,611,501180,38,1,395688,116092,39,0,511780,0,-116092,116092
2016-08-06,615,633,614,624,691671,105,1,687171,4500,83,1,637584,54087,49587,-49587
2016-08-07,624,624,613,616,662358,52,1,270450,391908,37,1,653358,9000,-382908,382908
2016-08-08,614,616,610,613,441371,39,1,161334,280037,36,1,381371,60000,-220037,220037
2016-08-09,613,614,599,604,539750,57,2,123821,415929,33,1,479750,60000,-355929,355929
2016-08-10,613,613,606,606,371772,18,2,64734,307038,43,0,371772,0,-307038,307038
2016-08-13,608,608,586,600,585463,81,2,552151,33312,37,1,575463,10000,-23312,23312
2016-08-14,594,609,593,602,340780,45,1,128610,212170,49,0,340780,0,-212170,212170
2016-08-15,594,621,585,615,1286974,75,1,303832,983142,101,1,1186974,100000,-883142,883142
2016-08-16,592,606,592,602,369502,55,2,270599,98903,23,0,369502,0,-98903,98903
2016-08-17,586,613,586,594,267795,25,1,78703,189092,40,0,267795,0,-189092,189092
2016-08-20,588,615,588,613,399746,29,1,95763,303983,66,3,383446,16300,-287683,287683
2016-08-21,592,615,591,592,1263443,64,2,365438,898005,68,1,1072687,190756,-707249,707249
2016-08-22,605,609,591,606,1193767,93,2,972144,221623,19,1,193767,1000000,778377,-778377
2016-08-23,599,612,587,612,439553,49,1,189553,250000,47,0,439553,0,-250000,250000
2016-08-24,609,609,592,604,1007461,50,1,377463,629998,32,2,421805,585656,-44342,44342
2016-08-27,593,610,592,609,938718,33,2,224429,714289,68,1,766374,172344,-541945,541945
2016-08-28,595,606,594,604,510135,27,1,145093,365042,56,0,510135,0,-365042,365042
2016-08-29,593,613,593,600,4723131,31,2,224881,4498250,83,1,1723131,3000000,-1498250,1498250
2016-08-30,597,611,596,596,530635,31,1,520635,10000,25,1,430635,100000,90000,-90000
2016-08-31,604,604,592,592,185040,37,0,185040,0,16,0,185040,0,0,0
2016-09-03,595,600,588,599,313106,25,1,242054,71052,30,0,313106,0,-71052,71052
2016-09-04,586,604,581,586,1801801,37,1,219341,1582460,88,0,1801801,0,-1582460,1582460
2016-09-05,585,592,580,591,567087,58,1,493689,73398,19,1,564587,2500,-70898,70898
2016-09-06,582,596,581,582,201194,14,1,26548,174646,24,1,164314,36880,-137766,137766
2016-09-07,584,598,581,596,831573,18,1,77124,754449,68,1,826573,5000,-749449,749449
2016-09-10,592,596,581,581,314502,23,0,314502,0,17,0,314502,0,0,0
2016-09-11,580,587,579,580,302626,41,0,302626,0,15,0,302626,0,0,0
2016-09-13,591,591,577,591,634592,48,1,433271,201321,56,0,634592,0,-201321,201321
2016-09-14,576,591,576,576,1086524,32,2,192524,894000,22,1,242524,844000,-50000,50000
2016-09-17,577,580,575,575,179337,16,0,179337,0,17,0,179337,0,0,0
2016-09-18,573,579,568,579,238104,38,1,233974,4130,22,0,238104,0,-4130,4130
2016-09-19,570,590,568,589,880299,57,1,477000,403299,78,0,880299,0,-403299,403299
2016-09-21,588,588,578,586,784484,56,1,373270,411214,57,1,748484,36000,-375214,375214
2016-09-24,584,592,572,590,755279,37,2,458858,296421,57,2,687159,68120,-228301,228301
2016-09-25,588,592,580,588,390224,37,1,177908,212316,29,1,338224,52000,-160316,160316
2016-09-26,582,598,581,598,1394605,29,2,128482,1266123,66,1,1324605,70000,-1196123,1196123
2016-09-27,599,603,590,598,362614,60,1,306929,55685,43,1,356074,6540,-49145,49145
2016-09-28,602,602,586,594,233987,42,1,135613,98374,37,0,233987,0,-98374,98374
2016-10-01,600,600,582,597,332085,24,1,67296,264789,38,0,332085,0,-264789,264789
2016-10-02,594,598,582,595,455665,23,2,82241,373424,43,0,455665,0,-373424,373424
2016-10-03,584,588,582,583,1041864,45,2,796842,245022,61,2,354986,686878,441856,-441856
2016-10-04,588,598,579,582,314403,34,1,153677,160726,40,0,314403,0,-160726,160726
2016-10-05,595,595,580,588,476875,26,1,111101,365774,38,0,476875,0,-365774,365774
2016-10-08,591,591,582,587,303412,25,1,45169,258243,31,0,303412,0,-258243,258243
2016-10-09,590,591,582,591,465870,22,1,182598,283272,31,1,415870,50000,-233272,233272
2016-10-10,581,597,580,581,849324,28,1,374526,474798,43,1,749324,100000,-374798,374798
2016-10-15,594,598,580,598,805197,47,2,284695,520502,59,0,805197,0,-520502,520502
2016-10-16,592,597,580,580,2516742,61,3,416722,2100020,39,2,446052,2070690,-29330,29330
2016-10-17,583,583,574,574,462184,80,1,462084,100,45,0,462184,0,-100,100
2016-10-18,586,596,574,586,4188804,71,5,206329,3982475,117,4,1707849,2480955,-1501520,1501520
2016-10-29,546,546,546,546,201000,1,1,1000,200000,1,1,1000,200000,0,0
2016-10-30,572,572,559,567,735868,80,0,735868,0,40,2,429371,306497,306497,-306497
2016-10-31,567,573,552,553,598616,84,2,538641,59975,33,2,182390,416226,356251,-356251
2016-11-01,554,558,533,556,675504,78,1,284388,391116,48,0,675504,0,-391116,391116
2016-11-02,552,558,537,539,271469,50,1,192151,79318,28,0,271469,0,-79318,79318
2016-11-05,539,539,528,534,387222,67,0,387222,0,32,0,387222,0,0,0
2016-11-06,534,543,522,524,292945,64,1,273945,19000,24,0,292945,0,-19000,19000
2016-11-07,525,527,522,525,475029,102,0,475029,0,35,1,474929,100,100,-100
2016-11-08,527,533,521,527,479376,80,0,479376,0,40,1,477376,2000,2000,-2000
2016-11-09,523,523,510,510,775542,109,1,725542,50000,69,0,775542,0,-50000,50000
2016-11-12,506,532,505,509,690187,51,2,282173,408014,54,0,690187,0,-408014,408014
2016-11-13,516,516,500,500,1283909,181,1,1020295,263614,51,1,1190538,93371,-170243,170243
2016-11-14,497,514,497,502,680299,45,1,255603,424696,48,1,545299,135000,-289696,289696
2016-11-15,509,514,507,507,567047,39,1,154431,412616,59,0,567047,0,-412616,412616
2016-11-16,503,514,503,514,597676,20,1,124603,473073,49,0,597676,0,-473073,473073
2016-11-19,514,516,509,512,312247,21,1,236747,75500,36,0,312247,0,-75500,75500
2016-11-21,514,516,509,514,307929,31,1,292233,28000,24,0,320233,0,-28000,28000
2016-11-22,514,515,507,510,396697,23,1,231197,165500,31,1,323937,72760,-92740,92740
2016-11-23,514,526,514,518,469737,29,2,179199,290538,54,2,465137,4600,-285938,285938
2016-11-26,526,532,521,528,357072,27,2,128126,228946,43,1,352072,5000,-223946,223946
2016-11-27,531,531,521,528,2870618,55,2,352121,2518497,38,2,440992,2429626,-88871,88871
2016-11-29,528,532,516,532,409883,35,2,399883,10000,39,1,404883,5000,-5000,5000
2016-12-03,527,527,503,507,251176,54,0,251176,0,29,0,251176,0,0,0
2016-12-04,507,524,500,501,635529,55,1,490451,145078,37,0,635529,0,-145078,145078
2016-12-05,501,512,501,501,325605,36,0,325605,0,31,0,325605,0,0,0
2016-12-06,501,521,501,519,1444617,27,2,179229,1265388,60,0,1444617,0,-1265388,1265388
2016-12-07,518,539,509,521,986429,26,1,742728,243701,89,1,983429,3000,-240701,240701
2016-12-10,538,538,509,512,269092,42,1,244287,24805,29,0,269092,0,-24805,24805
2016-12-11,527,527,504,507,3871549,21,1,129784,3741765,21,1,254286,3617263,-124502,124502
2016-12-12,507,508,501,501,292105,54,0,292105,0,18,1,278175,13930,13930,-13930
2016-12-13,501,504,500,500,114932,27,0,114932,0,18,0,114932,0,0,0
2016-12-14,497,508,495,508,296951,56,0,296951,0,23,0,296951,0,0,0
2016-12-18,503,507,493,493,320267,46,0,320267,0,26,0,320267,0,0,0
2016-12-19,497,520,495,498,678914,20,1,120117,558797,45,0,678914,0,-558797,558797
2016-12-20,503,503,487,488,305567,48,1,260008,45559,23,0,305567,0,-45559,45559
2016-12-21,497,497,488,488,154439,34,1,152218,2221,18,0,154439,0,-2221,2221
2016-12-24,487,491,484,484,211473,60,0,211473,0,30,0,211473,0,0,0
2016-12-25,482,485,480,485,777379,57,0,777379,0,44,0,777379,0,0,0
2016-12-26,476,482,473,478,441364,80,2,404179,37185,27,2,302656,138708,101523,-101523
2016-12-27,479,479,469,469,404216,42,4,253474,150742,29,1,341416,62800,-87942,87942
2016-12-28,467,473,465,467,147346,41,2,122346,25000,25,0,147346,0,-25000,25000
2016-12-31,465,482,464,468,942516,71,5,584705,357811,60,2,766216,176300,-181511,181511
2017-01-01,467,487,457,468,1229112,43,2,211256,1017856,62,3,1028836,200276,-817580,817580
2017-01-02,480,484,461,473,244884,12,1,46953,197931,42,1,228886,15998,-181933,181933
2017-01-03,479,499,465,485,1273492,16,2,30467,1243025,90,0,1273492,0,-1243025,1243025
2017-01-04,496,496,479,485,90750,11,1,36028,154922,16,0,190950,0,-154922,154922
2017-01-07,475,485,467,476,149583,28,2,118134,31449,20,1,143648,5935,-25514,25514
2017-01-08,465,474,465,465,82795,13,2,25763,57032,23,0,82795,0,-57032,57032
2017-01-09,462,476,460,465,182975,22,2,81125,101850,22,0,182975,0,-101850,101850
2017-01-11,461,485,458,467,267871,24,1,67941,199930,26,0,267871,0,-199930,199930
2017-01-14,467,473,460,468,317258,44,2,196342,120916,26,0,317258,0,-120916,120916
2017-01-15,458,503,458,485,2091134,40,2,292674,1798460,135,2,1644020,447114,-1351346,1351346
2017-01-16,483,508,483,483,529101,18,1,63447,465654,60,2,390215,138886,-326768,326768
2017-01-17,489,503,484,501,213001,27,2,191449,21552,24,0,213001,0,-21552,21552
2017-01-18,486,501,485,493,197763,17,1,175952,21811,21,1,91745,106018,84207,-84207
2017-01-21,497,497,477,477,25709,9,0,25709,0,10,1,16234,9475,9475,-9475
2017-01-22,476,476,468,468,204098,35,0,204098,0,16,0,204098,0,0,0
2017-01-23,468,472,467,470,218142,36,1,208142,10000,25,0,218142,0,-10000,10000
2017-01-24,467,495,466,467,667563,68,2,320986,346577,40,1,541625,125938,-220639,220639
2017-01-25,464,467,464,464,139134,24,2,86656,52478,15,1,81106,58028,5550,-5550
2017-01-28,464,485,464,465,316820,14,4,26408,290412,37,2,238981,77839,-212573,212573
2017-01-29,465,483,465,467,400290,20,2,41690,358600,32,2,303088,97202,-261398,261398
2017-01-30,468,475,468,469,194757,37,1,184757,10000,17,1,114857,79900,69900,-69900
2017-01-31,469,485,466,466,319404,40,3,169276,150128,53,2,300114,19290,-130838,130838
2017-02-01,478,478,466,466,220010,21,2,57874,162136,15,0,220010,0,-162136,162136
2017-02-04,464,464,462,462,182126,19,2,46937,135189,18,0,182126,0,-135189,135189
2017-02-05,464,483,461,463,563000,9,2,69854,493146,57,1,339912,223088,-270058,270058
2017-02-06,475,477,461,473,498803,22,1,83728,415075,54,0,498803,0,-415075,415075
2017-02-07,473,475,460,463,314186,31,3,212372,101814,22,2,295976,18210,-83604,83604
2017-02-08,463,463,459,461,104821,13,1,84821,20000,12,0,104821,0,-20000,20000
2017-02-11,462,470,459,469,100371,14,1,79843,20528,18,0,100371,0,-20528,20528
2017-02-12,461,471,450,450,288867,48,1,275880,12987,23,0,288867,0,-12987,12987
2017-02-13,455,464,448,454,394567,75,1,353908,40659,37,0,394567,0,-40659,40659
2017-02-14,449,491,448,491,2829264,24,2,209794,2624470,181,2,2575614,258650,-2365820,2365820
2017-02-15,475,483,469,476,259709,24,1,101030,158679,31,1,254183,5526,-153153,153153
2017-02-18,470,481,462,463,107048,19,3,54052,52996,17,0,107048,0,-52996,52996
2017-02-19,463,475,463,470,130288,14,4,44842,85446,18,0,130288,0,-85446,85446
2017-02-20,462,471,462,463,130124,14,2,79329,50795,15,0,130124,0,-50795,50795
2017-02-21,463,466,458,462,325520,25,2,104064,221456,15,1,315520,10000,-211456,211456
2017-02-22,461,467,457,458,248026,24,3,110035,137991,22,0,248026,0,-137991,137991
2017-02-25,467,467,453,453,299019,36,2,222456,76563,12,2,120870,178149,101586,-101586
2017-02-26,453,453,448,448,560845,71,3,444502,116343,22,1,368155,192690,76347,-76347
2017-02-27,452,453,446,448,126204,42,1,106995,19209,15,0,126204,0,-19209,19209
2017-02-28,452,464,441,447,350526,38,2,230526,120000,36,0,350526,0,-120000,120000
2017-03-01,445,445,439,439,531185,110,1,521185,10000,14,1,466485,64700,54700,-54700
2017-03-04,436,446,435,435,728721,80,3,316232,412489,26,3,428659,300062,-112427,112427
2017-03-05,436,461,432,446,1064787,16,2,54547,1010240,81,1,963541,101246,-908994,908994
2017-03-06,437,474,437,453,2050664,34,3,228509,1822155,132,3,1776622,274042,-1548113,1548113
2017-03-07,443,473,443,473,1036936,11,1,66936,970000,68,2,579221,457715,-512285,512285
2017-03-08,467,467,449,449,101987,29,0,101987,0,16,0,101987,0,0,0
2017-03-11,444,482,442,482,2217057,48,2,952800,1264257,71,6,711005,1506052,241795,-241795
2017-03-12,461,482,447,459,1074101,18,1,174101,900000,55,4,478748,595353,-304647,304647
2017-03-13,472,472,456,457,4711714,19,3,184353,4527361,17,2,149999,4561715,34354,-34354
2017-03-14,469,469,458,458,61765,13,1,51765,10000,11,1,57528,4237,-5763,5763
2017-03-15,458,467,458,458,136501,7,0,136501,0,7,1,84571,51930,51930,-51930
2017-03-18,457,466,457,457,165268,13,0,165268,0,15,1,84268,81000,81000,-81000
2017-03-25,467,467,458,466,27890,4,0,27890,0,10,1,7890,20000,20000,-20000
2017-03-26,458,458,458,458,9371,8,0,9371,0,8,0,9371,0,0,0
2017-03-27,466,467,457,457,112347,11,2,40899,71448,19,0,112347,0,-71448,71448
2017-03-28,461,461,458,458,51807,10,0,51807,0,12,1,49189,2618,2618,-2618
2017-03-29,457,461,457,457,106907,9,0,106907,0,8,0,106907,0,0,0
2017-04-03,457,457,457,457,7205,2,0,7205,0,5,0,7205,0,0,0
2017-04-04,468,479,461,468,4644118,23,2,84603,4559515,30,2,113775,4530343,-29172,29172
2017-04-05,473,473,461,461,235413,41,0,235413,0,19,1,230789,4624,4624,-4624
2017-04-08,461,473,457,461,193773,32,0,193773,0,19,0,193773,0,0,0
2017-04-09,461,471,458,461,281798,48,0,281798,0,20,0,281798,0,0,0
2017-04-10,461,472,456,465,649105,56,0,649105,0,50,1,638105,11000,11000,-11000
2017-04-12,463,467,462,462,152904,31,0,152904,0,23,1,149904,3000,3000,-3000
2017-04-15,462,479,462,467,901342,41,2,319524,581818,57,3,682342,219000,-362818,362818
2017-04-16,469,471,458,460,451039,47,0,451039,0,28,1,444239,6800,6800,-6800
2017-04-17,462,463,456,457,297903,37,0,297903,0,29,1,293903,4000,4000,-4000
2017-04-18,463,470,456,457,280393,32,0,280393,0,27,0,280393,0,0,0
2017-04-19,461,461,455,456,117361,25,0,117361,0,19,0,117361,0,0,0
2017-04-22,470,470,456,462,405458,46,0,405458,0,46,0,405458,0,0,0
2017-04-23,463,463,456,457,242032,41,0,242032,0,21,0,242032,0,0,0
2017-04-24,456,463,456,457,206393,27,1,202365,4028,25,0,206393,0,-4028,4028
2017-04-26,456,461,455,457,307966,30,0,307966,0,24,0,307966,0,0,0
2017-04-29,457,457,454,455,318098,37,1,298098,20000,24,0,318098,0,-20000,20000
2017-04-30,454,455,453,455,241577,31,0,241577,0,21,0,241577,0,0,0
2017-05-01,455,483,446,474,3154532,88,0,3154532,0,122,3,2332065,822467,822467,-822467
2017-05-02,467,480,467,477,798169,73,0,798169,0,74,1,685967,112202,112202,-112202
2017-05-03,479,479,468,470,207863,37,0,207863,0,37,0,207863,0,0,0
2017-05-06,467,473,464,467,332998,39,1,325298,7700,26,1,316140,16858,9158,-9158
2017-05-07,466,470,455,455,365333,52,1,265333,100000,24,1,362333,3000,-97000,97000
2017-05-08,457,457,455,456,260018,27,0,260018,0,17,0,260018,0,0,0
2017-05-09,457,479,450,455,1740709,43,1,438709,1302000,77,2,1637720,102989,-1199011,1199011
2017-05-10,463,463,455,455,132883,21,0,132883,0,12,0,132883,0,0,0
2017-05-13,461,461,451,451,265217,37,1,264217,1000,13,0,265217,0,-1000,1000
2017-05-14,455,467,450,450,209327,18,1,190327,19000,20,0,209327,0,-19000,19000
2017-05-15,464,465,455,462,32341,4,2,30340,2001,15,0,32341,0,-2001,2001
2017-05-16,453,461,453,461,125331,12,2,104212,21119,17,0,125331,0,-21119,21119
2017-05-17,463,478,455,460,1031705,22,2,263888,767817,65,2,911705,120000,-647817,647817
2017-05-20,467,467,461,461,273284,19,1,173284,100000,16,0,273284,0,-100000,100000
2017-05-21,462,489,462,489,3150633,53,3,2580633,570000,160,2,2665633,485000,-85000,85000
2017-05-22,502,502,494,502,3552878,89,1,3052878,500000,68,3,1536878,2016000,1516000,-1516000
2017-05-23,512,519,503,504,2723337,176,3,2233337,490000,108,4,2561020,162317,-327683,327683
2017-05-24,509,509,491,491,958515,72,1,858515,100000,47,2,728515,230000,130000,-130000
2017-05-27,486,495,479,479,809709,72,0,809709,0,51,0,809709,0,0,0
2017-05-28,479,485,472,473,419833,59,0,419833,0,49,0,419833,0,0,0
2017-05-29,473,509,469,493,1399425,39,5,283929,1115496,107,0,1399425,0,-1115496,1115496
2017-05-30,485,496,473,474,390731,36,2,177119,213612,32,1,369151,21580,-192032,192032
2017-05-31,479,483,472,473,520273,51,1,420273,100000,25,0,520273,0,-100000,100000
2017-06-03,471,478,471,478,296627,26,2,193043,103584,22,1,271627,25000,-78584,78584
2017-06-06,478,485,471,471,193404,30,0,193404,0,24,1,186047,7357,7357,-7357
2017-06-07,484,497,465,473,986759,25,1,286759,700000,56,0,986759,0,-700000,700000
2017-06-10,485,495,470,490,593047,10,2,41847,551200,37,1,558460,34587,-516613,516613
2017-06-11,487,496,473,477,628159,12,2,72859,555300,48,1,615643,12516,-542784,542784
2017-06-12,491,491,473,484,307780,18,2,96303,211477,31,0,307780,0,-211477,211477
2017-06-13,473,490,472,473,74694,17,1,64694,10000,18,0,74694,0,-10000,10000
2017-06-14,473,490,463,466,2308867,104,3,1502524,806343,35,0,2308867,0,-806343,806343
2017-06-17,466,478,449,466,857393,103,1,796193,61200,28,0,857393,0,-61200,61200
2017-06-18,467,467,443,449,529908,105,1,520908,9000,20,0,529908,0,-9000,9000
2017-06-19,456,456,439,439,547941,83,3,437941,110000,17,0,547941,0,-110000,110000
2017-06-20,435,454,435,436,1047166,98,1,775541,271625,42,1,947166,100000,-171625,171625
2017-06-21,436,452,434,436,191942,20,1,76942,115000,31,1,184664,7278,-107722,107722
2017-06-24,436,439,428,431,271194,53,0,271194,0,16,0,271194,0,0,0
2017-06-25,428,436,428,430,208426,20,0,208426,0,14,0,208426,0,0,0
2017-06-28,430,437,428,436,71837,23,1,65233,6604,18,0,71837,0,-6604,6604
2017-07-01,430,436,427,433,128459,22,1,77599,50860,31,0,128459,0,-50860,50860
2017-07-02,433,433,423,426,357206,61,2,270557,86649,26,0,357206,0,-86649,86649
2017-07-03,424,451,421,428,931297,53,3,183797,747500,78,1,738933,192364,-555136,555136
2017-07-04,445,445,427,428,166912,38,2,151912,15000,15,0,166912,0,-15000,15000
2017-07-05,436,436,418,418,873463,104,1,693759,179704,18,0,873463,0,-179704,179704
2017-07-23,423,434,423,424,452926,50,2,446876,6050,28,2,415077,37849,31799,-31799
2017-07-24,419,423,412,414,583125,59,2,266529,316596,39,1,549125,34000,-282596,282596
2017-07-25,412,417,410,410,571176,62,1,371176,200000,38,1,476684,94492,-105508,105508
2017-07-26,410,415,406,410,602375,34,3,313776,288599,53,2,496033,106342,-182257,182257
2017-07-29,412,412,399,401,761543,77,4,420589,340954,35,0,761543,0,-340954,340954
2017-07-30,400,400,394,394,703674,136,3,678659,25015,39,1,695974,7700,-17315,17315
2017-07-31,390,396,389,389,525392,85,3,456671,68721,25,0,525392,0,-68721,68721
2017-08-01,386,397,386,389,1530397,170,6,1122920,407477,52,3,1457137,73260,-334217,334217
2017-08-02,388,412,383,404,893739,55,2,292639,601100,91,3,642739,251000,-350100,350100
2017-08-06,400,406,394,400,658594,63,2,330093,328501,54,0,658594,0,-328501,328501
2017-08-07,398,418,390,418,2785126,91,2,1990057,795069,172,1,2497323,287803,-507266,507266
2017-08-08,421,432,419,432,3671129,115,3,2865631,805498,159,5,1991129,1680000,874502,-874502
2017-08-09,432,453,430,453,3510713,70,2,877927,2632786,221,3,2760713,750000,-1882786,1882786
2017-08-12,451,469,451,469,5141380,99,3,1069394,4071986,196,5,3320676,1820704,-2251282,2251282
2017-08-13,473,484,472,475,2204254,70,2,814750,1389504,137,5,1389596,814658,-574846,574846
2017-08-14,479,491,473,486,7788127,69,2,686219,7101908,150,6,1830143,5957984,-1143924,1143924
2017-08-15,473,479,468,468,1763622,33,2,585012,1178610,116,2,1463622,300000,-878610,878610
2017-08-16,473,485,472,485,2153206,14,3,111690,2041516,124,2,1653206,500000,-1541516,1541516
2017-08-19,491,491,481,488,2538680,10,2,59467,2479213,67,2,1146733,1391947,-1087266,1087266
2017-08-20,486,489,480,485,2115078,8,3,19897,2095181,68,6,1017731,1097347,-997834,997834
2017-08-21,485,511,484,497,5095554,29,2,181023,4914531,153,4,2248722,2846832,-2067699,2067699
2017-08-22,502,516,498,506,2672621,34,2,545381,2127240,72,5,508784,2163837,36597,-36597
2017-08-23,509,518,506,506,1043337,16,1,151427,891910,38,4,415783,627554,-264356,264356
2017-08-26,510,510,502,505,1147443,8,2,52867,1094576,32,5,354260,793183,-301393,301393
2017-08-27,507,507,485,491,2883325,19,2,223299,2660026,69,5,1491946,1391379,-1268647,1268647
2017-08-28,496,503,491,497,1443751,10,2,84039,1359712,36,2,632557,811194,-548518,548518
2017-08-30,496,496,490,495,931645,4,2,3800,927845,43,1,431645,500000,-427845,427845
2017-09-02,496,497,485,488,1020679,12,2,43679,977000,27,2,201613,819066,-157934,157934
2017-09-03,494,494,483,486,1085450,9,2,111450,974000,43,2,279012,806438,-167562,167562
2017-09-04,492,493,468,472,1681330,46,5,244727,1436603,36,2,962919,718411,-718192,718192
2017-09-05,484,491,462,483,2147891,14,3,64812,2083079,50,2,780145,1367746,-715333,715333
2017-09-06,485,493,479,484,1540639,5,2,27247,1513392,28,2,390650,1149989,-363403,363403
2017-09-10,485,490,466,484,1023901,10,2,48918,974983,14,2,199691,824210,-150773,150773
2017-09-11,485,485,473,481,252825,3,2,100940,151885,19,1,153983,98842,-53043,53043
2017-09-12,483,483,476,480,249642,1,2,20000,229642,36,0,249642,0,-229642,229642
2017-09-13,484,484,473,474,209291,5,2,16075,193216,40,1,209251,40,-193176,193176
2017-09-16,485,485,462,473,478032,32,2,275074,202958,21,2,293665,184367,-18591,18591
2017-09-17,480,502,478,497,6249997,21,3,93355,6156642,100,6,1290927,4959070,-1197572,1197572
2017-09-18,491,509,491,497,3358914,16,3,131459,3227455,46,4,656602,2702312,-525143,525143
2017-09-19,504,509,502,506,1828686,7,2,28065,1800621,36,2,187012,1641674,-158947,158947
2017-09-20,509,509,497,504,731691,7,2,89281,642410,28,3,142983,588708,-53702,53702
2017-09-23,505,514,497,514,833174,5,2,32613,800561,76,0,833174,0,-800561,800561
2017-09-24,506,509,504,508,252890,10,2,53122,199768,28,0,252890,0,-199768,199768
2017-09-25,506,509,503,506,287549,1,2,1193,286356,23,1,257549,30000,-256356,256356
2017-09-26,506,515,501,509,286825,4,2,2220,284605,29,0,286825,0,-284605,284605
2017-09-27,509,527,497,508,1284878,26,4,312896,971982,94,0,1284878,0,-971982,971982
2017-10-02,526,533,518,532,954961,15,2,43282,911679,93,1,876742,78219,-833460,833460
2017-10-03,521,543,521,536,786877,32,2,87940,698937,85,1,686633,100244,-598693,598693
2017-10-04,526,529,525,527,333773,28,1,57857,275916,22,0,333773,0,-275916,275916
2017-10-07,523,533,521,521,307382,15,1,49585,257797,26,0,307382,0,-257797,257797
2017-10-08,530,530,502,508,447158,16,2,114519,332639,32,0,447158,0,-332639,332639
2017-10-09,520,520,496,502,440534,23,2,132951,307583,47,0,440534,0,-307583,307583
2017-10-10,515,535,509,519,768029,11,2,25608,742421,39,0,768029,0,-742421,742421
2017-10-11,519,521,504,507,239176,6,1,69766,169410,22,0,239176,0,-169410,169410
2017-10-14,519,524,513,513,1370567,11,2,23458,1347109,29,1,500907,869660,-477449,477449
2017-10-15,521,521,518,518,288562,10,2,206540,82022,22,1,210684,77878,-4144,4144
2017-10-16,518,521,516,521,376003,7,2,233560,142443,43,0,376003,0,-142443,142443
2017-10-17,519,521,493,495,754676,20,2,221376,533300,50,0,754676,0,-533300,533300
2017-10-25,522,522,516,519,693940,4,3,6639,687301,25,1,543940,150000,-537301,537301
2017-10-28,520,527,510,513,206825,4,2,1442,205383,20,1,191295,15530,-189853,189853
2017-10-29,519,521,515,521,669759,1,2,1000,668759,29,1,519759,150000,-518759,518759
2017-10-30,519,528,518,519,792987,4,2,2614,790373,22,2,286356,506631,-283742,283742
2017-10-31,521,521,507,514,76417,8,1,55897,20520,13,1,19052,57365,36845,-36845
2017-11-01,515,521,494,509,240100,19,2,35493,204607,26,1,140100,100000,-104607,104607
2017-11-04,494,509,494,503,433130,30,4,141166,291964,14,0,433130,0,-291964,291964
2017-11-05,503,503,490,490,635651,47,3,395651,240000,20,0,635651,0,-240000,240000
2017-11-06,485,495,484,485,362051,20,2,82446,279605,29,2,282466,79585,-200020,200020
2017-11-07,489,489,480,482,356084,30,2,57025,299059,18,1,314595,41489,-257570,257570
2017-11-08,477,484,477,484,171188,17,1,53748,117440,19,1,162677,8511,-108929,108929
2017-11-11,477,484,476,484,137095,10,2,22032,115063,17,0,137095,0,-115063,115063
2017-11-12,484,484,474,481,126332,12,5,19043,107289,10,0,126332,0,-107289,107289
2017-11-13,481,481,473,478,94001,6,2,46786,47215,11,0,94001,0,-47215,47215
2017-11-14,473,484,473,475,145304,8,2,18025,127279,8,0,145304,0,-127279,127279
2017-11-15,474,484,471,471,265936,20,3,70780,195156,18,0,265936,0,-195156,195156
2017-11-18,477,482,469,482,94865,5,2,12341,82524,12,0,94865,0,-82524,82524
2017-11-20,482,485,472,472,33286,1,2,478,32808,16,0,33286,0,-32808,32808
2017-11-21,470,484,468,468,269529,19,3,67289,203940,15,0,271229,0,-203940,203940
2017-11-22,467,505,467,505,671937,7,2,24903,647034,54,0,671937,0,-647034,647034
2017-11-25,498,503,490,497,759536,13,2,25544,733992,23,1,234022,525514,-208478,208478
2017-11-26,497,497,492,497,202098,7,1,13125,188973,20,2,198370,3728,-185245,185245
2017-11-28,494,497,492,496,280108,5,1,4881,275227,21,2,200098,80010,-195217,195217
2017-11-29,494,497,490,490,250835,5,1,71355,179480,21,0,250835,0,-179480,179480
2017-12-02,493,495,492,494,253495,1,1,1247,252248,16,1,206495,47000,-205248,205248
2017-12-03,494,496,490,493,388412,2,1,3000,385412,26,0,388412,0,-385412,385412
2017-12-04,493,495,484,494,560308,3,1,9053,551255,22,0,560308,0,-551255,551255
2017-12-05,494,516,488,509,1390454,6,2,44980,1352954,75,3,1097934,300000,-1052954,1052954
2017-12-09,498,511,497,497,199455,7,1,29950,169505,16,1,199255,200,-169305,169305
2017-12-10,497,500,493,500,596430,10,1,61925,534505,33,0,596430,0,-534505,534505
2017-12-11,500,501,497,499,382092,3,1,10986,371106,15,1,374489,7603,-363503,363503
2017-12-12,500,507,482,498,542208,8,1,36730,505478,24,1,312208,230000,-275478,275478
2017-12-13,494,494,477,477,163612,35,0,163612,0,11,1,36343,127269,127269,-127269
2017-12-16,473,503,473,496,663767,6,1,39775,623992,27,1,555974,107793,-516199,516199
2017-12-17,497,497,474,484,157111,17,2,81761,75350,9,1,125876,31235,-44115,44115
2017-12-18,478,506,472,506,693637,19,1,58079,635558,56,2,556481,137156,-498402,498402
2017-12-19,505,505,478,494,173486,26,1,124986,48500,14,1,51986,121500,73000,-73000
2017-12-20,494,503,476,488,970300,25,3,166450,318700,25,2,384150,101000,-217700,217700
2017-12-23,477,501,477,497,492237,5,1,11002,481235,36,2,362237,130000,-351235,351235
2017-12-24,495,503,494,495,304443,6,1,10324,294119,30,1,204145,100298,-193821,193821
2017-12-25,500,500,470,470,585740,1,1,2500,282173,10,1,184671,100002,-182171,182171
2017-12-26,493,493,468,468,291674,61,2,245327,51820,11,0,297147,0,-51820,51820
2017-12-27,490,490,469,475,170227,20,1,165527,4700,13,2,163527,6700,2000,-2000
2017-12-30,466,472,465,465,153365,35,1,133365,20000,9,0,153365,0,-20000,20000
2017-12-31,474,474,464,472,136400,11,2,14682,121718,13,0,136400,0,-121718,121718
2018-01-01,462,471,462,471,138496,30,1,109064,29432,11,0,138496,0,-29432,29432
2018-01-02,463,469,461,469,90369,19,2,22957,67412,14,1,85869,4500,-62912,62912
2018-01-03,461,468,461,468,379010,12,2,19759,169746,9,1,107614,81891,-87855,87855
2018-01-06,459,468,459,459,322176,29,1,294947,27229,13,0,322176,0,-27229,27229
2018-01-07,459,459,456,459,188586,33,1,90571,98015,7,0,188586,0,-98015,98015
2018-01-08,459,466,454,466,143498,24,1,80749,62749,19,0,143498,0,-62749,62749
2018-01-09,461,462,453,462,157704,23,3,46201,111503,11,0,157704,0,-111503,111503
2018-01-10,454,460,454,460,151074,3,2,12394,138680,11,0,151074,0,-138680,138680
2018-01-13,452,459,451,458,123369,25,2,94670,28699,10,0,123369,0,-28699,28699
2018-01-14,452,465,452,465,137472,2,2,30249,107223,18,0,137472,0,-107223,107223
2018-01-15,462,465,457,459,35918,6,2,20964,14954,12,0,35918,0,-14954,14954
2018-01-16,467,471,454,457,21881,8,2,14770,7111,13,0,21881,0,-7111,7111
2018-01-17,459,464,450,464,25500,8,1,21228,4272,4,0,25500,0,-4272,4272
2018-01-20,453,464,449,455,188805,26,1,118240,70565,12,0,188805,0,-70565,70565
2018-01-21,459,462,447,454,186830,6,2,12267,174563,16,1,175230,11600,-162963,162963
2018-01-22,448,461,446,447,509326,35,3,229062,280264,15,0,509326,0,-280264,280264
2018-01-23,451,451,444,449,23910,9,2,8443,15467,5,0,23910,0,-15467,15467
2018-01-24,447,447,442,442,164076,29,2,127727,36349,16,0,164076,0,-36349,36349
2018-01-27,443,447,441,447,139794,16,1,75420,64374,11,0,139794,0,-64374,64374
2018-01-28,449,449,439,446,131643,21,1,87396,44247,11,0,131643,0,-44247,44247
2018-01-29,445,445,438,438,52622,9,1,25792,26830,7,0,52622,0,-26830,26830
2018-01-30,443,445,438,438,136806,6,1,13740,123066,11,0,136806,0,-123066,123066
2018-01-31,442,445,437,437,75633,12,1,28788,46845,15,0,75633,0,-46845,46845
2018-02-03,441,445,436,436,291778,32,1,262850,28928,12,1,218414,73364,44436,-44436
2018-02-04,434,436,434,436,215036,36,2,162536,52500,20,0,215036,0,-52500,52500
2018-02-05,436,441,432,439,195184,35,1,186684,8500,19,0,195184,0,-8500,8500
2018-02-06,435,469,433,466,296660,7,1,22604,274056,43,0,296660,0,-274056,274056
2018-02-07,456,459,453,456,166954,6,1,88650,78304,19,1,141249,25705,-52599,52599
2018-02-10,459,459,447,453,85137,5,1,9489,75648,11,1,64241,20896,-54752,54752
2018-02-12,453,453,447,447,91296,2,1,15500,75796,13,1,76134,15162,-60634,60634
2018-02-13,447,447,442,445,60508,3,1,7806,52702,10,1,26968,33540,-19162,19162
2018-02-14,444,444,439,441,136061,12,1,18721,117340,10,2,118631,17430,-99910,99910
2018-02-17,444,444,435,435,140146,7,1,79037,61109,9,1,83364,56782,-4327,4327
2018-02-18,439,441,430,432,155301,26,1,75301,80000,5,0,155301,0,-80000,80000
2018-02-19,441,441,439,441,68216,6,1,38483,29733,11,0,68216,0,-29733,29733
2018-02-21,441,441,433,433,71366,5,1,24592,46774,12,0,71366,0,-46774,46774
2018-02-24,439,439,430,436,365122,13,1,224467,140655,15,0,365122,0,-140655,140655
2018-02-25,437,453,431,450,1079306,8,1,440338,638968,27,0,1079306,0,-638968,638968
2018-02-26,447,447,438,438,49123,9,1,9123,40000,7,0,49123,0,-40000,40000
2018-02-27,441,441,428,428,80442,5,1,13800,66642,15,0,80442,0,-66642,66642
2018-02-28,439,440,427,428,207611,16,1,86893,120718,15,0,207611,0,-120718,120718
2018-03-03,435,435,422,435,290666,7,1,128544,162122,22,1,252266,38400,-123722,123722
2018-03-04,435,465,435,461,1069011,9,3,60066,1008945,70,1,925227,143784,-865161,865161
2018-03-05,459,459,451,458,760619,8,3,55615,705004,17,4,177744,582875,-122129,122129
2018-03-06,462,463,453,459,643706,9,4,39092,604614,39,2,254678,389028,-215586,215586
2018-03-07,459,474,456,461,611135,8,1,95708,515427,39,5,104479,506656,-8771,8771
2018-03-10,459,459,453,459,597069,12,2,83505,513564,9,3,261305,335764,-177800,177800
2018-03-11,459,459,456,459,82387,1,1,500,81887,9,2,13046,69341,-12546,12546
2018-03-12,458,458,437,447,85239,7,1,31599,53640,11,1,34129,51110,-2530,2530
2018-03-13,451,452,437,449,164008,5,2,23145,140863,16,0,164008,0,-140863,140863
2018-03-14,465,477,434,465,1454946,6,1,52826,1402120,37,4,430669,1024277,-377843,377843
2018-03-17,459,477,441,453,167322,10,1,42273,125049,13,2,59261,108061,-16988,16988
2018-03-18,468,468,462,463,2705031,1,2,1330,2703701,7,3,15201,2689830,-13871,13871
2018-03-19,442,459,442,458,5112,3,1,4112,1000,5,1,4112,1000,0,0
2018-03-25,458,458,442,442,35287,15,0,35287,0,2,0,35287,0,0,0
2018-03-26,442,442,442,442,285,1,0,285,0,2,0,285,0,0,0
2018-03-27,442,442,442,442,30000,11,0,30000,0,1,0,30000,0,0,0
2018-03-28,441,442,441,442,63577,15,0,63577,0,7,0,63577,0,0,0
2018-04-03,441,442,441,441,59734,14,0,59734,0,6,0,59734,0,0,0
2018-04-04,440,440,440,440,4342,6,0,4342,0,2,1,2000,2342,2342,-2342
2018-04-07,440,440,440,440,10857,6,0,10857,0,0,1,0,10857,10857,-10857
2018-04-08,440,440,440,440,15000,1,1,1400,13600,0,1,0,15000,1400,-1400
2018-04-09,440,440,440,440,92956,5,1,35956,57000,1,1,90000,2956,-54044,54044
2018-04-10,439,439,439,439,13185,2,1,685,12500,0,1,0,13185,685,-685
2018-04-11,439,439,439,439,41000,1,1,2000,39000,2,0,41000,0,-39000,39000
2018-04-15,439,439,439,439,11076,1,1,290,10786,1,0,11076,0,-10786,10786
2018-04-16,439,439,439,439,52000,0,1,0,52000,3,0,52000,0,-52000,52000
2018-04-17,438,438,438,438,54937,4,1,4937,50000,1,0,54937,0,-50000,50000
2018-04-18,438,438,438,438,50424,2,1,424,50000,7,0,50424,0,-50000,50000
2018-04-21,458,458,435,435,1337078,10,2,14578,1322500,28,5,362662,974416,-348084,348084
2018-04-22,435,435,435,435,60000,1,1,304,59696,1,0,60000,0,-59696,59696
2018-04-23,434,434,434,434,53342,4,1,11342,42000,3,0,53342,0,-42000,42000
2018-04-24,434,434,434,434,30290,1,1,290,30000,0,1,0,30290,290,-290
2018-04-25,434,434,434,434,911300,1,3,300,911000,0,2,0,911300,300,-300
2018-04-28,426,426,426,426,979173,1,2,2905,976268,11,2,275173,704000,-272268,272268
2018-04-29,420,426,419,422,1723247,17,5,161017,1562230,30,2,731197,992050,-570180,570180
2018-04-30,434,436,426,428,1720165,2,5,4300,1715865,27,3,713874,1006291,-709574,709574
2018-05-01,435,435,416,429,549232,3,2,10324,538908,14,3,89574,459658,-79250,79250
2018-05-05,433,433,417,429,202954,2,1,3300,199654,6,2,29026,173928,-25726,25726
2018-05-06,422,429,411,429,911068,2,3,15000,896068,20,3,207411,703657,-192411,192411
2018-05-07,433,433,410,417,293468,12,2,52641,240827,10,2,126099,167369,-73458,73458
2018-05-08,427,449,410,443,1979235,7,2,115764,1863471,29,4,537574,1441661,-421810,421810
2018-05-09,436,441,420,435,2991014,4,4,8945,2982069,23,4,430891,2560123,-421946,421946
2018-05-12,446,446,420,431,711730,2,3,5200,706530,12,2,317167,394563,-311967,311967
2018-05-13,433,435,409,432,2681491,12,2,59481,2622010,14,4,352090,2329401,-292609,292609
2018-05-14,431,442,428,430,361377,3,1,28500,332877,11,2,42251,319126,-13751,13751
2018-05-15,435,440,426,431,1161013,3,1,6930,1154083,5,3,20400,1140613,-13470,13470
2018-05-16,433,438,416,438,612482,6,1,47669,564813,14,2,192839,419643,-145170,145170
2018-05-19,432,438,430,437,485180,5,1,18032,467148,17,2,146430,338750,-128398,128398
2018-05-20,436,436,430,431,522324,0,1,0,522324,16,2,325719,196605,-325719,325719
2018-05-21,431,435,416,435,295736,2,1,7700,288036,19,2,218715,77021,-211015,211015
2018-05-22,435,435,431,433,342182,1,1,5000,337182,14,0,342182,0,-337182,337182
2018-05-23,434,434,431,433,232406,2,1,10947,221459,14,0,232406,0,-221459,221459
2018-05-26,435,447,432,440,321461,5,1,10436,311025,24,0,321461,0,-311025,311025
2018-05-27,442,442,432,439,381283,2,1,1776,379507,12,1,181283,200000,-179507,179507
2018-05-28,437,441,435,441,349076,2,1,802,348274,15,0,349076,0,-348274,348274
2018-05-29,438,441,434,439,583616,4,1,22837,560779,20,1,383616,200000,-360779,360779
2018-05-30,439,441,435,440,337676,2,1,1411,336265,10,1,137676,200000,-136265,136265
2018-06-02,441,452,435,451,2322047,0,0,0,0,0,0,0,0,0,0
2018-06-03,451,452,435,443,420947,7,1,63984,356963,25,1,274001,146946,-210017,210017
2018-06-09,442,451,440,447,298562,3,1,32512,266050,23,0,298562,0,-266050,266050
2018-06-10,447,451,445,449,357550,2,1,82550,275000,24,0,357550,0,-275000,275000
2018-06-11,448,448,422,442,210663,6,1,24663,186000,17,1,148885,61778,-124222,124222
2018-06-12,442,447,435,446,237831,4,1,13831,224000,16,0,237831,0,-224000,224000
2018-06-13,443,448,435,443,190277,14,1,49937,140340,15,2,167790,22487,-117853,117853
2018-06-17,447,449,441,447,331545,5,1,181082,150463,14,3,178453,153092,2629,-2629
2018-06-18,447,459,436,441,701983,16,1,461183,240800,30,2,459240,242743,1943,-1943
2018-06-19,444,452,435,446,149592,10,1,53592,96000,16,1,98906,50686,-45314,45314
2018-06-20,447,447,421,442,816720,25,1,133915,682805,24,1,590085,226635,-456170,456170
2018-06-23,444,444,439,443,569441,7,1,55784,513657,27,2,363353,206088,-307569,307569
2018-06-24,443,449,435,442,739517,14,1,93397,646000,35,3,567899,171498,-474502,474502
2018-06-25,444,447,434,442,830439,12,1,74939,755500,28,2,295785,534654,-220846,220846
2018-06-26,443,444,420,433,261391,13,1,54718,206673,10,1,169286,92105,-114568,114568
2018-06-27,434,441,428,430,446612,5,1,142878,303734,13,1,345202,101410,-202324,202324
2018-06-30,441,441,419,419,116446,0,0,0,0,0,0,0,0,0,0
2018-07-01,438,438,418,422,562857,14,1,97557,465300,23,2,264694,298163,-167137,167137
2018-07-02,422,460,422,460,2941406,3,3,3249,2938157,87,1,1884421,1056985,-1881172,1881172
2018-07-03,453,458,437,447,426651,17,1,100651,326000,26,2,186048,240603,-85397,85397
2018-07-04,447,459,438,447,506011,7,2,20761,485250,27,3,361811,144200,-341050,341050
2018-07-07,447,458,430,435,252384,20,1,125518,126866,15,2,54205,198179,71313,-71313
2018-07-08,445,445,421,421,638068,45,1,547568,90500,9,2,146138,491930,401430,-401430
2018-07-10,441,441,417,417,363743,23,2,282643,81100,20,3,150245,213498,132398,-132398
2018-07-11,415,415,415,415,46950,8,0,46950,0,6,0,46950,0,0,0
2018-07-14,415,415,415,415,18761,8,0,18761,0,1,0,18761,0,0,0
2018-07-15,415,415,415,415,6956,7,0,6956,0,1,0,6956,0,0,0
2018-07-16,415,415,415,415,3740,5,0,3740,0,1,0,3740,0,0,0
2018-07-17,415,415,415,415,800,2,0,800,0,1,0,800,0,0,0
2018-07-18,415,415,415,415,1000,1,0,1000,0,1,0,1000,0,0,0
2018-07-21,415,435,415,432,1264518,4,1,3300,1261218,43,1,1172698,91820,-1169398,1169398
2018-07-22,434,434,406,406,423871,41,0,423871,0,14,1,311169,112702,112702,-112702
2018-07-23,425,446,410,443,1899586,0,0,0,0,0,0,0,0,0,0
2018-07-24,428,441,408,441,2408148,17,1,228328,2179820,40,3,869690,1538458,-641362,641362
2018-07-25,428,428,406,406,509860,37,0,509860,0,11,1,227263,282597,282597,-282597
2018-07-28,410,441,400,416,2414193,36,1,314193,2100000,60,2,1254193,1160000,-940000,940000
2018-07-29,422,422,403,415,1029117,33,1,800617,228500,16,3,596427,432690,204190,-204190
2018-07-30,403,421,397,409,914352,28,1,145951,768401,42,3,440652,473700,-294701,294701
2018-07-31,399,402,396,400,1167272,77,3,1067412,99860,16,2,287272,880000,780140,-780140
2018-08-01,401,413,399,405,1437317,16,1,71129,1366188,42,3,467566,969751,-396437,396437
2018-08-04,408,413,399,400,1562240,15,1,85472,1476768,34,4,726155,836085,-640683,640683
2018-08-05,407,412,397,406,1796937,22,1,269263,1527674,31,3,344785,1452152,-75522,75522
2018-08-06,429,429,400,401,937975,15,1,82065,855910,44,2,679050,258925,-596985,596985
2018-08-07,428,428,405,416,954839,10,1,59701,895138,45,2,474839,480000,-415138,415138
2018-08-08,416,421,406,417,1850467,9,1,161484,1688983,27,4,438234,1412233,-276750,276750
2018-08-11,421,428,407,419,2921216,19,1,203214,2718002,36,3,387638,2533578,-184424,184424
2018-08-12,422,423,410,412,79447,15,1,40130,39317,11,2,40001,39446,129,-129
2018-08-13,410,415,409,409,138732,17,0,138732,0,10,1,133350,5382,5382,-5382
2018-08-14,417,423,406,408,1397791,26,1,487063,910728,27,2,489707,908084,-2644,2644
2018-08-15,407,408,401,408,95444,20,0,95444,0,11,0,95444,0,0,0
2018-08-18,405,414,400,405,221560,33,0,221560,0,13,0,221560,0,0,0
2018-08-19,416,416,397,397,1527144,101,1,1507324,19820,16,1,431382,1095762,1075942,-1075942
2018-08-20,406,406,394,399,290983,34,1,271333,19650,13,1,193813,97170,77520,-77520
2018-08-21,410,412,403,408,1669378,23,1,174337,1495041,59,3,712579,956799,-538242,538242
2018-08-25,413,413,406,410,562164,26,1,195520,366644,37,2,368517,193647,-172997,172997
2018-08-26,410,413,409,410,1086430,51,1,943236,143194,32,4,205009,881421,738227,-738227
2018-08-27,411,413,401,401,1154506,21,1,600502,50990,3,2,201688,449804,398814,-398814
2018-08-28,410,410,402,407,231519,26,1,211681,19838,21,2,212801,18718,-1120,1120
2018-08-29,410,410,400,407,494674,42,1,468174,26500,24,2,302816,191858,165358,-165358
2018-09-01,412,429,411,429,7546953,182,1,7188133,358820,128,4,2787395,4759558,4400738,-4400738
2018-09-02,447,447,435,447,9795465,422,1,9545465,250000,200,4,3827970,5967495,5717495,-5717495
2018-09-03,453,453,425,428,1528523,185,1,1478523,50000,95,0,1528523,0,-50000,50000
2018-09-04,438,438,419,421,2981634,250,1,2970464,11170,123,0,2981634,0,-11170,11170
2018-09-05,415,434,410,415,3088939,151,1,3081809,7130,81,3,1265168,1823771,1816641,-1816641
2018-09-08,413,438,413,430,6760324,266,13,5692287,1068037,133,2,1634659,5125665,4057628,-4057628
2018-09-09,432,448,432,448,5681973,302,13,4564973,1117000,182,4,2587221,3094752,1977752,-1977752
2018-09-10,457,457,434,439,5201437,284,0,5201437,0,124,3,2036161,3165276,3165276,-3165276
2018-09-11,441,448,427,432,4733021,202,1,4690591,42430,124,2,3912111,820910,778480,-778480
2018-09-12,439,454,437,452,9650563,445,4,6847517,2803046,218,6,4485344,5165219,2362173,-2362173
2018-09-15,473,473,469,473,15703865,393,5,12453865,3250000,179,5,4091865,11612000,8362000,-8362000
2018-09-16,485,492,453,479,7048463,343,2,6348463,700000,220,2,4283688,2764775,2064775,-2064775
2018-09-17,483,483,462,472,7697549,430,2,7602549,95000,206,3,4408236,3289313,3194313,-3194313
2018-09-18,474,497,472,479,12537201,466,2,11437201,1100000,234,3,4645600,7891601,6791601,-6791601
2018-09-22,502,510,501,510,30397116,626,3,25997116,4400000,173,5,3047116,27350000,22950000,-22950000
2018-09-23,535,535,535,535,68196719,784,8,60444719,7752000,88,6,1901348,66295371,58543371,-58543371
2018-09-24,562,562,562,562,73819075,457,15,56419075,17400000,54,6,569070,73250005,55850005,-55850005
2018-09-25,590,590,590,590,6902714,65,7,5997733,904981,17,2,502714,6400000,5495019,-5495019
2018-09-26,619,649,617,639,114149259,1928,33,78165311,35983948,685,23,47396357,66752902,30768954,-30768954
2018-09-29,657,657,647,652,6174928,179,2,4062928,2112000,91,2,5540219,634709,-1477291,1477291
2018-10-01,688,721,654,654,64974701,770,15,46254701,18720000,406,7,21765958,43208743,24488743,-24488743
2018-10-02,638,638,638,638,4148500,102,2,948500,3200000,54,0,4148500,0,-3200000,3200000
2018-10-03,606,606,606,606,2599857,101,1,599857,2000000,16,0,2599857,0,-2000000,2000000
2018-10-06,576,632,576,576,59246368,1326,6,38196411,21049957,844,22,47869637,11376731,-9673226,9673226
2018-10-07,565,576,565,565,33011686,577,8,23736995,9274691,669,4,29424395,3587291,-5687400,5687400
2018-10-08,551,555,537,544,20689410,529,7,15190441,5498969,632,2,20484719,204691,-5294278,5294278
2018-10-09,567,568,528,539,26542468,969,4,24575577,1966891,492,5,21405184,5137284,3170393,-3170393
2018-10-10,544,560,531,531,20849374,560,8,15435666,5413708,429,5,18629779,2219595,-3194113,3194113
2018-10-13,522,528,508,508,12350513,205,6,4950513,7400000,275,2,12170513,180000,-7220000,7220000
2018-10-14,495,524,486,516,6184540,106,11,3404851,2779689,306,0,6184540,0,-2779689,2779689
2018-10-15,527,527,520,527,3272349,92,1,2772349,500000,135,1,3022349,250000,-250000,250000
2018-10-16,553,553,546,553,41625217,445,5,37095117,4530100,375,16,16890730,24734487,20204387,-20204387
2018-10-21,591,621,591,621,34309343,563,10,27295038,7014305,448,12,17205635,17103708,10089403,-10089403
2018-10-22,636,636,610,636,36274096,1020,10,29667993,6605603,674,5,26960938,9312658,2707055,-2707055
2018-10-23,634,648,603,608,17618469,594,5,11954113,5664356,532,4,13801528,3816941,-1847415,1847415
2018-10-24,599,615,586,586,11977737,324,6,5793237,6184500,249,3,11564737,413000,-5771500,5771500
2018-10-27,568,608,568,579,10618621,295,6,6463621,4155000,408,4,8854168,1764453,-2390547,2390547
2018-10-28,584,605,574,597,5851956,248,4,5328583,523373,265,2,4807020,1044936,521563,-521563
2018-10-29,602,618,592,602,5981916,246,1,5781916,200000,275,1,5481916,500000,300000,-300000
2018-10-31,607,618,592,612,6361589,199,5,2803671,3557918,292,2,6061589,300000,-3257918,3257918
2018-11-03,610,621,602,606,7319132,167,7,2887827,4431305,317,2,6830800,488332,-3942973,3942973
2018-11-04,616,618,582,597,8487277,200,4,2533156,5954121,268,1,8311677,175600,-5778521,5778521
2018-11-05,610,618,608,611,5848477,102,4,1510552,4337925,192,8,4888477,960000,-3377925,3377925
2018-11-06,617,635,613,616,14328523,130,6,3352102,10976421,460,4,10361156,3967367,-7009054,7009054
2018-11-10,628,643,604,607,5608017,155,6,2038814,3569203,220,5,4337944,1270073,-2299130,2299130
2018-11-11,623,629,592,592,6983384,169,8,2161795,4821589,237,3,6653241,330143,-4491446,4491446
2018-11-12,607,620,597,608,2841312,95,5,1209624,1631688,196,1,2836312,5000,-1626688,1626688
2018-11-13,609,620,592,599,3973265,96,4,1040729,2932536,199,1,3956599,16666,-2915870,2915870
2018-11-14,606,616,586,601,3221234,80,10,1066904,2154330,182,0,3221234,0,-2154330,2154330
2018-11-17,602,603,578,599,5570454,110,6,1932256,3638198,330,2,5436561,133893,-3504305,3504305
2018-11-18,572,601,557,589,10383622,168,12,2460950,7922672,240,1,10363622,20000,-7902672,7902672
2018-11-19,584,594,571,586,3000633,99,4,1632533,1368100,79,1,2400633,600000,-768100,768100
2018-11-20,601,610,583,601,4085053,102,13,2741285,1343768,218,0,4085053,0,-1343768,1343768
2018-11-21,609,610,585,590,3758858,117,8,2741232,1017626,107,3,1969812,1789046,771420,-771420
2018-11-24,597,597,567,571,6118031,193,7,2699168,3418863,131,1,5118031,1000000,-2418863,2418863
2018-11-26,569,569,541,545,5497447,130,4,1899655,3597792,168,1,5096986,400461,-3197331,3197331
2018-11-27,560,567,544,564,2747853,70,9,560028,2187825,145,1,2646853,101000,-2086825,2086825
2018-11-28,565,565,534,535,2264147,135,6,2121295,142852,71,2,1497975,766172,623320,-623320
2018-12-01,544,558,516,522,5041118,158,6,2158068,2883050,160,2,3903918,1137200,-1745850,1745850
2018-12-02,550,552,531,550,4633272,71,8,3815709,817563,115,1,2527647,2105625,1288062,-1288062
2018-12-03,554,559,543,554,1277917,72,6,510479,767438,98,1,1272917,5000,-762438,762438
2018-12-04,557,564,522,548,1760446,66,8,298147,1462299,113,0,1760446,0,-1462299,1462299
2018-12-05,560,574,547,560,2895406,69,9,826054,2069352,164,0,2895406,0,-2069352,2069352
2018-12-08,573,583,564,573,2428293,81,4,908293,1520000,118,1,2328293,100000,-1420000,1420000
2018-12-09,576,583,561,562,1521341,49,5,369999,1151342,101,0,1521341,0,-1151342,1151342
2018-12-10,571,588,560,579,2560385,84,4,682148,1878237,148,1,2560156,229,-1878008,1878008
2018-12-11,565,579,564,565,1382267,47,8,382245,1000022,55,0,1382267,0,-1000022,1000022
2018-12-12,573,577,559,562,1160630,56,4,341560,819070,103,1,1056027,104603,-714467,714467
2018-12-15,551,574,547,551,1181064,52,16,496108,684956,73,1,1180076,988,-683968,683968
2018-12-16,544,557,531,532,2047413,134,4,1836312,211101,101,2,1398401,649012,437911,-437911
2018-12-17,527,539,511,521,2200100,118,4,1382100,818000,85,1,1522155,677945,-140055,140055
2018-12-18,526,544,518,521,2492212,98,5,962295,1529917,87,2,1261383,1230829,-299088,299088
2018-12-19,526,526,508,523,1222666,60,3,784657,438009,81,0,1222666,0,-438009,438009
2018-12-22,523,523,504,511,1048146,67,3,859431,188715,80,0,1048146,0,-188715,188715
2018-12-23,521,526,517,523,890263,53,3,488049,402214,64,0,890263,0,-402214,402214
2018-12-24,533,545,524,542,2234847,61,3,1104024,1130823,126,1,1234847,1000000,-130823,130823
2018-12-25,547,553,522,549,849319,68,1,633889,215430,71,0,849319,0,-215430,215430
2018-12-26,533,533,519,530,2061538,114,2,1982604,78934,86,3,1061538,1000000,921066,-921066
2018-12-29,533,533,527,532,2457753,34,9,818906,1638847,79,1,2157753,300000,-1338847,1338847
2018-12-30,533,546,524,528,1582953,66,5,707049,875904,61,0,1582953,0,-875904,875904
2018-12-31,530,531,521,524,1399766,72,5,538793,860973,67,1,1369766,30000,-830973,830973
2019-01-01,532,532,518,523,2107524,105,6,1128485,979039,74,0,2107524,0,-979039,979039
2019-01-02,527,532,511,524,2598079,79,5,704164,1893915,98,2,2523079,75000,-1818915,1818915
2019-01-05,518,529,517,518,870270,73,3,623348,246922,73,0,870270,0,-246922,246922
2019-01-06,523,537,521,522,1416426,57,3,1179126,237300,71,2,1142698,273728,36428,-36428
2019-01-07,526,528,521,521,824699,67,3,584699,240000,58,2,692468,132231,-107769,107769
2019-01-08,522,523,514,521,1986492,105,5,1364289,622203,81,0,1986492,0,-622203,622203
2019-01-09,523,540,522,540,2140465,73,4,1819661,320804,147,2,2001424,139041,-181763,181763
2019-01-12,546,557,542,557,14037502,327,5,10563144,3474358,193,6,3985602,10051900,6577542,-6577542
2019-01-13,553,577,553,565,4345116,287,7,2556398,1788718,219,1,4245116,100000,-1688718,1688718
2019-01-14,566,566,554,564,2152501,88,5,1134093,1018408,164,0,2152501,0,-1018408,1018408
2019-01-15,559,563,553,559,1261389,57,2,656071,605318,105,0,1261389,0,-605318,605318
2019-01-16,546,564,546,560,2050374,55,16,1029394,1020980,99,2,1676016,374358,-646622,646622
2019-01-19,562,562,550,560,1898049,61,9,787730,1110319,87,2,1238049,660000,-450319,450319
2019-01-20,560,560,545,549,1912956,74,4,825287,1087669,74,1,1872956,40000,-1047669,1047669
2019-01-21,542,560,521,560,3657875,150,5,2699448,958427,127,1,3655855,2020,-956407,956407
2019-01-22,550,551,531,551,1755488,34,4,1334456,420000,116,1,1254456,500000,80000,-80000
2019-01-23,538,565,538,554,892505,36,3,450181,442324,156,0,892505,0,-442324,442324
2019-01-26,541,562,541,546,1794375,41,9,253716,1540659,63,1,932125,862250,-678409,678409
2019-01-27,545,549,536,546,2377101,37,16,780885,1596216,83,2,1839351,537750,-1058466,1058466
2019-01-28,536,561,533,535,799863,49,9,283514,516349,61,0,799863,0,-516349,516349
2019-01-29,555,556,534,556,1495576,40,5,245825,1249751,88,0,1495576,0,-1249751,1249751
2019-01-30,539,551,538,541,570808,36,1,470808,100000,55,0,570808,0,-100000,100000
2019-02-02,554,554,524,524,1057831,116,3,510001,547830,47,1,1019741,38090,-509740,509740
2019-02-03,522,532,512,532,2470516,139,4,1072961,1397555,78,0,2470516,0,-1397555,1397555
2019-02-04,533,543,525,530,1028923,37,2,152094,876829,87,0,1028923,0,-876829,876829
2019-02-05,527,534,521,526,946030,42,2,201404,744626,53,0,946030,0,-744626,744626
2019-02-06,533,533,519,524,784665,42,4,311665,473000,40,0,784665,0,-473000,473000
2019-02-10,521,528,518,520,1739324,67,4,376570,1362754,50,0,1739324,0,-1362754,1362754
2019-02-12,532,533,514,518,689050,83,4,460918,228132,50,0,689050,0,-228132,228132
2019-02-13,521,543,514,519,2257229,67,4,400347,1856882,136,1,2237229,20000,-1836882,1836882
2019-02-16,526,537,517,523,1105177,43,4,221546,883631,106,0,1105177,0,-883631,883631
2019-02-17,536,536,516,517,764855,80,2,567430,197425,43,1,594855,170000,-27425,27425
2019-02-18,515,523,513,523,1994568,83,3,542514,1452054,54,3,1549568,445000,-1007054,1007054
2019-02-19,527,527,514,518,2018628,47,6,601870,1416758,67,2,1861942,156686,-1260072,1260072
2019-02-20,521,530,521,523,1318773,43,13,451775,866998,81,1,1199611,119162,-747836,747836
2019-02-23,524,540,524,540,2153989,63,9,687655,1466334,123,1,2055575,98414,-1367920,1367920
2019-02-24,546,559,546,553,2952690,124,19,1660379,1292311,190,2,1900658,1052032,-240279,240279
2019-02-25,559,560,546,555,944817,65,4,484020,460797,89,2,847117,97700,-363097,363097
2019-02-26,546,551,536,537,552714,60,4,280275,272439,58,0,552714,0,-272439,272439
2019-02-27,536,548,528,536,721366,67,3,301673,419693,65,0,721366,0,-419693,419693
2019-03-02,541,550,523,527,2556433,122,2,1145230,1411203,75,0,2556433,0,-1411203,1411203
2019-03-03,545,546,534,537,1618528,35,4,724078,894450,98,2,1568242,50286,-844164,844164
2019-03-04,533,546,530,540,871302,37,3,426192,445110,70,0,871302,0,-445110,445110
2019-03-05,536,546,527,528,685573,47,2,440573,245000,43,0,685573,0,-245000,245000
2019-03-06,524,538,524,536,364644,42,1,264644,100000,44,1,290716,73928,-26072,26072
2019-03-09,536,543,527,538,722480,22,2,410587,311893,73,0,722480,0,-311893,311893
2019-03-10,525,542,525,542,1305446,25,1,443183,862263,50,0,1305446,0,-862263,862263
2019-03-11,542,546,534,536,1107476,37,0,1107176,0,61,2,945113,162063,162063,-162063
2019-03-12,543,546,533,546,1610355,31,2,1217775,392580,95,1,1097032,513323,120743,-120743
2019-03-13,552,561,546,552,2296573,71,3,1519304,777269,166,3,1547501,749072,-28197,28197
2019-03-16,534,559,534,546,1023291,43,1,983291,40000,96,1,864481,158810,118810,-118810
2019-03-17,546,552,542,547,910136,50,1,835984,74152,59,1,880136,30000,-44152,44152
2019-03-18,546,559,536,559,1624679,44,4,748809,875870,87,3,1127968,496711,-379159,379159
2019-03-19,561,581,559,581,61440544,464,28,40065271,21375273,203,55,6283104,55157440,33782167,-33782167
2019-03-25,600,610,594,610,37922118,680,53,22327507,15594611,296,6,16815852,21106266,5511655,-5511655
2019-03-26,615,619,598,605,6196681,267,2,4298524,1898157,255,3,5984405,212276,-1685881,1685881
2019-03-27,600,613,591,610,6670366,153,19,2305322,4365044,232,4,5745569,924797,-3440247,3440247
2019-03-30,612,618,603,616,6888257,147,4,3551257,3337000,186,2,6460181,428076,-2908924,2908924
2019-03-31,610,618,597,609,3652717,84,22,1190575,2462142,160,4,2964898,687819,-1774323,1774323
2019-04-06,607,609,584,599,8552605,138,26,2701353,5851252,142,3,7310605,1242000,-4609252,4609252
2019-04-07,602,611,584,584,7072929,168,27,2717170,4355759,174,4,5164659,1908270,-2447489,2447489
2019-04-08,601,601,572,585,4143862,166,7,2317404,1826458,130,3,3227728,916134,-910324,910324
2019-04-09,591,601,559,571,9889673,371,12,6797566,3092107,148,4,9585825,303848,-2788259,2788259
2019-04-10,577,600,566,600,7029176,188,24,2555615,4473561,206,6,4836190,2192986,-2280575,2280575
2019-04-13,600,621,595,610,17698347,338,23,14087947,3610400,304,6,11482455,6215892,2605492,-2605492
2019-04-14,591,612,591,611,3864000,136,4,1636042,2227958,107,0,3864000,0,-2227958,2227958
2019-04-15,622,628,597,622,10604250,306,8,5372608,5231642,153,10,6287761,4316489,-915153,915153
2019-04-16,598,616,594,595,3836398,108,3,1279290,2557108,101,6,3225655,610743,-1946365,1946365
2019-04-17,585,601,578,597,3393484,90,3,2417380,976104,85,3,2116976,1276508,300404,-300404
2019-04-20,591,624,584,624,59747459,403,54,35353071,24394388,318,5,7914093,51833366,27438978,-27438978
2019-04-22,641,654,617,646,185074001,1214,42,138634001,46440000,604,17,50201375,134872626,88432626,-88432626
2019-04-23,639,654,621,628,21179309,571,15,15102064,6077245,278,5,20025646,1153663,-4923582,4923582
2019-04-24,634,646,607,617,12963068,473,7,9797035,3166033,224,3,11895975,1067093,-2098940,2098940
2019-04-27,622,639,612,622,16195127,410,8,13356299,2838828,301,6,13749411,2445716,-393112,393112
2019-04-28,661,661,621,661,55720917,550,41,37606755,18114162,554,11,21052348,34668569,16554407,-16554407
2019-04-29,690,690,686,690,34915360,245,31,24678360,10237000,384,6,16115360,18800000,8563000,-8563000
2019-04-30,711,715,662,705,43744465,761,26,22331235,21413230,674,31,39800942,3943523,-17469707,17469707
2019-05-01,698,727,693,715,47777461,624,29,24018978,23758483,494,14,30833340,16944121,-6814362,6814362
2019-05-04,716,741,704,705,22644265,726,14,15758519,6885746,422,5,20471099,2173166,-4712580,4712580
2019-05-05,721,723,687,687,34420491,650,24,16803787,17616704,390,7,24335648,10084843,-7531861,7531861
2019-05-06,670,698,663,663,15482680,327,21,6833980,8648700,231,2,14882680,600000,-8048700,8048700
2019-05-07,641,671,641,641,42312930,287,14,4263450,38049480,439,4,39031030,3281900,-34767580,34767580
2019-05-08,622,645,611,624,22923416,596,47,12713590,10209826,379,6,20182730,2740686,-7469140,7469140
2019-05-11,611,641,591,591,10850014,442,36,7542704,3307310,265,6,9610014,1240000,-2067310,2067310
2019-05-12,597,609,576,589,11797248,250,9,7747248,4050000,312,6,8091292,3705956,-344044,344044
2019-05-13,593,610,584,593,9008083,294,16,4962032,4046051,178,5,4394290,4613793,567742,-567742
2019-05-14,603,630,603,627,24900499,498,14,17080499,7820000,266,8,10600499,14300000,6480000,-6480000
2019-05-15,635,635,607,622,5080082,251,9,3985017,1095065,175,2,5041532,38550,-1056515,1056515
2019-05-18,653,653,622,631,29588685,831,14,24485858,5102827,356,9,9587653,20001032,14898205,-14898205
2019-05-19,653,659,634,653,8856461,397,14,5209624,3646837,273,5,8365962,490499,-3156338,3156338
2019-05-20,627,644,619,629,6489839,236,9,3130242,3359597,237,4,5201453,1288386,-2071211,2071211
2019-05-21,632,640,622,632,6577249,205,11,4470218,2107031,278,5,4561339,2015910,-91121,91121
2019-05-22,622,634,620,620,6374008,230,18,3547002,2827006,154,4,5438659,935349,-1891657,1891657
2019-05-25,618,635,616,635,6448578,184,13,2673410,3775168,178,2,6366637,81941,-3693227,3693227
2019-05-26,631,643,624,631,8445576,259,17,3434556,5011020,264,27,6387284,2058292,-2952728,2952728
2019-05-28,644,659,634,641,10366272,309,17,4816772,5549500,248,5,6039122,4327150,-1222350,1222350
2019-05-29,648,648,612,614,12871744,456,21,6812921,6058823,220,4,11403984,1467760,-4591063,4591063
2019-06-01,622,622,605,610,6748403,443,11,4725416,2022987,180,1,6631779,116624,-1906363,1906363
2019-06-02,622,633,618,618,9360965,278,21,6308181,3052784,167,35,7074402,2286563,-766221,766221
2019-06-03,622,628,616,624,8707264,304,12,6059722,2647542,195,5,7008113,1699151,-948391,948391
2019-06-08,629,652,609,652,28377429,440,20,18090659,10286770,355,12,7745340,20632089,10345319,-10345319
2019-06-09,669,677,664,677,66280756,873,29,44991069,21289687,389,39,9862069,56418687,35129000,-35129000
2019-06-10,687,698,653,660,16155108,641,13,10202339,5952769,414,36,12249889,3905219,-2047550,2047550
2019-06-11,648,686,648,673,12833019,341,25,5788581,7044438,432,2,12133019,700000,-6344438,6344438
2019-06-12,685,704,672,686,19747162,356,18,7454550,12292612,386,7,9497162,10250000,-2042612,2042612
2019-06-15,662,693,662,672,7762323,356,4,5532323,2230000,307,2,7311457,450866,-1779134,1779134
2019-06-16,683,700,664,673,15700669,461,9,9170064,6530605,446,4,10300669,5400000,-1130605,1130605
2019-06-17,685,690,663,680,7099823,214,9,2871440,4228383,525,3,6172823,927000,-3301383,3301383
2019-06-18,685,687,647,648,9724225,521,9,5105706,4618519,199,1,9602225,122000,-4496519,4496519
2019-06-19,648,665,633,633,11154517,469,9,5185904,5968613,207,3,10531746,622771,-5345842,5345842
2019-06-22,612,640,606,621,10956429,417,12,6387035,4569394,270,21,8450106,2506323,-2063071,2063071
2019-06-23,654,659,643,654,5013378,371,1,4813378,200000,256,8,3024921,1988457,1788457,-1788457
2019-06-24,652,669,648,667,5428985,390,4,3513985,1915000,189,5,4180890,1248095,-666905,666905
2019-06-25,648,656,635,649,7519917,482,7,5974288,1545629,198,4,5920084,1599833,54204,-54204
2019-06-26,645,667,640,644,8041724,574,8,7646696,395028,235,5,5498908,2542816,2147788,-2147788
2019-06-30,644,682,641,669,31253967,1066,4,26602577,4651390,649,9,13271694,17982273,13330883,-13330883
2019-07-01,684,684,656,673,8060379,432,20,3981060,4079319,338,5,4993808,3066571,-1012748,1012748
2019-07-02,669,674,666,673,9134901,368,14,6135711,2999190,306,3,6722526,2412375,-586815,586815
2019-07-03,691,705,672,691,25083306,702,28,17393306,7690000,655,8,13203214,11880092,4190092,-4190092
2019-07-06,696,696,672,673,7553649,298,9,3901461,3652188,380,1,7378392,175257,-3476931,3476931
2019-07-07,673,681,664,668,6282855,276,15,2960199,3322656,249,2,5767855,515000,-2807656,2807656
2019-07-08,665,675,654,673,8452462,333,10,6721737,1730725,282,2,7842915,609547,-1121178,1121178
2019-07-09,673,673,658,670,7594590,211,12,5398858,2195732,292,4,4089249,3505341,1309609,-1309609
2019-07-10,667,675,658,672,7702824,185,16,4116144,3586680,411,5,6147106,1555718,-2030962,2030962
2019-07-13,666,698,659,678,10741964,448,9,7885496,2856468,625,7,6283822,4458142,1601674,-1601674
2019-07-14,698,716,687,716,36374765,712,18,31899881,4474884,481,10,9820272,26554493,22079609,-22079609
2019-07-15,743,750,720,728,62666230,2236,87,49056613,13609617,1004,16,35752380,26913850,13304233,-13304233
2019-07-16,724,724,709,709,18064057,368,9,3590057,14474000,361,8,10818908,7245149,-7228851,7228851
2019-07-17,686,714,686,705,18087298,637,13,11050968,7036330,489,14,15787584,2299714,-4736616,4736616
2019-07-20,703,703,665,665,7300888,387,13,4261288,3039600,340,5,6179735,1121153,-1918447,1918447
2019-07-21,676,695,665,682,5390997,333,10,3442314,1948683,250,4,3949981,1441016,-507667,507667
2019-07-22,682,696,674,683,5463505,344,20,3922378,1541127,210,5,4542755,920750,-620377,620377
2019-07-23,686,686,668,674,3350443,273,5,2266914,1083529,204,4,2893143,457300,-626229,626229
2019-07-24,674,693,671,673,4763760,312,7,2640260,2123500,181,4,3997200,766560,-1356940,1356940
2019-07-27,668,686,661,667,4452991,289,9,2413791,2039200,226,3,3710981,742010,-1297190,1297190
2019-07-28,670,682,659,669,3418562,239,8,2143365,1275197,218,3,3124162,294400,-980797,980797
2019-07-29,667,676,653,660,5870540,438,6,4982216,888324,182,10,4456540,1414000,525676,-525676
2019-07-30,654,671,654,660,8877785,406,8,4184542,4693243,149,11,3074370,5803415,1110172,-1110172
2019-07-31,665,665,654,658,5076546,392,3,4626546,450000,211,9,3872785,1203761,753761,-753761
2019-08-03,662,679,652,662,6253919,395,3,5578905,675014,257,12,5421593,832326,157312,-157312
2019-08-04,679,687,674,684,7388799,368,6,3798916,3589883,295,9,3175475,4213324,623441,-623441
2019-08-05,688,714,685,691,18924961,486,9,9512661,9412300,495,42,8052874,10872087,1459787,-1459787
2019-08-06,689,705,686,690,3605627,205,3,1672010,1933617,249,4,2909735,695892,-1237725,1237725
2019-08-07,686,721,686,691,12561529,391,9,9178753,3382776,389,11,6414041,6147488,2764712,-2764712
2019-08-10,720,735,705,722,24206992,757,7,20641362,3565630,677,15,9598391,14608601,11042971,-11042971
2019-08-11,733,761,722,742,27104604,831,8,24888572,2216032,612,26,13498688,13605916,11389884,-11389884
2019-08-13,749,776,745,776,46958141,1243,28,39409323,7548818,736,31,16658352,30299789,22750971,-22750971
2019-08-14,800,800,762,773,19956948,1295,8,15848516,4108432,653,16,12539249,7417699,3309267,-3309267
2019-08-17,777,780,762,767,16026615,812,10,12341671,3684944,628,11,9056812,6969803,3284859,-3284859
2019-08-18,771,780,763,770,10762470,574,9,8446852,2315618,427,8,5150001,5612469,3296851,-3296851
2019-08-19,778,807,766,796,17324755,811,12,11127209,6197546,624,12,9171525,8153230,1955684,-1955684
2019-08-21,808,834,798,819,24147102,1067,15,16906573,7240529,564,28,7393399,16753703,9513174,-9513174
2019-08-24,845,861,827,853,21107312,990,16,11386748,9720564,528,15,11148477,9958835,238271,-238271
2019-08-25,816,847,808,816,17663484,980,12,13157230,4506254,701,40,14685773,2977711,-1528543,1528543
2019-08-26,825,843,814,819,14970178,758,36,9394060,5576118,551,13,12158987,2811191,-2764927,2764927
2019-08-27,831,834,785,796,13614665,797,12,10622019,2992646,634,9,11915309,1699356,-1293290,1293290
2019-08-28,783,813,771,788,12841813,998,11,9026783,3815030,440,13,12277414,564399,-3250631,3250631
2019-08-31,800,816,776,787,18161134,1110,6,13739990,4421144,501,14,11203667,6957467,2536323,-2536323
2019-09-01,778,791,773,777,11727917,914,8,9198687,2529230,370,12,5213548,6514369,3985139,-3985139
2019-09-02,779,797,757,773,11533711,825,9,9455786,2077925,424,10,7260643,4273068,2195143,-2195143
2019-09-03,809,809,773,809,23061699,694,11,14907879,8153820,510,18,5703336,17358363,9204543,-9204543
2019-09-04,825,836,798,825,17445679,1078,5,15443271,2002408,661,14,10430526,7015153,5012745,-5012745
2019-09-07,825,838,807,817,11461634,1077,7,9271934,2185721,577,5,9860354,1597301,-588420,588420
2019-09-08,798,832,796,798,11794191,1027,12,10223103,1571088,517,5,8782734,3011457,1440369,-1440369
2019-09-11,813,827,808,812,13496183,732,3,10946183,2550000,454,54,8444030,5052153,2502153,-2502153
2019-09-14,819,857,816,845,26167912,1079,11,20643621,5524291,1062,20,13457540,12710372,7186081,-7186081
2019-09-15,845,850,815,821,9296330,803,5,7080500,2215830,424,55,6535481,2760849,545019,-545019
2019-09-16,832,847,794,803,17247821,1417,5,16307821,940000,515,54,8949152,8298669,7358669,-7358669
2019-09-17,810,810,770,787,22933586,1044,4,19133586,3800000,475,5,14224381,8709205,4909205,-4909205
2019-09-18,785,785,749,762,11796701,1049,6,11296463,500238,459,6,10650851,1145850,645612,-645612
2019-09-21,781,797,771,787,9475472,844,4,8830472,645000,318,25,5723428,3752044,3107044,-3107044
2019-09-22,799,799,782,786,10827878,911,3,10497878,330000,345,60,6671679,4156199,3826199,-3826199
2019-09-23,792,829,783,827,30052231,1002,11,18267233,11784998,903,47,20111968,9940263,-1844735,1844735
2019-09-24,827,851,799,829,16125314,649,8,10310319,5771865,774,8,12519444,3562740,-2209125,2209125
2019-09-25,837,865,813,865,29954386,988,23,21458672,8495714,1234,57,19396232,10558154,2062440,-2062440
2019-09-28,894,897,888,894,30505890,1618,14,24740267,5765623,692,68,15878126,14627764,8862141,-8862141
2019-09-29,903,942,871,942,26584145,970,9,17907456,8676689,1173,18,17453733,9130412,453723,-453723
2019-09-30,970,970,955,970,23930808,304,5,21150808,2780000,300,11,11780718,12150090,9370090,-9370090
2019-10-01,961,1018,934,960,34942309,1621,15,22880686,12061623,1153,62,25150587,9791722,-2269901,2269901
2019-10-02,970,983,945,970,17194248,1175,8,13101934,4092314,778,54,13202391,3991857,-100457,100457
2019-10-05,959,983,909,909,14935459,1032,20,11783514,3151945,740,8,12765540,2169919,-982026,982026
2019-10-06,897,914,889,890,14425094,985,15,11750504,2674590,641,13,13054705,1370389,-1304201,1304201
2019-10-07,890,914,864,876,10673163,736,6,8252242,2420921,708,6,9267198,1405965,-1014956,1014956
2019-10-08,842,895,842,842,6706860,537,2,5711860,995000,333,15,5322312,1384548,389548,-389548
2019-10-09,826,866,826,866,11112570,477,10,6145791,4966779,803,11,9216082,1896488,-3070291,3070291
2019-10-12,870,875,847,862,6336191,618,7,4665191,1671000,372,4,5276495,1059696,-611304,611304
2019-10-13,862,902,818,837,9942493,682,15,8886775,1055718,475,54,6621853,3320640,2264922,-2264922
2019-10-14,822,838,811,811,16386631,702,16,10573805,5812826,323,4,12254866,4131765,-1681061,1681061
2019-10-15,803,819,774,774,7804339,377,6,5664339,2140000,167,3,7735599,68740,-2071260,2071260
2019-10-16,762,793,753,773,14021538,863,6,8992286,5029252,606,8,13087646,933892,-4095360,4095360
2019-10-20,733,782,733,733,19848533,618,7,11363533,8485000,683,15,17125684,2722849,-5762151,5762151
2019-10-23,703,740,703,703,2360968,206,2,2309968,51000,23,1,2290197,70771,19771,-19771
2019-10-26,693,707,672,694,24775179,735,20,13744945,11030234,522,8,22281514,2493665,-8536569,8536569
2019-10-28,700,713,691,713,11402279,805,16,9902425,1499854,307,17,6548585,4853694,3353840,-3353840
2019-10-30,741,743,716,742,10661948,1137,4,9451948,1210000,312,48,8165910,2496038,1286038,-1286038
2019-11-02,757,757,709,715,7552345,1055,3,7013614,538731,347,2,7346293,206052,-332679,332679
2019-11-03,711,733,699,711,8861415,686,6,8093091,768324,338,3,7967206,894209,125885,-125885
2019-11-04,723,723,679,682,15534987,956,5,13872628,1662359,354,7,11530726,4004261,2341902,-2341902
2019-11-05,673,718,673,695,7448969,564,6,6004254,1444715,336,39,4975388,2473581,1028866,-1028866
2019-11-09,719,733,711,731,8295768,779,3,8193768,102000,404,53,5045403,3250365,3148365,-3148365
2019-11-10,726,728,689,707,3500676,476,1,3100676,400000,315,3,2680676,820000,420000,-420000
2019-11-11,707,719,707,709,3415340,351,1,3115340,300000,255,7,2711344,703996,403996,-403996
2019-11-12,714,742,709,730,8164682,519,7,6240368,1924314,428,8,5370563,2794119,869805,-869805
2019-11-13,733,741,714,721,5585819,429,17,4514615,1071204,341,3,4942312,643507,-427697,427697
2019-11-16,733,733,693,708,5947575,597,2,5797575,150000,318,1,5938190,9385,-140615,140615
2019-11-17,676,714,674,686,10263341,443,10,5263694,4999647,397,1,10047263,216078,-4783569,4783569
2019-11-18,670,700,670,683,3867518,376,4,3205466,690571,223,2,3769406,126631,-563940,563940
2019-11-19,677,708,677,701,3118495,295,0,3118495,0,240,1,3016495,102000,102000,-102000
2019-11-20,714,736,703,736,19763560,246,0,19763560,0,453,10,12167837,7595723,7595723,-7595723
2019-11-23,768,768,759,768,37745250,834,4,36301391,1443859,392,10,10973575,26771675,25327816,-25327816
2019-11-24,806,806,786,806,42210948,1035,6,36465471,5745477,968,33,24374587,17836361,12090884,-12090884
2019-11-25,844,844,844,844,6159138,40,1,5859138,300000,268,3,4136088,2023050,1723050,-1723050
2019-11-26,867,867,816,828,33639063,1775,50,28360013,5279050,1976,11,31137242,2501821,-2777229,2777229
2019-11-27,814,854,814,834,12703670,705,32,9968722,2734948,1021,10,11565170,1138500,-1596448,1596448
2019-11-30,822,842,816,822,13614645,835,3,12672245,942400,900,6,11523287,2091358,1148958,-1148958
2019-12-01,827,853,827,841,10081691,568,8,7630691,2451000,606,5,9526922,554769,-1896231,1896231
2019-12-02,838,848,799,819,16405022,579,15,8843610,7561412,618,7,10257297,6147725,-1413687,1413687
2019-12-03,802,844,802,828,10721559,488,6,8347559,2374000,523,4,9211559,1510000,-864000,864000
2019-12-04,829,869,822,869,22278719,256,0,22278719,0,610,12,7803138,14475581,14475581,-14475581
2019-12-07,901,904,867,888,33330008,1680,14,27765410,5564598,926,16,23320950,10009058,4444460,-4444460
2019-12-08,893,930,872,883,13771615,977,8,10712244,3059371,852,5,12334062,1437553,-1621818,1621818
2019-12-09,886,892,871,876,10814935,821,6,8518607,2296328,778,2,10684338,130597,-2165731,2165731
2019-12-10,889,889,842,852,13501789,880,6,11354789,2147000,593,4,11021557,2480232,333232,-333232
2019-12-11,846,869,844,854,10261579,539,8,6923579,3338000,494,6,9638550,623029,-2714971,2714971
2019-12-14,842,865,842,855,12084156,865,11,9051892,3032264,797,2,11934156,150000,-2882264,2882264
2019-12-15,863,867,842,852,12373981,888,2,11683491,690490,577,4,12189755,184226,-506264,506264
2019-12-16,852,867,842,863,15761532,634,3,15097432,664100,633,2,14719223,1042309,378209,-378209
2019-12-17,867,897,861,889,44795180,1082,12,34008929,10786251,789,21,21041007,23754173,12967922,-12967922
2019-12-18,895,895,870,883,10369106,768,7,6798876,3570230,717,3,9992273,376833,-3193397,3193397
2019-12-21,884,898,867,875,10383723,677,6,9324415,1059308,633,0,10383723,0,-1059308,1059308
2019-12-22,880,892,873,876,9598771,535,5,8308316,1290455,573,4,8958771,640000,-650455,650455
2019-12-23,881,906,855,867,18990021,929,8,13831035,5158986,887,4,17533615,1456406,-3702580,3702580
2019-12-24,862,891,862,872,9262272,678,1,8862272,400000,533,2,8391136,871136,471136,-471136
2019-12-25,880,884,852,884,11577639,862,0,11577639,0,588,2,9295181,2282458,2282458,-2282458
2019-12-28,906,906,899,906,9766633,136,2,9734357,32276,511,12,6272735,3493898,3461622,-3461622
2019-12-29,944,951,916,944,54854556,2303,11,47709556,7145000,1406,19,42509584,12344972,5199972,-5199972
2019-12-30,980,993,957,981,30949543,2026,11,26409171,4537872,1302,11,25457043,5490000,952128,-952128
2019-12-31,993,993,937,951,18884060,1602,9,14345010,4539050,1147,1,18880060,4000,-4535050,4535050
2020-01-01,933,969,921,932,10994666,847,5,9651382,1343284,754,4,10851068,143598,-1199686,1199686
2020-01-04,899,899,899,899,5590136,175,2,570136,5020000,37,1,5390136,200000,-4820000,4820000
2020-01-05,854,854,854,854,11963858,483,5,3163858,8800000,40,1,11763858,200000,-8600000,8600000
2020-01-07,812,833,812,812,42443722,1006,13,25045015,17398707,822,9,36971369,5472353,-11926354,11926354
2020-01-08,796,796,796,796,2965499,118,1,529371,2436128,23,0,2965499,0,-2436128,2436128
2020-01-11,812,812,812,812,1579815,6,0,1579815,0,94,0,1579815,0,0,0
2020-01-12,852,852,844,852,27595184,908,3,25488535,2106649,254,15,15640530,11954654,9848005,-9848005
2020-01-13,876,895,855,895,19945376,580,12,11402047,8543329,457,13,11023765,8921611,378282,-378282
2020-01-14,931,931,876,885,18133379,981,2,14035563,4097816,560,6,14568415,3564964,-532852,532852
2020-01-15,875,926,865,902,26978726,663,8,19578687,7400039,935,9,23402759,3575967,-3824072,3824072
2020-01-18,937,947,937,947,56273002,260,4,52163002,4110000,551,18,7711458,48561544,44451544,-44451544
2020-01-19,995,995,995,995,80257369,685,9,74155369,6102000,571,16,27796610,52460759,46358759,-46358759
2020-01-20,1044,1044,1044,1044,15402580,34,1,10975301,4427279,512,11,9688521,5714059,1286780,-1286780
2020-01-21,1096,1096,1058,1096,90072404,1071,12,59477156,30595248,1284,32,63934398,26138006,-4457242,4457242
2020-01-22,1111,1149,1105,1149,119560853,1359,21,81183567,38377286,1972,26,56289442,63271411,24894125,-24894125
2020-01-25,1203,1203,1150,1203,97817738,2096,15,67218735,30599003,1572,19,42756062,55061676,24462673,-24462673
2020-01-26,1256,1263,1221,1263,136225850,2753,27,83865823,52360027,2224,31,73517455,62708395,10348368,-10348368
2020-01-27,1321,1321,1321,1321,6804842,39,4,5200017,1604825,172,5,2904842,3900000,2295175,-2295175
2020-02-02,1388,1457,1388,1457,15991394,46,3,12141880,3849514,530,2,5491394,10500000,6650486,-6650486
2020-02-03,1527,1527,1527,1527,4106734,41,4,3506734,600000,238,1,2106734,2000000,1400000,-1400000
2020-02-04,1603,1603,1603,1603,18051004,126,12,15051004,3000000,547,4,12251004,5800000,2800000,-2800000
2020-02-05,1684,1684,1684,1684,6670683,43,1,5370683,1300000,462,4,4050683,2620000,1320000,-1320000
2020-02-08,1768,1768,1696,1768,121109918,2684,36,87329435,33780483,1936,18,91953850,29156068,-4624415,4624415
2020-02-09,1851,1851,1729,1851,43691231,946,9,34370981,9320250,2195,9,38491231,5200000,-4120250,4120250
2020-02-10,1903,1903,1726,1900,130034548,4650,30,114838805,15195743,2656,27,86170078,43864470,28668727,-28668727
2020-02-12,1900,1968,1875,1968,69842303,4480,16,48971471,20870832,2095,21,52483233,17359070,-3511762,3511762
2020-02-15,1990,2002,1854,1941,108663981,4002,20,73160617,35503364,3874,29,82137961,26526020,-8977344,8977344
2020-02-16,1951,1975,1933,1975,44785796,1248,10,31267469,13518195,1316,14,14204351,30581313,17063118,-17063118
2020-02-17,1990,2065,1900,1996,47105952,2991,11,40204966,6900986,1966,16,42532052,4573900,-2327086,2327086
2020-02-18,2027,2027,1900,1935,32716461,1898,19,24193397,8523064,1717,11,25864328,6852133,-1670931,1670931
2020-02-19,2066,2066,1968,2066,35149192,1769,9,29462468,5686724,2043,9,25088007,10061185,4374461,-4374461
2020-02-22,2153,2153,2066,2153,58279277,3357,20,48728947,9550330,907,9,49999913,8279364,-1270966,1270966
2020-02-23,2256,2256,2256,2256,5122475,245,1,4822475,300000,69,2,4822475,300000,0,0
2020-02-26,2369,2487,2334,2360,49488000,4991,11,42079524,7408476,1541,23,34452733,15035267,7626791,-7626791
2020-02-29,2292,2338,2292,2292,44201592,3206,14,32771213,11412000,1418,8,40082713,4100500,-7311500,7311500
2020-03-01,2270,2296,2178,2263,55367324,4897,17,47379624,7987700,3339,16,50396363,4970961,-3016739,3016739
2020-03-02,2319,2333,2258,2307,40975652,3455,17,34954130,6021522,1845,9,28117342,12858310,6836788,-6836788
2020-03-03,2403,2425,2334,2425,58728039,3342,21,51157869,7570170,1905,15,30230512,28497527,20927357,-20927357
2020-03-04,2487,2523,2289,2334,33511984,3585,12,26278051,7233933,1540,10,29022704,4489280,-2744653,2744653
2020-03-07,2264,2270,2264,2264,3488698,1003,2,3481698,7000,341,1,2488698,1000000,993000,-993000
2020-03-09,2190,2190,2190,2190,589845,471,0,589845,0,6,1,489845,100000,100000,-100000
2020-03-10,2178,2178,2178,2178,394778,302,0,394778,0,6,0,394778,0,0,0
2020-03-11,2170,2170,2170,2170,7139691,853,4,2136591,5003100,51,5,5639691,1500000,-3503100,3503100
2020-03-14,2061,2061,2061,2061,952101,379,1,452101,500000,11,2,752101,200000,-300000,300000
2020-03-15,2045,2045,2045,2045,4894057,316,3,394057,4500000,37,5,3594057,1300000,-3200000,3200000
2020-03-16,1960,2063,1960,1960,143687841,6444,15,63730060,79957781,3599,23,114615885,29071956,-50885825,50885825
2020-03-17,1948,2015,1876,1900,52850624,4268,10,38292938,14557686,1711,8,41490347,11360277,-3197409,3197409
2020-03-18,1927,2000,1912,2000,38350662,2579,0,38350662,0,1184,5,16437662,21913000,21913000,-21913000
2020-03-24,2091,2091,2001,2091,58864510,7126,12,56268168,2596342,1500,11,31474477,27390033,24793691,-24793691
2020-03-25,2166,2181,2117,2181,65604895,6784,13,59078014,7558633,983,12,20323273,46313374,38754741,-38754741
2020-03-28,2288,2289,2232,2289,36988298,5949,8,33977298,3011000,1185,16,24877480,12110818,9099818,-9099818
2020-03-29,2219,2400,2175,2219,39219422,7737,10,36566262,2653160,3044,5,37409422,1810000,-843160,843160
2020-03-30,2245,2310,2205,2205,45877795,6385,12,42908561,2960228,2468,5,39478169,6390620,3430392,-3430392
2020-04-04,2245,2326,2228,2326,35345232,4458,9,31947837,3397395,3019,11,31467291,3877941,480546,-480546
2020-04-05,2353,2353,2195,2251,25637491,5388,7,25259819,377672,2578,8,22619107,3018384,2640712,-2640712
2020-04-06,2180,2230,2121,2178,45825259,5453,10,38598159,7227100,3497,10,41978184,3847075,-3380025,3380025
2020-04-07,2245,2255,2187,2255,19566143,1088,7,10579701,8986442,2494,9,14890849,4675294,-4311148,4311148
2020-04-08,2356,2357,2309,2357,20164693,1327,5,17043482,3121211,2085,5,12160096,8004597,4883386,-4883386
2020-04-11,2471,2471,2471,2471,9450833,378,4,8945164,305200,923,5,5267169,3983195,3677995,-3677995
2020-04-12,2595,2595,2595,2595,5429328,82,3,5129328,300000,550,4,1622328,3807000,3507000,-3507000
2020-04-13,2702,2702,2702,2702,23508099,194,8,18858099,4650000,970,11,14187099,9321000,4671000,-4671000
2020-04-14,2704,2837,2569,2837,62971539,5131,12,57182803,5788736,5172,18,53042225,9929314,4140578,-4140578
2020-04-15,2914,2914,2914,2914,5669022,152,2,5269022,400000,949,2,5269022,400000,0,0
2020-04-18,3059,3059,3059,3059,4350696,118,4,4040696,310000,447,3,3450323,900373,590373,-590373
2020-04-19,3211,3211,2933,3036,91982014,13915,19,88629790,3352224,5062,18,72981544,19000470,15648246,-15648246
2020-04-20,3208,3315,3205,3315,16213327,1474,2,14516840,1696487,1547,8,14438927,1774400,77913,-77913
2020-04-21,3418,3432,3303,3431,81743115,12754,18,68032481,13710634,3262,20,59285407,22457708,8747074,-8747074
2020-04-29,3577,3755,3577,3755,11268048,482,3,9969548,1300000,533,3,4140582,7128966,5828966,-5828966
2020-05-02,3932,3932,3845,3932,39496033,7155,13,29668733,9827300,1305,13,17524583,21971450,12144150,-12144150
2020-05-03,4128,4128,4126,4128,28826228,6963,8,22548764,6277464,1190,9,25976098,2850130,-3427334,3427334
2020-05-04,4054,4271,3921,4054,80361843,17637,17,67294379,13067464,5301,16,75166706,5195137,-7872327,7872327
2020-05-05,4164,4265,3859,3859,25135881,8939,3,25034381,101500,1403,7,20571447,4564434,4462934,-4462934
2020-05-06,3735,3859,3735,3735,58004198,9973,10,53435134,4569064,4447,14,49410276,8593922,4024858,-4024858
2020-05-09,3936,3938,3801,3938,34062052,7549,8,32334752,1727300,2621,10,26928990,7133062,5405762,-5405762
2020-05-10,4121,4122,3731,3848,46345196,13912,4,46328625,16571,4872,9,43857271,2487925,2471354,-2471354
2020-05-11,3782,3928,3782,3782,11312564,5635,3,11302739,9825,609,1,11262564,50000,40175,-40175
2020-05-12,3608,3608,3608,3608,21358930,5470,7,18852329,2506601,1971,1,20158930,1200000,-1306601,1306601
2020-05-13,3428,3428,3257,3257,9372145,2472,3,9021947,350198,610,1,8372145,1000000,649802,-649802
2020-05-16,3163,3390,2970,2988,37087720,5809,8,36034538,1053182,4965,6,35228898,1858822,805640,-805640
2020-05-17,3248,3248,3248,3248,9568047,774,0,9568047,0,1741,3,7967096,1600951,1600951,-1600951
2020-05-18,3411,3411,3411,3411,4185376,71,4,3583294,389014,495,1,2972308,1000000,610986,-610986
2020-05-19,3581,3581,3581,3581,3916512,68,3,3674563,241949,696,2,2216512,1700000,1458051,-1458051
2020-05-20,3760,3760,3760,3760,14434093,218,9,11860845,2573248,1582,6,11104105,3329988,756740,-756740
2020-05-23,3928,3948,3586,3948,80362644,15890,10,78122483,2240661,5806,23,62482982,17880162,15639501,-15639501
2020-05-23,3948,3948,3948,3948,500,15890,10,78122483,2240661,5806,23,62482982,17880162,15639501,-15639501
2020-06-02,4549,4616,4397,4549,37640401,5433,7,32022401,5618000,3461,15,34266492,3373909,-2244091,2244091
2020-06-06,4647,4699,4323,4483,45415329,9643,15,41626604,3788725,7097,11,44772451,642878,-3145847,3145847
2020-06-07,4733,4733,4649,4733,23797082,5787,4,23646999,150083,2673,14,19708188,4088894,3938811,-3938811
2020-06-08,4963,4963,4491,4491,22387385,6620,7,21824521,510828,3030,11,22045224,290125,-220703,220703
2020-06-09,4403,4549,4403,4403,25501914,5398,5,21691214,3810700,2972,3,23511464,1990450,-1820250,1820250
2020-06-10,4234,4549,4219,4274,39925129,8444,11,38329415,1595714,6640,8,37669496,2255633,659919,-659919
2020-06-13,4480,4518,4420,4518,36915870,7198,8,37554867,2586781,4402,14,32748349,7393299,4806518,-4806518
2020-06-14,4666,4666,4280,4398,29369500,7938,4,28993685,375815,3892,11,29306061,63439,-312376,312376
2020-06-15,4388,4589,4252,4558,39363501,7215,7,38156722,1206779,5535,26,36039515,3323986,2117207,-2117207
2020-06-16,4717,4717,4717,4717,7803308,973,3,6503308,1300000,1708,19,6021758,1781550,481550,-481550
2020-06-20,4953,4953,4953,4953,4886839,68,0,4886839,0,1477,4,3610579,1276260,1276260,-1276260
2020-06-21,5200,5200,5200,5200,10086006,156,7,9447256,638750,1482,4,3466046,6619960,5981210,-5981210
2020-06-22,5459,5459,5459,5459,3986751,89,4,3486751,500000,1249,10,3645490,341261,-158739,158739
2020-06-23,5715,5715,5715,5715,13719484,268,5,13013484,706000,2042,9,8701175,5018309,4312309,-4312309
2020-06-24,6000,6000,6000,6000,8858437,341,1,6258437,2600000,1807,11,8599969,258468,-2341532,2341532
2020-06-27,6299,6299,6299,6299,4216346,164,5,3716346,500000,1137,5,4194171,22175,-477825,477825
2020-06-28,6613,6613,6613,6613,17152315,279,5,13604889,3547426,1648,12,8648031,8504284,4956858,-4956858
2020-06-29,6283,6944,6283,6944,109370048,15895,16,108297593,1072455,10634,20,103680262,5689786,4617331,-4617331
2020-06-30,6939,6939,6939,6939,2783503,90,2,2563503,220000,1750,3,2682111,101392,-118608,118608
2020-07-06,7229,7229,7229,7229,4692310,416,0,4692310,0,1455,9,4279738,412572,412572,-412572
2020-07-07,7589,7589,7589,7589,8506985,153,2,6761619,1745366,1862,18,8314056,192929,-1552437,1552437
2020-07-08,7289,7968,7211,7968,98519016,24131,20,92465019,6053997,9624,26,92669433,5849583,-204414,204414
2020-07-11,7488,8195,7488,8195,25367828,4469,6,25084707,283121,5489,15,24002065,1365763,1082642,-1082642
2020-07-12,8320,8320,8320,8320,6719665,139,2,6599665,120000,960,8,1583120,5136545,5016545,-5016545
2020-07-13,8735,8735,8735,8735,47957518,13740,15,45385417,2572101,2219,23,19220223,28737295,26165194,-26165194
2020-07-14,9172,9172,9172,9172,9354415,941,2,9212415,142000,1407,25,5931840,3422575,3280575,-3280575
2020-07-15,9630,9630,9148,9630,86103451,28340,19,84645950,1457501,4888,37,68223729,17879722,16422221,-16422221
2020-07-18,9102,9102,9102,9102,14984947,15845,6,14956451,28496,678,1,14784947,200000,171504,-171504
2020-07-19,8966,9557,8966,9557,50221957,5110,14,43679327,6542630,6987,28,42139724,8082233,1539603,-1539603
2020-07-20,9683,9683,9683,9683,10539411,444,6,9432511,1106900,1506,10,9876872,662539,-444361,444361
2020-07-21,10166,10166,9688,10166,115433634,36006,33,110671536,4762098,6166,41,91740351,23693283,18931185,-18931185
2020-07-22,10410,10601,10294,10601,30439309,12716,10,29449614,989695,4264,14,28681745,1757564,767869,-767869
2020-07-25,11081,11081,11081,11081,1390092,83,2,1254162,135930,270,1,1340092,50000,-85930,85930
2020-07-27,10626,11488,10626,11488,25886967,6476,1,25660043,50000,3165,44,16584049,9125994,9075994,-9075994
2020-07-28,11792,11792,11792,11792,6040796,342,2,5640796,400000,1699,38,2145944,3894852,3494852,-3494852
2020-07-29,12381,12381,11798,12381,87054068,33707,20,82620483,4433585,11744,24,73193000,13861068,9427483,-9427483
2020-08-01,12619,12942,12452,12942,29825498,18356,7,28928130,897368,7118,23,27587878,2237620,1340252,-1340252
2020-08-02,12718,13357,12086,12718,75648364,46286,17,74876081,772283,8695,22,57477518,18170846,17398563,-17398563
2020-08-03,12519,12519,12519,12519,26196406,21362,7,25918642,277764,8816,7,25243040,953366,675602,-675602
2020-08-04,11893,13145,11893,13017,104025216,39875,20,98382610,5642606,23766,57,89125728,14899488,9256882,-9256882
2020-08-05,13225,13225,13000,13225,20675272,7177,5,15925726,88483,5423,18,12911566,3102643,3014160,-3014160
2020-08-09,13859,13859,13859,13859,6305851,491,3,2805851,3500000,2499,18,3909863,2395988,-1104012,1104012
2020-08-10,14551,14551,13859,14551,75667991,40819,19,72456529,3211462,11844,20,66524857,9143134,5931672,-5931672
2020-08-11,13743,15187,13743,13743,48656072,25080,10,48381699,274373,9661,34,44656406,3999666,3725293,-3725293
2020-08-12,14345,14511,13130,13130,30688762,21705,12,30480597,208165,4467,23,26265331,4423431,4215266,-4215266
2020-08-15,13068,13068,13068,13068,3223406,4304,3,3123218,100188,95,1,3222847,559,-99629,99629
2020-08-16,12416,12416,12416,12416,1502777,2561,1,1502647,130,37,2,1202777,300000,299870,-299870
2020-08-17,11797,12084,11797,11797,31923005,9194,7,28898120,3026141,8864,33,28322214,3602047,575906,-575906
2020-08-18,12406,12406,11232,11423,50333374,23480,15,50260803,72571,8893,56,46580213,3753161,3680590,-3680590
2020-08-19,11411,11411,11411,11411,1950737,3140,3,1873237,77500,33,1,1850737,100000,22500,-22500
2020-08-22,11323,11951,10842,10842,15590279,6198,5,11760779,3829500,2868,18,13998700,1591579,-2237921,2237921
2020-08-23,10510,10510,10510,10510,726958,1354,2,717458,9500,29,2,526958,200000,190500,-190500
2020-08-24,10291,10291,10291,10291,1254359,1437,1,1253826,533,26,1,1154359,100000,99467,-99467
2020-08-25,9922,10917,9922,10641,81034512,26302,24,78307040,2727472,13988,24,74753535,6280977,3553505,-3553505
2020-08-26,10699,10809,10478,10809,11088495,5013,2,10988417,100078,3158,11,8932005,2156490,2056412,-2056412
2020-08-31,11310,11310,10234,10234,51851496,15437,10,46693861,5157635,5083,8,41471763,10379733,5222098,-5222098
2020-09-01,9945,9945,9945,9945,884539,1536,2,877358,7181,18,0,884539,0,-7181,7181
2020-09-02,9708,9708,9708,9708,473405,875,1,472905,500,18,0,473405,0,-500,500
2020-09-05,9583,9583,9583,9583,4490239,2234,2,4482343,7896,211,4,3572854,917385,909489,-909489
2020-09-06,9105,9105,9105,9105,3016761,2353,0,3016761,0,74,1,2261520,755241,755241,-755241
2020-09-07,8650,8650,8650,8650,339952,613,0,339952,0,6,1,239952,100000,100000,-100000
2020-09-08,8577,8577,8577,8577,260502,380,1,222002,38500,16,0,260502,0,-38500,38500
2020-09-09,8519,8519,8519,8519,1486606,1951,1,1484606,2000,38,1,1386606,100000,98000,-98000
2020-09-12,8469,8881,8200,8200,63023353,15229,13,58247052,4776301,9323,17,54209023,8814330,4038029,-4038029
2020-09-13,7966,7966,7966,7966,1832588,1416,1,1132588,700000,57,5,1332588,500000,-200000,200000
2020-09-14,7651,7651,7651,7651,4470258,3415,4,4318275,151983,140,5,4004258,466000,314017,-314017
2020-10-11,8140,8140,7733,7733,19884317,10994,6,19773222,111095,1887,13,16782529,3101788,2990693,-2990693
2020-10-12,7476,7476,7476,7476,1305658,1695,1,1305648,10,48,2,1080658,225000,224990,-224990
2020-10-13,7290,7290,7290,7290,2605904,1056,2,905904,1700000,97,1,2500273,105631,-1594369,1594369
2020-10-14,6926,6926,6926,6926,2942183,1252,5,942183,2000000,123,4,2627283,314900,-1685100,1685100
2020-10-18,6580,6580,6580,6580,2936958,781,3,636958,2300000,116,3,2636958,300000,-2000000,2000000
2020-10-19,6252,6252,6252,6252,2773878,398,3,273878,2500000,128,1,2743486,30392,-2469608,2469608
2020-10-20,5951,5951,5951,5951,2763786,545,2,763786,2000000,142,0,2763786,0,-2000000,2000000
2020-10-21,5665,5798,5665,5665,54186385,5515,10,43390441,10795944,6565,13,39288192,14898193,4102249,-4102249
2020-10-24,5383,5383,5383,5383,624800,554,0,624800,0,30,1,576327,48473,48473,-48473
2020-10-26,5334,5334,5334,5334,3502366,336,2,702366,2800000,104,2,3302366,200000,-2600000,2600000
2020-10-27,5070,5070,5070,5070,2711845,356,3,211845,2500000,74,2,2511845,200000,-2300000,2300000
2020-10-28,4876,4876,4876,4876,1204473,675,0,1204473,0,48,0,1204473,0,0,0
2020-10-31,4793,4793,4793,4793,8026791,2314,4,4010126,4016665,261,2,7626791,400000,-3616665,3616665
2020-11-01,4554,4554,4554,4554,818232,661,0,818232,0,63,0,818232,0,0,0
2020-11-02,4507,4507,4507,4507,919352,493,1,918352,1000,35,0,919352,0,-1000,1000
2020-11-04,4454,4454,4454,4454,6178369,1470,4,2175004,4003365,207,0,6178369,0,-4003365,4003365
2020-11-07,4231,4427,4231,4231,21696249,3259,4,20682249,1014000,3400,9,19123131,2573118,1559118,-1559118
2020-11-08,4082,4082,4082,4082,4428816,290,1,428816,4000000,164,0,4428816,0,-4000000,4000000
2020-11-09,3881,3881,3881,3881,2116619,370,1,416619,1700000,66,3,1816619,300000,-1400000,1400000
2020-11-10,3788,3962,3788,3839,149660213,11079,18,134505922,15154291,16554,29,139418083,10242130,-4912161,4912161
2020-11-11,4000,4000,3904,4000,86550248,4932,5,84236165,2314083,6972,18,59121270,27428978,25114895,-25114895
2020-11-14,4198,4198,4198,4198,6285711,155,1,6284742,969,1192,4,2241986,4043725,4042756,-4042756
2020-11-15,4087,4407,4022,4089,174709921,19818,18,166597232,8112689,12197,18,155217240,19492681,11379992,-11379992
2020-11-16,4087,4431,4087,4221,88437663,10975,19,84461090,3976573,9481,9,86834875,1602788,-2373785,2373785
2020-11-17,4183,4446,4137,4446,63295051,5437,14,60263014,3032037,6546,5,59007293,4287758,1255721,-1255721
2020-11-18,4628,4640,4474,4640,42526727,8502,10,41535942,990785,4094,15,31725852,10800875,9810090,-9810090
2020-11-21,4813,4813,4388,4388,62849457,13727,14,59182867,3666590,7759,9,62484232,365225,-3301365,3301365
2020-11-22,4324,4482,4324,4324,70262841,7506,9,65304378,4958463,5928,7,60380239,9882602,4924139,-4924139
2020-11-23,4133,4441,4127,4133,82953431,12303,18,79592841,3360590,9556,9,82219891,733540,-2627050,2627050
2020-11-24,4203,4389,4079,4389,106197060,6443,8,102114129,4082931,11774,13,93059680,13137380,9054449,-9054449
2020-11-25,4499,4577,4402,4577,29276048,1770,6,27238000,2038048,3907,9,24560765,4715283,2677235,-2677235
2020-11-28,4773,4773,4577,4773,28570965,2071,3,26201561,2369404,3321,10,22547759,6023206,3653802,-3653802
2020-11-29,4999,4999,4999,4999,12779281,358,4,11449281,1330000,1434,8,4412177,8367104,7037104,-7037104
2020-11-30,5248,5248,4904,4974,94816847,17318,15,91002032,3814815,7981,10,86685841,8131006,4316191,-4316191
2020-12-01,4926,5130,4884,4884,82045230,14701,16,77024408,5020822,9706,13,79610648,2434582,-2586240,2586240
2020-12-02,4868,5213,4771,5213,97962452,11067,13,94033400,3929052,11623,18,85654335,12308117,8379065,-8379065
2020-12-05,5225,5426,5213,5426,48882213,8482,10,47260884,1621329,4893,21,36096517,12785696,11164367,-11164367
2020-12-06,5612,5647,5150,5311,78613010,21421,17,74596897,4016113,10367,11,76438289,2174721,-1841392,1841392
2020-12-07,5311,5482,5143,5145,44577878,9656,10,41000449,3577429,8867,11,42532474,2045404,-1532025,1532025
2020-12-08,5183,5333,4994,5120,36704161,7818,14,33503424,3200737,7556,5,35083599,1620562,-1580175,1580175
2020-12-09,5009,5359,5009,5359,53526982,5698,11,50495254,3031728,9297,11,42463368,11063614,8031886,-8031886
2020-12-12,5439,5575,5109,5145,46555804,12983,13,45619723,936081,7677,9,46144071,411733,-524348,524348
2020-12-13,5074,5261,5052,5052,42390555,9242,10,39417556,2972999,5484,3,39387055,3003500,30501,-30501
2020-12-14,4986,5203,4828,4828,24259427,5511,7,22140131,2119296,4180,4,24247097,12330,-2106966,2106966
2020-12-15,4710,4710,4710,4710,4678167,756,4,1428167,3250000,491,0,4678167,0,-3250000,3250000
2020-12-16,4476,4565,4476,4476,56116052,7752,11,44099052,12017000,7216,6,54880473,1235579,-10781421,10781421
2020-12-19,4569,4710,4486,4594,35995005,7043,3,35793501,201504,5605,11,34053289,1941716,1740212,-1740212
2020-12-20,4652,4652,4378,4378,31197778,6376,10,27176461,4021517,3719,4,31024173,173805,-3847712,3847712
2020-12-21,4270,4378,4187,4187,39078645,7684,13,34855018,4223627,6055,2,39077775,870,-4222757,4222757
2020-12-22,4153,4399,4103,4378,48235069,8568,10,44655219,3579850,7416,14,43144016,5091053,1511203,-1511203
2020-12-23,4467,4467,4200,4265,31661288,7129,7,30241581,1419707,4994,7,29915739,1745549,325842,-325842
2020-12-26,4110,4319,4110,4117,35918888,7738,14,32206478,3712410,6524,2,35848305,70583,-3641827,3641827
2020-12-27,4014,4286,3929,4012,33097527,7003,7,31037527,2060000,6491,3,32804534,292993,-1767007,1767007
2020-12-28,3997,4235,3997,4235,58021731,7395,7,54133461,3888270,6051,10,39652392,18369339,14481069,-14481069
2020-12-29,4000,4286,4000,4000,29299355,5897,4,24962116,4337239,3444,8,28214591,1084764,-3252475,3252475
2020-12-30,3886,4062,3844,3844,35488675,5910,13,29321846,6166829,5022,6,32753575,2735100,-3431729,3431729
2021-01-02,3686,3873,3680,3680,12151687,1949,3,8001687,4150000,1701,1,12131287,20400,-4129600,4129600
2021-01-03,3504,3775,3504,3554,52960164,6679,20,45890263,7069901,8046,6,52096764,863400,-6206501,6206501
2021-01-04,3588,3720,3500,3597,30318080,4965,4,29797080,521000,4994,6,29683343,634737,113737,-113737
2021-01-05,3432,3647,3432,3432,27402506,4185,5,22802506,4600000,3767,3,27271128,131378,-4468622,4468622
2021-01-06,3323,3389,3279,3279,33081723,3411,11,28242798,4838925,4633,5,32950888,130835,-4708090,4708090
2021-01-09,3279,3449,3157,3449,37950781,2997,4,37673813,276968,6458,7,35592981,2357800,2080832,-2080832
2021-01-10,3519,3519,3519,3519,5725782,71,2,5525782,200000,1188,3,3475782,2250000,2050000,-2050000
2021-01-11,3683,3683,3564,3620,74068978,6084,12,72239421,1829557,4659,17,63611034,10457944,8628387,-8628387
2021-01-12,3572,3572,3484,3484,23109582,2218,4,20307582,2802000,1767,2,22309582,800000,-2002000,2002000
2021-01-13,3389,3605,3318,3379,67096491,5305,8,62353914,4742577,6609,7,66094601,1001890,-3740687,3740687
2021-01-16,3396,3396,3260,3260,11335846,1162,3,6925702,4410144,1039,0,11335846,0,-4410144,4410144
2021-01-18,3125,3125,3125,3125,2914764,461,2,1067707,1847057,41,0,2914764,0,-1847057,1847057
2021-01-19,3248,3313,3047,3158,60250155,5227,8,56007650,4242505,5746,5,59646722,603433,-3639072,3639072
2021-01-20,3284,3284,3166,3284,15081804,997,1,14981804,100000,1681,3,12990804,2091000,1991000,-1991000
2021-01-23,3439,3439,3366,3439,7603722,900,1,7553722,50000,1020,2,5403722,2200000,2150000,-2150000
2021-01-24,3608,3608,3266,3269,66701157,6454,5,60564126,6137031,4585,6,65620607,1080550,-5056481,5056481
2021-01-25,3248,3472,3245,3274,33532864,3978,4,33052864,480000,3745,5,32706864,826000,346000,-346000
2021-01-26,3313,3391,3176,3176,21336125,2305,3,18836125,2500000,1799,1,21335887,238,-2499762,2499762
2021-01-27,3058,3176,3044,3058,34820271,3822,3,32558868,2261403,3565,1,34520271,300000,-1961403,1961403
2021-01-30,3215,3228,3132,3228,7933458,187,1,7928809,4649,1514,3,5593458,2340000,2335351,-2335351
2021-01-31,3384,3384,3291,3384,69473532,4862,7,65934502,3539030,5749,12,62903983,6569549,3030519,-3030519
2021-02-01,3404,3542,3260,3542,57398801,1930,3,56970109,428692,4550,8,50121751,7277050,6848358,-6848358
2021-02-02,3701,3701,3439,3701,112253028,6949,5,111643557,609471,8880,9,103941877,8311151,7701680,-7701680
2021-02-03,3701,3731,3467,3467,29134441,2832,1,27434441,1700000,2259,2,28783441,351000,-1349000,1349000
2021-02-06,3353,3404,3353,3353,6147517,480,2,4447108,1700409,462,0,6147517,0,-1700409,1700409
2021-02-07,3256,3519,3256,3519,40472898,2383,2,39759898,713000,3013,5,38856746,1616152,903152,-903152
2021-02-08,3544,3605,3314,3339,62982932,5600,4,55652948,7329984,4663,4,61095859,1887073,-5442911,5442911
2021-02-09,3372,3555,3264,3487,34637233,3305,5,28484773,6152460,3851,2,33625508,1011725,-5140735,5140735
2021-02-13,3663,3665,3530,3665,31847320,3096,3,31814238,33082,3111,7,25386080,6461240,6428158,-6428158
2021-02-14,3788,3788,3582,3582,23478240,2608,3,21741340,1736900,1790,0,23478240,0,-1736900,1736900
2021-02-15,3545,3545,3545,3545,2761992,488,1,1061992,1700000,22,0,2761992,0,-1700000,1700000
2021-02-16,3510,3510,3510,3510,3160236,297,1,1460236,1700000,38,0,3160236,0,-1700000,1700000
2021-02-17,3472,3472,3472,3472,4086517,419,1,2786517,1300000,67,0,4086517,0,-1300000,1300000
2021-02-20,3422,3422,3422,3422,2626021,324,1,2419021,207000,29,0,2626021,0,-207000,207000
2021-02-21,3392,3392,3392,3392,399024,163,0,399024,0,11,0,399024,0,0,0
2021-02-22,3387,3387,3387,3387,929934,163,4,743804,186130,15,0,929934,0,-186130,186130
2021-02-23,3376,3376,3376,3376,1379345,303,0,1379345,0,20,0,1379345,0,0,0
2021-02-24,3359,3359,3359,3359,640890,224,0,640890,0,17,0,640890,0,0,0
2021-02-27,3351,3351,3351,3351,2393632,162,7,341561,2052071,34,0,2393632,0,-2052071,2052071
2021-02-28,3324,3324,3324,3324,1798042,89,1,193327,1604715,25,0,1798042,0,-1604715,1604715
2021-03-01,3304,3304,3304,3304,928439,176,1,313439,615000,15,1,925859,2580,-612420,612420
2021-03-02,3294,3294,3294,3294,1237547,308,1,737547,500000,21,0,1237547,0,-500000,500000
2021-03-03,3281,3281,3281,3281,287457,177,0,287457,0,5,1,276022,11435,11435,-11435
2021-03-06,3278,3278,3278,3278,238899,106,0,238899,0,5,0,238899,0,0,0
2021-03-07,3274,3274,3274,3274,251277,183,0,251277,0,6,0,251277,0,0,0
2021-03-08,3271,3271,3271,3271,2344766,427,1,1744766,600000,32,2,2233646,111120,-488880,488880
2021-03-09,3246,3338,3246,3246,48993721,5303,12,47421967,1571754,4642,10,47035428,1958293,386539,-386539
2021-03-10,3198,3198,3198,3198,599954,261,0,599954,0,25,0,599954,0,0,0
2021-03-13,3191,3191,3191,3191,559068,347,0,559068,0,15,0,559068,0,0,0
2021-03-14,3185,3185,3185,3185,1289418,456,0,1289418,0,34,0,1289418,0,0,0
2021-03-15,3173,3271,3173,3175,64256605,5139,3,60812478,3444127,5543,10,60921091,3335514,-108613,108613
2021-03-16,3223,3323,3210,3241,42274465,4804,8,40152367,2122098,3801,4,41394495,879970,-1242128,1242128
2021-03-17,3271,3321,3203,3203,20551595,2987,4,17946422,2605173,1511,0,20551595,0,-2605173,2605173
2021-03-27,3225,3409,3153,3409,36685697,2364,2,36650697,35000,3433,3,31785697,4900000,4865000,-4865000
2021-03-28,3422,3462,3298,3304,26428530,3801,4,24239954,2188576,2643,2,26319826,108704,-2079872,2079872
2021-03-30,3306,3364,3271,3271,14724444,1871,3,12274292,2450152,1375,1,14400759,323685,-2126467,2126467
2021-03-31,3241,3294,3230,3230,9406917,1203,3,7625917,1781000,1261,0,9406917,0,-1781000,1781000
2021-04-03,3266,3381,3170,3170,31559526,3080,10,29835208,1724318,3685,6,30032517,1527009,-197309,197309
2021-04-04,3218,3273,3216,3216,17135673,2049,10,15210970,1924703,2195,5,16615569,520104,-1404599,1404599
2021-04-05,3168,3288,3160,3250,17438142,2052,5,17270926,167216,2626,4,15605540,1832602,1665386,-1665386
2021-04-06,3201,3298,3176,3201,11905973,1469,6,11595982,309991,2104,1,11805973,100000,-209991,209991
2021-04-07,3183,3228,3168,3168,6999408,708,5,4988730,2010678,411,1,6249408,750000,-1260678,1260678
2021-04-10,3112,3157,3112,3112,4576962,434,2,2851962,1725000,294,1,4572762,4200,-1720800,1720800
2021-04-11,3067,3067,3067,3067,1631832,270,1,631832,1000000,59,2,1445792,186040,-813960,813960
2021-04-12,3052,3098,3050,3050,7915771,950,3,7639529,276242,885,4,7688385,227386,-48856,48856
2021-04-13,3057,3157,2992,2994,31214078,3466,6,30744021,470057,3011,11,29730986,1483092,1013035,-1013035
2021-04-14,2990,3024,2990,2990,2374739,569,2,1842739,532000,129,1,2374289,450,-531550,531550
2021-04-17,2969,2969,2969,2969,422283,184,0,422283,0,11,0,422283,0,0,0
2021-04-18,2965,2965,2965,2965,131173,99,0,131173,0,6,0,131173,0,0,0
2021-04-19,2964,2964,2964,2964,422017,151,0,422017,0,9,0,422017,0,0,0
2021-04-20,2960,2960,2960,2960,1742161,312,0,1742161,0,35,0,1742161,0,0,0
2021-04-21,2914,2914,2914,2914,310509,150,0,310509,0,13,0,310509,0,0,0
2021-04-24,2909,2909,2909,2909,332178,138,0,332178,0,4,0,332178,0,0,0
2021-04-25,2904,2904,2904,2904,145233,101,0,145233,0,2,0,145233,0,0,0
2021-04-26,2902,2902,2902,2902,296871,156,0,296871,0,4,0,296871,0,0,0
2021-04-27,2901,2901,2901,2901,1894386,425,1,1394386,500000,44,0,1894386,0,-500000,500000
2021-04-28,2876,2929,2876,2876,22939323,2075,4,21433735,1505588,1538,4,22919323,20000,-1485588,1485588
2021-05-01,2826,2864,2796,2796,7328579,798,4,5095079,2233500,504,1,7322879,5700,-2227800,2227800
2021-05-02,2725,2725,2725,2725,2127412,152,1,427412,1700000,60,0,2127412,0,-1700000,1700000
2021-05-03,2700,2700,2700,2700,1751590,148,1,223590,1528000,32,2,1706290,45300,-1482700,1482700
2021-05-05,2680,2680,2680,2680,1569922,264,1,569922,1000000,29,1,1569627,295,-999705,999705
2021-05-08,2661,2661,2661,2661,265002,138,0,265002,0,9,0,265002,0,0,0
2021-05-09,2658,2658,2658,2658,166563,73,0,166563,0,4,0,166563,0,0,0
2021-05-10,2656,2656,2656,2656,2322075,259,1,1322075,1000000,59,2,2130255,191820,-808180,808180
2021-05-11,2769,2824,2632,2675,50085913,4582,5,44237075,5848838,5118,6,49445656,640257,-5208581,5208581
2021-05-12,2676,2758,2605,2605,10118972,1633,2,9818972,300000,1085,2,10082295,36677,-263323,263323
2021-05-15,2575,2774,2527,2756,26831368,1687,3,26717486,113882,3433,10,26480372,350996,237114,-237114
2021-05-16,2753,2821,2663,2680,18391733,2247,4,17737226,654507,2090,2,18235039,156694,-497813,497813
2021-05-17,2658,2725,2607,2607,11940063,1090,4,11705451,234612,1131,2,11912309,27754,-206858,206858
2021-05-18,2494,2623,2494,2494,17573993,1510,6,12154963,5419030,1929,3,16461942,1112051,-4306979,4306979
2021-05-19,2396,2553,2396,2396,7776439,904,2,7701439,75000,967,0,7776439,0,-75000,75000
2021-05-22,2316,2326,2316,2316,5543461,431,4,1843461,3700000,351,1,5540461,3000,-3697000,3697000
2021-05-23,2239,2239,2239,2239,1061981,209,1,561981,500000,16,0,1061981,0,-500000,500000
2021-05-24,2225,2324,2225,2225,24298283,1292,8,19306870,4991413,2001,6,24214795,83488,-4907925,4907925
2021-05-25,2231,2304,2181,2191,12387744,1314,4,10317744,2070000,2014,3,12336287,51457,-2018543,2018543
2021-05-26,2193,2238,2136,2165,12293202,1208,4,11602112,691090,2352,4,11660147,633055,-58035,58035
2021-05-29,2201,2286,2185,2286,14009795,847,1,13815795,194000,1114,4,8939259,5070536,4876536,-4876536
2021-05-30,2211,2382,2176,2216,18942866,2056,3,18056794,886072,1508,1,18642866,300000,-586072,586072
2021-05-31,2216,2248,2151,2151,9265273,1178,4,6818879,2446394,891,1,8965273,300000,-2146394,2146394
2021-06-01,2098,2173,2067,2085,10202136,983,1,10197136,5000,921,2,10161936,40200,35200,-35200
2021-06-02,2014,2191,1992,2156,28709362,1613,2,28224776,484586,1903,6,26683702,2025660,1541074,-1541074
2021-06-07,2185,2208,2135,2208,18249198,803,2,18172198,77000,1302,7,10740182,7509016,7432016,-7432016
2021-06-08,2299,2299,2251,2273,42957349,1609,10,33657349,9300000,1868,6,36654049,6303300,-2996700,2996700
2021-06-09,2319,2391,2243,2258,24329961,1446,5,22963744,1366217,1502,6,22807887,1522074,155857,-155857
2021-06-12,2318,2344,2193,2241,11869704,801,4,10429704,1440000,1002,3,11279837,589867,-850133,850133
2021-06-13,2266,2291,2203,2266,12910943,698,5,11920238,990705,863,7,12106024,804919,-185786,185786
2021-06-14,2286,2359,2266,2359,28351698,709,5,26901644,1450054,1637,11,23583651,4768047,3317993,-3317993
2021-06-15,2401,2442,2276,2293,21957253,1414,5,19151558,2805695,1218,5,21451201,506052,-2299643,2299643
2021-06-16,2309,2359,2236,2251,14093635,1223,3,12880436,1213199,975,4,12770236,1323399,110200,-110200
2021-06-19,2274,2342,2206,2303,13170022,948,4,12347204,822818,940,5,11792892,1377130,554312,-554312
2021-06-20,2226,2339,2206,2216,10221262,914,3,9409262,812000,793,5,9871748,349514,-462486,462486
2021-06-21,2259,2359,2201,2359,19447544,542,2,17944110,1503434,1365,10,15268890,4178654,2675220,-2675220
2021-06-22,2376,2447,2376,2447,11424836,113,5,7876411,3548425,676,8,6905049,4519787,971362,-971362
2021-06-23,2562,2562,2562,2562,6815257,67,8,6015257,800000,624,9,4040256,2775001,1975001,-1975001
2021-06-26,2663,2663,2663,2663,11753839,131,11,10503839,1250000,627,9,3594167,8159672,6909672,-6909672
2021-06-27,2721,2796,2670,2688,74303633,4784,14,69185109,5118524,3117,20,69315750,4987883,-130641,130641
2021-06-28,2715,2736,2612,2708,28199393,1996,7,26603743,1595650,2281,7,26747918,1451475,-144175,144175
2021-06-29,2801,2821,2713,2821,74365205,2869,11,71330894,3034311,2841,18,62315863,12049342,9015031,-9015031
2021-06-30,2809,2857,2779,2799,27214783,2123,6,26018463,1196320,1760,11,23206156,4008627,2812307,-2812307
2021-07-03,2824,2841,2668,2668,38521340,1816,4,34309544,4211796,1992,9,29557650,8963690,4751894,-4751894
2021-07-04,2617,2821,2610,2774,17241022,1253,5,16373176,867846,1599,9,16058844,1182178,314332,-314332
2021-07-05,2774,2889,2774,2889,19566039,742,1,18860546,705493,1592,7,15858655,3707384,3001891,-3001891
2021-07-06,2989,3005,2862,2876,38288318,2851,6,36185005,2103313,1873,5,31078318,7210000,5106687,-5106687
2021-07-07,2879,2911,2808,2881,18172563,1624,3,17752563,420000,1539,3,17952563,220000,-200000,200000
2021-07-10,2711,2824,2703,2711,16927402,1695,3,16408402,519000,1390,4,15929083,998319,479319,-479319
2021-07-11,2791,2823,2670,2784,15807561,1447,4,12983483,2824078,1348,5,15246796,560765,-2263313,2263313
2021-07-12,2711,2824,2681,2793,19382224,1555,4,16282224,3100000,1292,4,19046748,335476,-2764524,2764524
2021-07-13,2686,2806,2655,2716,16245101,1170,5,14004080,2241021,1216,4,15575101,670000,-1571021,1571021
2021-07-14,2849,2849,2668,2849,36496613,1080,8,32108209,4388404,2308,8,24816938,11679675,7291271,-7291271
2021-07-17,2917,2970,2849,2917,56448844,2371,13,45520696,10928148,2905,14,53434916,3013928,-7914220,7914220
2021-07-18,2974,3015,2874,2985,22958217,1799,6,19954867,3003350,2014,5,22515996,442221,-2561129,2561129
2021-07-19,2987,3108,2970,3103,46346272,2281,10,39157484,7188788,2911,11,40615065,5731207,-1457581,1457581
2021-07-26,3140,3171,2962,2994,20218792,1748,6,17884153,2334639,1841,5,18764692,1454100,-880539,880539
2021-07-27,2990,3042,2892,2892,17828061,1225,6,10918061,6910000,1113,3,17518120,309941,-6600059,6600059
2021-07-28,2788,2964,2768,2768,24657872,1995,5,21257872,3400000,1282,8,17658680,6999192,3599192,-3599192
2021-07-31,2799,2907,2728,2804,15896506,1516,2,15096506,800000,1454,5,14240197,1656309,856309,-856309
2021-08-01,2828,2847,2686,2711,16946038,2182,5,15785668,1160370,1318,6,15450854,1495184,334814,-334814
2021-08-02,2668,2793,2668,2721,14602070,1339,4,13468165,1133905,1239,2,14498314,103756,-1030149,1030149
2021-08-03,2758,2833,2668,2798,19102682,1330,6,10694037,8408645,1489,3,17144368,1958314,-6450331,6450331
2021-08-04,2843,2843,2693,2741,22325084,1835,6,17531390,4793694,1390,5,19181993,3143091,-1650603,1650603
2021-08-07,2774,2808,2658,2691,17966750,1975,4,16465735,1501015,1377,6,16150100,1816650,315635,-315635
2021-08-08,2710,2710,2610,2691,19107560,1864,3,18257560,850000,1488,3,17703157,1404403,554403,-554403
2021-08-09,2793,2793,2660,2705,13511527,586,4,12511527,1000000,1369,6,9991027,3520500,2520500,-2520500
2021-08-10,2911,2911,2841,2911,68866834,1484,9,56200219,12666615,2178,10,51276451,17590383,4923768,-4923768
2021-08-11,2974,3005,2841,2897,44342293,3458,7,34940526,9401767,2905,4,44122904,219389,-9182378,9182378
2021-08-14,2916,2959,2828,2916,32094852,2121,8,25001517,7093335,2055,6,30913071,1181781,-5911554,5911554
2021-08-15,2979,2995,2833,2979,29207330,1751,7,22278900,6928430,2228,9,27264648,1942682,-4985748,4985748
2021-08-22,2949,3015,2934,2949,28824798,2375,7,26080674,2744124,2053,10,24680911,4143887,1399763,-1399763
2021-08-23,2974,3113,2859,3113,28233075,987,6,24720824,3512251,2189,8,24579223,3653852,141601,-141601
2021-08-24,3211,3211,3211,3211,19049597,475,3,17049597,2000000,1022,8,14949597,4100000,2100000,-2100000
2021-08-25,3273,3298,3135,3226,49461923,4438,10,45764923,3697000,3048,9,47885419,1576504,-2120496,2120496
2021-08-28,3231,3372,3230,3372,33737719,2266,16,27725462,6012257,2446,10,29913295,3824424,-2187833,2187833
2021-08-29,3456,3470,3186,3186,39778893,3935,8,33565174,6213719,2863,4,38270490,1508403,-4705316,4705316
2021-08-30,3140,3188,3140,3140,18508228,1305,10,7115287,11392941,1185,9,16201921,2306307,-9086634,9086634
2021-08-31,2987,3082,2987,2987,47360723,3412,9,34733947,12628847,1844,12,39732660,7630134,-4998713,4998713
2021-09-01,2932,3077,2879,3030,22720901,2586,7,21373246,1347655,1881,8,20855899,1865002,517347,-517347
2021-09-04,3088,3112,2959,2992,24032513,2364,8,22189621,1842892,1747,6,20137424,3895089,2052197,-2052197
2021-09-05,3019,3168,2942,3166,53371998,2857,6,48504773,4867225,3116,19,45625377,7746621,2879396,-2879396
2021-09-06,3138,3223,2987,3005,25917231,2671,11,25418422,498809,2568,11,22602404,3314827,2816018,-2816018
2021-09-07,2992,3090,2934,2960,23031584,1830,12,18346718,4684866,2602,8,19839354,3192230,-1492636,1492636
2021-09-08,3025,3073,2962,3025,14670933,1503,7,14260735,410198,3689,3,14430604,240329,-169869,169869
2021-09-11,2974,3107,2932,3052,12905813,1745,3,12502069,403744,1309,6,12693238,212575,-191169,191169
2021-09-12,2877,3002,2869,2876,20660647,1960,10,14663059,5997588,1129,0,20660647,0,-5997588,5997588
2021-09-13,2781,2902,2738,2758,17770320,2006,5,15005320,2765000,1755,5,16319920,1450400,-1314600,1314600
2021-09-14,2744,2862,2744,2814,10824167,1217,2,10323167,501000,1760,1,10823444,723,-500277,500277
2021-09-15,2814,2814,2741,2766,12464393,1221,7,7995340,4469053,2598,1,12464129,264,-4468789,4468789
2021-09-18,2758,2823,2632,2632,19729603,2082,10,15065003,4664600,1039,3,18562603,1167000,-3497600,3497600
2021-09-19,2568,2666,2515,2537,21776642,1773,8,16948742,4827900,1460,4,19059667,2716975,-2110925,2110925
2021-09-20,2500,2637,2475,2529,11783610,1327,2,10623610,1160000,1190,1,11767610,16000,-1144000,1144000
2021-09-21,2550,2590,2427,2429,17511423,1589,6,12077011,5434412,958,3,15711422,1800001,-3634411,3634411
2021-09-22,2414,2467,2313,2422,19397235,2127,4,15951829,3445406,1511,6,18367235,1030000,-2415406,2415406
2021-09-25,2459,2490,2426,2490,10758784,351,2,4573495,6185289,943,3,8607927,2150857,-4034432,4034432
2021-09-26,2583,2583,2442,2553,16445530,1453,2,12358701,4086829,1303,4,15463896,981634,-3105195,3105195
2021-09-28,2492,2570,2444,2492,7047411,1025,3,6009166,1038245,898,4,6365592,681819,-356426,356426
2021-09-29,2489,2542,2457,2484,8493743,1120,1,8293743,200000,918,1,8443743,50000,-150000,150000
2021-10-02,2492,2557,2460,2480,14158848,1439,2,13748646,410202,1289,3,13561199,597649,187447,-187447
2021-10-03,2480,2557,2426,2525,10100253,1101,3,10059310,40943,1309,4,9749302,350951,310008,-310008
2021-10-04,2492,2587,2485,2492,13456456,1628,3,12655456,801000,1278,2,12906456,550000,-251000,251000
2021-10-17,2287,2335,2254,2287,13696295,865,1,12596295,1100000,516,1,13396295,300000,-800000,800000
2021-10-18,2416,2416,2189,2416,37274406,1461,11,21335907,15938499,2384,7,33839905,3434501,-12503998,12503998
2021-10-19,2431,2431,2431,2431,7539165,142,0,7539165,0,813,4,5757430,1781735,1781735,-1781735
2021-10-20,2462,2462,2340,2354,14113913,1204,3,12713913,1400000,1111,3,12640028,1473885,73885,-73885
2021-10-23,2337,2354,2282,2282,6916257,758,5,4313689,2602568,248,3,6315994,600263,-2002305,2002305
2021-10-25,2210,2280,2192,2194,24079615,1327,5,20019615,4060000,1452,6,21751782,2327833,-1732167,1732167
2021-10-26,2170,2249,2137,2194,13356006,866,6,11909874,1446132,1088,5,10541503,2814503,1368371,-1368371
2021-10-27,2162,2259,2162,2214,12124777,772,4,11629882,494895,1032,7,8485191,3639586,3144691,-3144691
2021-10-30,2262,2262,2105,2118,15906283,1140,7,9720195,6186088,1205,4,12754183,3152100,-3033988,3033988
2021-10-31,2093,2102,2022,2022,12044721,740,4,5840221,6204500,790,4,11021324,1023397,-5181103,5181103
2021-11-01,2022,2112,2022,2057,10525736,883,2,8825736,1700000,837,3,8936986,1588750,-111250,111250
2021-11-02,2112,2180,2037,2180,16111476,677,2,16060477,50999,983,2,14403267,1708209,1657210,-1657210
2021-11-03,2224,2272,2170,2272,8719556,515,0,8719556,0,912,3,7338556,1381000,1381000,-1381000
2021-11-06,2334,2364,2305,2362,23120918,1373,1,22620918,500000,1016,5,19145058,3975860,3475860,-3475860
2021-11-07,2384,2402,2245,2250,18601254,1337,4,16695772,1905482,1273,2,17098254,1503000,-402482,402482
2021-11-08,2225,2362,2225,2250,11927866,933,3,10485219,1442647,911,5,8626850,3301016,1858369,-1858369
2021-11-09,2250,2362,2239,2287,12542767,734,1,11042767,1500000,890,2,11013664,1529103,29103,-29103
2021-11-10,2297,2414,2297,2414,18850414,593,4,11803709,7046705,1541,2,16624209,2226205,-4820500,4820500
2021-11-13,2330,2514,2277,2467,36691563,2125,3,33187455,3504108,2294,7,31945012,4746551,1242443,-1242443
2021-11-14,2474,2554,2379,2401,12198457,1113,4,10823168,1375289,1156,5,10272433,1926024,550735,-550735
2021-11-15,2521,2579,2436,2521,43906206,1624,5,42290219,1615987,2596,5,39391779,4514427,2898440,-2898440
2021-11-16,2454,2556,2424,2456,13118008,917,5,10386693,2731315,1071,2,13092573,25435,-2705880,2705880
2021-11-17,2512,2584,2481,2504,12556812,712,5,11087379,1469433,1020,3,9991947,2564865,1095432,-1095432
2021-11-20,2517,2579,2421,2421,12449163,791,1,12349163,100000,1095,2,12299163,150000,50000,-50000
2021-11-21,2462,2536,2396,2486,12189139,722,4,11341565,847574,1010,2,11639139,550000,-297574,297574
2021-11-22,2531,2562,2457,2472,9222113,801,2,8142113,1080000,868,2,8866613,355500,-724500,724500
2021-11-23,2487,2487,2381,2387,7927856,731,4,7443877,483979,847,2,7902635,25221,-458758,458758
2021-11-24,2426,2426,2304,2312,12296930,1038,2,11836930,460000,789,2,12099771,197159,-262841,262841
2021-11-27,2227,2295,2207,2254,8963094,556,5,8408103,554991,860,1,8933294,29800,-525191,525191
2021-11-28,2212,2304,2212,2254,6645869,441,5,5817664,828205,743,0,6645869,0,-828205,828205
2021-11-29,2262,2304,2207,2207,4644417,439,2,4425242,219175,544,3,4353295,291122,71947,-71947
2021-11-30,2259,2312,2200,2235,7625186,424,1,7387598,237588,651,2,5407253,2217933,1980345,-1980345
2021-12-01,2230,2249,2155,2219,7497754,440,4,6046208,1451546,582,3,6309687,1188067,-263479,263479
2021-12-04,2220,2225,2112,2150,6012889,521,3,5327966,684923,759,1,5992889,20000,-664923,664923
2021-12-05,2152,2194,2128,2180,7101512,477,2,6901512,200000,648,3,6937849,163663,-36337,36337
2021-12-06,2163,2204,2150,2160,6559872,429,0,6559872,0,541,3,6188111,371761,371761,-371761
2021-12-07,2147,2184,2103,2140,3839289,336,0,3839289,0,483,2,3837158,2131,2131,-2131
2021-12-08,2112,2217,2112,2199,5316620,388,0,5316620,0,619,2,4631620,685000,685000,-685000
2021-12-11,2163,2222,2155,2162,4468455,336,3,4053739,414716,581,1,4468255,200,-414516,414516
2021-12-12,2122,2212,2090,2187,4337375,333,4,2905167,1432208,489,2,4327375,10000,-1422208,1422208
2021-12-13,2184,2187,2068,2068,5904372,461,3,5593772,310600,595,4,5322372,582000,271400,-271400
2021-12-14,2087,2167,2058,2097,4580750,388,3,2968385,1612365,522,0,4580750,0,-1612365,1612365
2021-12-15,2100,2142,2070,2093,4197497,310,4,2591450,1606047,511,2,3696897,500600,-1105447,1105447
2021-12-18,2120,2187,2108,2137,4095420,379,2,3779420,316000,499,2,3095420,1000000,684000,-684000
2021-12-19,2108,2110,2035,2065,4899376,306,5,3340456,1558920,466,2,4799176,100200,-1458720,1458720
2021-12-20,2052,2120,2052,2085,4664278,341,5,4172929,491349,489,3,4164088,500190,8841,-8841
2021-12-21,2103,2197,2103,2197,6432409,147,4,5958694,473715,697,1,5932409,500000,26285,-26285
2021-12-22,2237,2265,2199,2265,9182241,374,3,8328456,853785,552,3,6099654,3082587,2228802,-2228802
2021-12-25,2354,2354,2180,2197,9783196,943,9,8048187,1735009,731,3,9675423,107773,-1627236,1627236
2021-12-26,2205,2254,2170,2237,6848300,474,8,5021012,1827288,529,3,5685211,1163089,-664199,664199
2021-12-27,2257,2310,2230,2282,8872621,409,8,5242861,3629760,569,2,7997621,875000,-2754760,2754760
2021-12-28,2290,2324,2245,2292,4698530,344,6,3765129,933401,577,2,4605405,93125,-840276,840276
2021-12-29,2284,2397,2270,2360,21432944,756,10,16796765,4636179,1438,7,19760455,1672489,-2963690,2963690
2022-01-01,2360,2424,2322,2349,9965673,483,8,6437520,3528153,917,1,9935673,30000,-3498153,3498153
2022-01-02,2426,2439,2330,2426,7607981,387,7,5093109,2514872,745,0,7607981,0,-2514872,2514872
2022-01-03,2344,2437,2337,2340,3978798,420,2,3594179,384619,524,0,3978798,0,-384619,384619
2022-01-04,2340,2362,2272,2317,4173371,341,5,3229674,943697,540,2,3823371,350000,-593697,593697
2022-01-05,2315,2367,2274,2292,3737411,399,4,2582248,1155163,420,5,3119714,617697,-537466,537466
2022-01-08,2242,2379,2242,2290,5223675,334,3,4248468,975207,578,3,4363550,860125,-115082,115082
2022-01-09,2287,2412,2282,2337,10876946,527,7,10097091,779855,934,3,9424580,1452366,672511,-672511
2022-01-10,2381,2381,2305,2335,7208782,524,5,6414363,794419,608,3,4498382,2710400,1915981,-1915981
2022-01-11,2339,2417,2329,2354,8316925,461,6,7099843,1217082,662,4,6366665,1950260,733178,-733178
2022-01-12,2354,2386,2310,2315,5548953,424,4,4878453,670500,477,1,5448953,100000,-570500,570500
2022-01-15,2289,2335,2235,2307,7877055,558,5,5081055,2796000,502,0,7877055,0,-2796000,2796000
2022-01-16,2227,2245,2155,2205,5161639,371,6,3353125,1808514,530,4,5058117,103522,-1704992,1704992
2022-01-17,2222,2259,2128,2140,4907303,494,5,4159310,747993,490,1,4905764,1539,-746454,746454
2022-01-18,2152,2187,2088,2090,9881236,662,7,7234760,2646476,478,2,9350527,530709,-2115767,2115767
2022-01-19,2045,2130,2045,2102,3938053,410,4,3471827,466226,427,0,3938053,0,-466226,466226
2022-01-22,2102,2153,2003,2025,6961698,660,7,5802365,1159333,542,2,6846500,115198,-1044135,1044135
2022-01-23,2008,2025,1967,1967,16137291,748,5,6754476,9382815,388,2,14279906,1857385,-7525430,7525430
2022-01-24,1911,1973,1873,1875,7091471,746,3,6183814,907657,576,2,7056851,34620,-873037,873037
2022-01-25,1838,1886,1811,1811,8296773,538,2,5496773,2800000,196,1,6996773,1300000,-1500000,1500000
2022-01-26,1865,1890,1756,1863,7183331,603,4,6487774,695557,688,1,7163331,20000,-675557,675557
2022-01-29,1930,1930,1878,1930,10700726,191,5,7524164,3176562,412,3,8763369,1937357,-1239205,1239205
2022-01-30,1923,2022,1918,2003,7761452,668,4,7131452,630000,542,3,7558380,203072,-426928,426928
2022-01-31,1921,2057,1903,2057,14980219,398,7,11047848,3932371,798,8,10035573,4944646,1012275,-1012275
2022-02-01,2137,2137,1998,2003,8624267,628,6,6961468,1662799,486,3,7438984,1185283,-477516,477516
2022-02-02,1992,2037,1953,1968,6326394,625,3,5648837,677557,464,1,5756394,570000,-107557,107557
2022-02-05,2007,2037,1970,1985,5555526,475,4,4897153,658373,525,3,4443181,1112345,453972,-453972
2022-02-06,1988,1988,1901,1901,6201309,424,4,3331309,2870000,228,0,6201309,0,-2870000,2870000
2022-02-07,1845,1905,1840,1868,4275929,438,6,3873185,402744,529,1,4045139,230790,-171954,171954
2022-02-08,1868,1970,1868,1895,5228198,431,4,4963198,265000,525,5,4383150,845048,580048,-580048
2022-02-09,1951,1977,1870,1953,6196398,418,4,4643692,1552706,891,3,5640397,556001,-996705,996705
2022-02-12,1933,2018,1886,2018,27063852,646,5,19844886,7218966,1240,10,18275459,8788393,1569427,-1569427
2022-02-13,2017,2042,1961,1963,6084063,469,6,5368912,715151,569,4,6078641,5422,-709729,709729
2022-02-14,1972,2037,1936,1992,5871360,310,5,5105537,765823,494,1,5836360,35000,-730823,730823
2022-02-16,1970,2023,1943,1992,4459376,339,6,3458535,1000841,459,1,4389376,70000,-930841,930841
2022-02-19,2003,2085,1965,2083,26698534,935,6,24759995,1938539,1357,6,18940092,7758442,5819903,-5819903
2022-02-20,2100,2163,2042,2092,12229576,718,6,11142401,1087175,961,5,11877295,352281,-734894,734894
2022-02-21,2170,2215,2170,2215,11128108,107,2,10118108,1010000,453,4,2534929,8593179,7583179,-7583179
2022-02-22,2324,2324,2290,2324,84730885,2142,16,79108527,5622358,2871,18,68254110,16476775,10854417,-10854417
2022-02-23,2327,2369,2282,2329,20880844,1063,8,20166889,713955,1336,5,18288803,2592041,1878086,-1878086
2022-02-26,2285,2287,2219,2219,25539121,1070,9,16357409,9181712,1046,4,24366974,1172147,-8009565,8009565
2022-02-27,2252,2292,2148,2254,16061217,749,3,15206753,854464,931,4,15470685,590532,-263932,263932
2022-02-28,2242,2317,2220,2239,8448050,536,3,8323050,125000,595,1,8438050,10000,-115000,115000
2022-03-02,2194,2252,2155,2162,8318892,587,6,7846309,472583,658,0,8318892,0,-472583,472583
2022-03-05,2284,2300,2224,2300,44525623,772,4,42973623,1552000,916,8,28155084,16370539,14818539,-14818539
2022-03-06,2334,2414,2300,2414,45049651,1170,14,28516288,16533363,1659,13,38110353,6939298,-9594065,9594065
2022-03-07,2387,2401,2279,2279,48298061,1942,9,31091189,17206872,1281,6,47425704,872357,-16334515,16334515
2022-03-08,2220,2279,2197,2210,7685885,654,3,7339929,345956,611,1,7492507,193378,-152578,152578
2022-03-09,2265,2337,2212,2284,12689806,641,7,10247701,2442105,753,4,12415672,274134,-2167971,2167971
2022-03-12,2177,2210,2177,2187,31356289,902,9,9802511,21553778,761,0,31356289,0,-21553778,21553778
2022-03-13,2153,2170,2087,2132,11197715,646,5,9394613,1803102,594,5,7707596,3490119,1687017,-1687017
2022-03-14,2113,2197,2113,2145,4842863,363,4,3202863,1640000,488,1,4706696,136167,-1503833,1503833
2022-03-15,2168,2209,2138,2148,6169968,378,4,5049501,1120467,443,2,5169236,1000732,-119735,119735
2022-03-16,2272,2272,2269,2272,16966278,289,3,14656278,2310000,586,7,5473751,11492527,9182527,-9182527
2022-03-19,2386,2386,2386,2386,16160597,487,2,15764794,395803,653,7,6229497,9931100,9535297,-9535297
2022-03-26,2404,2504,2387,2454,34788024,1092,6,33263356,1524668,1337,6,25710960,9077064,7552396,-7552396
2022-03-27,2469,2599,2424,2599,38278012,1131,9,33442111,4835901,1404,11,19820627,18457385,13621484,-13621484
2022-03-28,2663,2706,2581,2659,19496418,1366,10,16585153,2911265,1202,2,19459548,36870,-2874395,2874395
2022-03-29,2706,2706,2521,2529,21904298,1292,5,13523986,8380312,1255,3,21303397,600901,-7779411,7779411
2022-03-30,2529,2673,2474,2644,17535747,820,8,8583770,8951977,1106,2,16985747,550000,-8401977,8401977
2022-04-03,2663,2739,2611,2739,27692055,890,4,25715812,1976243,1224,8,21460626,6231429,4255186,-4255186
2022-04-04,2694,2784,2588,2688,19896475,1427,5,18630931,1265544,1272,4,19740212,156263,-1109281,1109281
2022-04-05,2681,2733,2574,2691,25366416,1057,6,22572765,2793651,998,4,24466660,899756,-1893895,1893895
2022-04-06,2591,2704,2584,2678,37464224,979,8,24011244,13452980,1173,7,34637012,2827212,-10625768,10625768
2022-04-09,2703,2788,2604,2768,31433793,1040,8,24754108,6679685,1755,7,29249109,2184684,-4495001,4495001
2022-04-10,2838,2838,2706,2721,11578645,1031,4,10191211,1387434,946,2,11178644,400001,-987433,987433
2022-04-11,2754,2759,2634,2664,11223889,1116,4,9615783,1608106,927,3,10661378,562511,-1045595,1045595
2022-04-12,2639,2639,2539,2539,13641947,865,7,5621947,8020000,532,0,13641947,0,-8020000,8020000
2022-04-13,2454,2621,2446,2547,11637901,797,8,10212211,1425690,793,3,11205189,432712,-992978,992978
2022-04-16,2547,2658,2547,2658,18117418,308,6,12210170,5907248,1044,3,11135394,6982024,1074776,-1074776
2022-04-17,2714,2766,2629,2766,40215380,695,9,32236909,7978471,1803,13,25635816,14579564,6601093,-6601093
2022-04-18,2771,2880,2763,2771,28639675,1410,9,25207667,3432008,1638,14,20337835,8301840,4869832,-4869832
2022-04-19,2771,2866,2738,2803,12225493,880,8,9183613,3041880,941,5,11434458,791035,-2250845,2250845
2022-04-20,2753,2801,2673,2713,13544580,1047,8,11195556,2391938,898,1,13487494,100000,-2291938,2291938
2022-04-24,2711,2788,2703,2711,10185902,585,4,7951843,2234059,808,4,9676854,509048,-1725011,1725011
2022-04-25,2724,2788,2696,2716,14361161,841,4,10165581,4195580,727,8,11200714,3160447,-1035133,1035133
2022-04-26,2820,2856,2729,2810,22129390,866,5,14006113,8123277,1687,7,18189225,3940165,-4183112,4183112
2022-04-27,2838,2933,2779,2838,15175433,789,9,10273877,4901556,1225,1,15090433,85000,-4816556,4816556
2022-04-30,2983,2983,2921,2983,20698298,288,4,19829410,868888,1087,7,10501379,10196919,9328031,-9328031
2022-05-01,3088,3130,3013,3128,49854325,1789,10,44579683,5274642,2806,18,30319937,19534388,14259746,-14259746
2022-05-02,3170,3254,3038,3122,22274853,1257,6,21244867,1029986,1586,8,15368720,6906133,5876147,-5876147
2022-05-07,3105,3170,2988,3002,28203014,1533,11,18652613,9550401,1629,4,28057583,145431,-9404970,9404970
2022-05-08,3005,3170,2971,3088,20956850,1011,6,15753319,5203531,1363,5,16634849,4322001,-881530,881530
2022-05-09,3105,3147,3038,3057,14130652,417,9,7892873,6237779,987,6,12559652,1571000,-4666779,4666779
2022-05-10,3163,3170,2988,3138,20443359,735,3,16588636,3854723,1348,8,15613609,4829750,975027,-975027
2022-05-11,3284,3284,3130,3284,45709469,861,10,35396951,10312518,2068,20,23687508,22021961,11709443,-11709443
2022-05-14,3307,3389,3239,3352,24249148,1059,10,19522278,4726870,1804,9,21699628,2549520,-2177350,2177350
2022-05-15,3390,3467,3322,3392,32425094,1124,8,28115981,4309113,1903,11,24115870,8309224,4000111,-4000111
2022-05-16,3289,3419,3265,3320,27361855,1092,12,18926842,8435013,2184,11,18482514,8879341,444328,-444328
2022-05-17,3389,3436,3337,3364,22715479,716,8,11605310,11110169,1299,10,17168274,5547205,-5562964,5562964
2022-05-18,3365,3367,3305,3365,18389210,507,6,7670984,10718226,1284,5,14078230,4310980,-6407246,6407246
2022-05-21,3352,3395,3280,3330,13361531,544,10,9639706,3721825,1007,9,9814069,3547462,-174363,174363
2022-05-22,3315,3501,3310,3501,36094073,580,7,32287569,3806504,1385,14,22410596,13683477,9876973,-9876973
2022-05-23,3549,3634,3357,3623,39228583,1654,17,36112539,3116044,2409,8,38053173,1175410,-1940634,1940634
2022-05-24,3581,3694,3581,3694,88808571,2417,21,74703679,14104892,3201,22,73133926,15674645,1569753,-1569753
2022-05-25,3704,3868,3694,3868,56558716,1778,19,46173696,10385020,2707,19,38837275,17721441,7336421,-7336421
2022-05-28,3913,3971,3651,3664,32454632,1629,14,27497014,4957618,2158,10,30512303,1942329,-3015289,3015289
2022-05-29,3654,3731,3582,3606,50176771,1372,22,29220281,20956490,1985,9,45293072,4883699,-16072791,16072791
2022-05-30,3629,3723,3562,3636,18505037,917,9,12242365,6262672,1292,14,14551939,3953098,-2309574,2309574
2022-05-31,3653,3713,3576,3701,9179031,608,10,6356741,2822290,958,5,8891346,287685,-2534605,2534605
2022-06-01,3532,3634,3479,3491,12693857,910,11,10197521,2496336,998,3,12326820,367037,-2129299,2129299
2022-06-06,3489,3506,3355,3355,17140652,542,13,4178883,12961769,437,0,17140652,0,-12961769,12961769
2022-06-07,3198,3302,3198,3198,42451387,1436,22,17926614,24524773,1397,7,32899498,9551889,-14972884,14972884
2022-06-08,3249,3360,3165,3360,27933082,1043,14,25034869,2898213,1377,11,20063082,7870000,4971787,-4971787
2022-06-11,3441,3469,3205,3412,17838131,1000,11,14106796,3731335,1213,10,13959501,3878630,147295,-147295
2022-06-12,3339,3444,3247,3339,11923008,740,8,9169414,2753594,928,5,9479652,2443356,-310238,310238
2022-06-13,3436,3524,3352,3365,15368162,865,5,12051554,3316608,886,6,12850682,2517480,-799128,799128
2022-06-14,3359,3464,3260,3260,32160405,1053,10,12270756,19889649,860,7,29502002,2658403,-17231246,17231246
2022-06-15,3302,3302,3140,3193,18414779,872,8,10976685,7438094,790,6,11383994,7030785,-407309,407309
2022-06-18,3047,3222,3032,3047,27798639,1043,13,11462813,16335826,936,1,27666210,132429,-16203397,16203397
2022-06-19,3103,3197,3042,3138,13743065,587,14,8098830,5644235,799,7,9193834,4549231,-1095004,1095004
2022-06-20,3147,3265,3147,3265,20256940,241,2,18285054,1971886,869,10,8049342,12207598,10235712,-10235712
2022-06-21,3345,3422,3332,3422,39643166,890,19,28794315,10848851,1643,17,23887695,15755471,4906620,-4906620
2022-06-22,3461,3581,3442,3572,49104907,1531,28,34060301,15044606,2307,19,28526389,20578518,5533912,-5533912
2022-06-25,3673,3723,3496,3497,23908829,1250,9,21174211,2734618,1494,6,19157880,4750949,2016331,-2016331
2022-06-26,3506,3581,3439,3452,12411778,558,8,10160459,2251319,924,8,11216523,1195255,-1056064,1056064
2022-06-27,3659,3659,3447,3659,30204360,711,11,22708535,7495825,1331,15,19149909,11054451,3558626,-3558626
2022-06-28,3748,3821,3748,3788,44227378,1631,13,39211158,5016220,1583,24,23091748,21135630,16119410,-16119410
2022-07-25,3456,3628,3456,3628,37865230,390,15,24864445,13000785,673,9,32877922,4987308,-8013477,8013477
2022-07-26,3643,3699,3527,3624,64017695,1471,15,47596043,16421652,2294,27,47370674,16647021,225369,-225369
2022-07-27,3651,3739,3569,3698,17220160,699,7,11402079,5818081,1654,4,16968880,251280,-5566801,5566801
2022-07-30,3673,3796,3482,3482,19739230,830,13,11340229,8399001,1239,7,15720191,4019039,-4379962,4379962
2022-07-31,3422,3471,3389,3422,26187743,453,14,12589743,13598000,962,5,21575443,4612300,-8985700,8985700
2022-08-01,3372,3552,3372,3456,6150532,391,5,5586532,564000,775,2,5975889,174643,-389357,389357
2022-08-02,3469,3502,3390,3467,7582381,331,5,4954698,2627683,707,3,7461099,121282,-2506401,2506401
2022-08-03,3621,3623,3437,3623,11656554,313,9,7521662,4134892,937,4,10958821,697733,-3437159,3437159
2022-08-06,3746,3768,3694,3768,23185714,712,9,22472594,713120,1093,11,18317996,4867718,4154598,-4154598
2022-08-09,3808,3935,3656,3758,13891255,739,12,10359109,3532146,954,5,13610255,281000,-3251146,3251146
2022-08-10,3689,3789,3609,3698,9772506,477,13,6848775,2923731,716,4,9681517,90989,-2832742,2832742
2022-08-13,3784,3861,3784,3861,13898444,332,6,11277334,2621110,862,14,8999568,4898876,2277766,-2277766
2022-08-14,3840,3990,3813,3846,15883445,990,13,12441252,3442193,1064,6,15265150,618295,-2823898,2823898
2022-08-15,3840,4040,3794,3940,20061118,1052,12,18727120,1333998,1135,10,18671769,1389349,55351,-55351
2022-08-16,3845,4090,3818,3843,14508504,1103,13,12024495,2484009,938,4,13213690,1294814,-1189195,1189195
2022-08-17,3845,4006,3798,3893,15139762,851,14,10169141,4949525,867,4,14975000,143666,-4805859,4805859
2022-08-20,3871,3978,3808,3880,9727895,552,8,8046078,1681817,893,3,9635148,92747,-1589070,1589070
2022-08-21,3890,3996,3880,3898,8012538,520,7,5545255,2467283,721,5,7437873,574665,-1892618,1892618
2022-08-22,3895,3971,3840,3846,9671950,467,14,4901742,4770208,685,3,9029574,642376,-4127832,4127832
2022-08-23,4070,4075,3881,4070,40114184,1382,17,37148927,2965257,1526,17,21850697,18263487,15298230,-15298230
2022-08-24,4264,4264,4073,4264,21017990,751,10,17812240,3205750,1326,12,13226203,7791787,4586037,-4586037
2022-08-27,4207,4422,4173,4207,21836983,2044,12,19858256,1978727,1721,9,20021538,1815445,-163282,163282
2022-08-28,4125,4259,4088,4123,21822610,1296,18,11211907,10610703,1234,15,18055291,3767319,-6843384,6843384
2022-08-29,4152,4334,4130,4334,25012154,827,15,20290169,4721985,1285,12,21691454,3320700,-1401285,1401285
2022-08-30,4314,4424,4275,4319,16375071,1222,15,14165869,2209202,1116,6,14717268,1657803,-551399,551399
2022-08-31,4285,4365,4235,4302,9676940,666,8,5578973,4097967,958,6,8851812,825128,-3272839,3272839
2022-09-03,4087,4198,4087,4087,29974013,1231,20,12877180,17096833,973,6,26873743,3100270,-13996563,13996563
2022-09-04,4053,4172,3983,4062,8558202,702,6,7814798,743404,739,6,7542152,1016050,272646,-272646
2022-09-05,4073,4173,4067,4075,6497831,537,5,5392611,1105220,640,4,5092176,1405655,300435,-300435
2022-09-06,4016,4110,3973,3990,7056259,624,9,5195329,1860930,658,6,6762787,293472,-1567458,1567458
2022-09-07,4001,4023,3931,3933,8976881,439,12,4875925,4100956,643,6,8036990,939891,-3161065,3161065
2022-09-10,3925,3925,3766,3768,41692789,1392,21,15826519,25866270,972,6,40244680,1448109,-24418161,24418161
2022-09-11,3768,3831,3581,3592,18757857,1035,23,10826465,7931392,1041,4,17537857,1220000,-6711392,6711392
2022-09-12,3592,3656,3534,3626,8759612,551,11,5703931,3055681,651,5,8535511,224101,-2831580,2831580
2022-09-13,3609,3769,3596,3683,7797200,588,10,6119935,1677265,548,3,7281658,515542,-1161723,1161723
2022-09-14,3691,3739,3628,3648,5100467,367,8,4074521,1025946,473,1,5078347,22120,-1003826,1003826
2022-09-18,3574,3674,3522,3584,5779617,367,8,2282587,3497030,596,1,5579617,200000,-3297030,3297030
2022-09-19,3683,3724,3502,3681,6295697,464,7,5313123,982574,593,4,5976178,319519,-663055,663055
2022-09-20,3833,3833,3756,3779,32190192,1254,15,19289464,12900728,1049,22,18703750,13486442,585714,-585714
2022-09-21,3714,3811,3689,3741,6747012,379,10,4329217,2417795,592,5,6208946,538066,-1879729,1879729
2022-09-24,3556,3731,3552,3552,20854194,675,14,6530133,14324061,595,4,20202865,651329,-13672732,13672732
2022-09-26,3472,3673,3472,3589,6620722,410,6,5334265,1286457,478,3,6232513,388209,-898248,898248
2022-09-28,3673,3748,3589,3673,13968916,467,16,6147588,7821328,651,5,11312999,2655917,-5165411,5165411
2022-10-04,3503,3592,3503,3542,24526205,727,11,8419805,16106400,409,9,19574572,4951633,-11154767,11154767
2022-10-08,3526,3565,3392,3409,9946686,677,7,6805396,3141290,598,8,6724879,3221807,80517,-80517
2022-10-09,3315,3373,3315,3315,27536085,779,14,10244660,17291425,693,8,25706469,1829616,-15461809,15461809
2022-10-10,3236,3382,3236,3352,6510829,366,8,5376549,1134280,546,5,5147871,1362958,228678,-228678
2022-10-11,3390,3430,3353,3373,6775667,347,9,3887340,2888327,380,6,3367136,3408531,520204,-520204
2022-10-12,3403,3457,3313,3453,5678599,266,6,5221400,457199,514,4,4808499,870100,412901,-412901
2022-10-15,3450,3494,3323,3342,3660963,316,6,3188242,472721,357,2,3044720,616243,143522,-143522
2022-10-16,3402,3402,3267,3282,4797842,392,6,3751409,1046433,436,1,4432786,365056,-681377,681377
2022-10-17,3271,3325,3163,3294,11823483,610,10,8509396,3314087,442,5,11360460,463023,-2851064,2851064
2022-10-18,3277,3305,3227,3286,6589194,253,7,4362360,2226834,439,5,5667265,921929,-1304905,1304905
2022-10-19,3440,3440,3259,3438,37055189,594,15,23304620,13750569,675,18,15451697,21603492,7852923,-7852923
2022-10-22,3578,3578,3578,3578,5603259,50,0,5603259,0,244,2,903259,4700000,4700000,-4700000
2022-10-23,3649,3726,3630,3648,67310600,1481,17,53081680,14228920,1149,23,44134716,23175884,8946964,-8946964
2022-10-24,3592,3663,3548,3563,8251801,489,9,7060602,1191199,666,4,7352265,899536,-291663,291663
2022-10-25,3594,3611,3521,3532,7428638,328,8,4592048,2836590,635,8,5294306,2134332,-702258,702258
2022-10-26,3398,3551,3398,3398,17052829,514,10,8955802,8097027,684,7,16301228,751601,-7345426,7345426
2022-10-29,3459,3544,3355,3448,14600716,294,7,10436692,4164024,634,6,13377978,1222738,-2941286,2941286
2022-10-30,3388,3561,3388,3553,14323637,370,13,9295928,5027709,604,10,11496644,2826993,-2200716,2200716
2022-10-31,3586,3672,3557,3672,31890634,525,12,19410043,12480591,773,16,18654686,13235948,755357,-755357
2022-11-01,3757,3849,3719,3721,23792814,824,9,16751514,7041300,769,23,16863878,6928936,-112364,112364
2022-11-02,3738,3920,3680,3870,22976750,656,12,18070758,4905992,943,16,14948608,8028142,3122150,-3122150
2022-11-05,4003,4003,4003,4003,7688260,134,2,7671238,323908,413,9,2350954,5644192,5320284,-5320284
2022-11-06,4076,4203,4026,4203,56635532,1197,17,43137833,13497699,1428,31,43817157,12818375,-679324,679324
2022-11-07,4286,4382,4270,4382,40453954,1225,17,31900162,8553792,1102,25,27552352,12901602,4347810,-4347810
2022-11-08,4458,4512,4253,4336,34573904,1010,20,17372401,17201503,1360,13,31346990,3226914,-13974589,13974589
2022-11-09,4324,4555,4247,4537,36506194,918,17,24258289,12247905,1509,22,29423978,7082216,-5165689,5165689
2022-11-12,4606,4630,4482,4608,60669035,1240,17,48488257,12180778,1435,22,32465834,28203201,16022423,-16022423
2022-11-13,4641,4804,4520,4631,39058674,1146,15,31597397,7461277,1368,29,29455071,9603603,2142326,-2142326
2022-11-14,4614,4726,4508,4574,28383637,683,22,14617458,13766179,1196,11,23223516,5160121,-8606058,8606058
2022-11-15,4597,4756,4535,4641,19694408,613,9,12545474,7148934,862,9,13947750,5746658,-1402276,1402276
2022-11-16,4687,4689,4593,4612,9094368,595,13,5113058,3981310,742,10,8061871,1032497,-2948813,2948813
2022-11-19,4520,4593,4405,4455,43745086,1025,29,11802729,31942357,912,10,41118711,2626375,-29315982,29315982
2022-11-20,4468,4557,4407,4409,14230500,599,14,7202040,7028460,455,11,8076291,6154209,-874251,874251
2022-11-21,4384,4514,4384,4449,16928805,476,15,5302144,11626661,605,8,14919211,2009594,-9617067,9617067
2022-11-22,4384,4482,4364,4403,10778490,447,17,4940046,5838444,531,3,10443399,335091,-5503353,5503353
2022-11-23,4420,4566,4420,4476,12794691,616,11,10315806,2489335,636,8,12087834,717307,-1772028,1772028
2022-11-26,4503,4728,4503,4616,25138326,1490,12,22130900,3007426,1059,18,18832966,6305360,3297934,-3297934
2022-11-27,4664,4710,4580,4660,13297142,712,5,8284399,5012743,681,7,8633899,4663243,-349500,349500
2022-11-28,4662,4728,4614,4647,5668112,518,8,4756722,911390,610,6,4928865,739247,-172143,172143
2022-11-29,4647,4774,4622,4747,13154930,564,16,9346203,3808727,748,8,11252921,1902009,-1906718,1906718
2022-11-30,4781,4781,4631,4631,7612620,464,11,5628300,1984320,510,8,5647829,1964791,-19529,19529
2022-12-03,4631,4683,4462,4522,27057493,1410,18,14285972,12771521,821,7,22509968,4547525,-8223996,8223996
2022-12-04,4468,4583,4416,4514,10027244,697,11,7508516,2518728,707,6,9006285,1020959,-1497769,1497769
2022-12-05,4435,4512,4326,4403,8307377,582,15,4719540,3587837,606,5,7655853,651524,-2936313,2936313
2022-12-06,4407,4514,4362,4495,7816596,451,12,5753525,2063071,576,7,6994654,821942,-1241129,1241129
2022-12-07,4495,4545,4422,4426,6170631,432,14,4041274,2129357,511,2,5759091,411540,-1717817,1717817
2022-12-10,4251,4485,4251,4251,9834372,766,10,5574139,4260233,477,7,6197729,3636643,-623590,623590
2022-12-11,4282,4391,4174,4282,9271460,583,11,7849273,1422187,469,10,6986778,2284682,862495,-862495
2022-12-12,4362,4499,4268,4499,16444654,652,9,13062614,3382040,952,21,9888540,6556114,3174074,-3174074
2022-12-13,4547,4704,4541,4704,16908656,565,9,12830459,4078197,1215,10,14634077,2274579,-1803618,1803618
2022-12-14,4704,4862,4603,4618,11264917,716,13,7979686,3285231,906,4,11009269,255648,-3029583,3029583
2022-12-17,4708,4795,4612,4687,12430520,509,15,7233115,5197405,973,9,10777990,1652530,-3544875,3544875
2022-12-18,4718,4860,4670,4747,9407588,563,12,5861896,3545692,755,7,6978733,2428855,-1116837,1116837
2022-12-19,4802,4802,4583,4603,7791097,497,13,4240405,3550692,659,5,7159191,631906,-2918786,2918786
2022-12-20,4651,4651,4453,4507,7544969,645,9,6347152,1197817,515,3,7264023,280946,-916871,916871
2022-12-21,4524,4733,4524,4599,8470424,511,12,7328520,1141904,563,2,8290452,179972,-961932,961932
2022-12-24,4693,4854,4631,4801,16843833,783,17,12554198,4289635,1090,6,13198865,3644968,-644667,644667
2022-12-25,4866,4977,4737,4929,18124805,818,17,13355466,4769339,1164,12,13322849,4801956,32617,-32617
2022-12-26,4985,5133,4889,5133,34830451,753,18,27552984,7277467,1324,18,13848508,20981943,13704476,-13704476
2022-12-28,5323,5352,5266,5352,58014367,1740,25,45180857,12833510,1620,18,37271802,20742565,7909055,-7909055
2022-12-31,5079,5266,5079,5079,36505320,1677,23,23034396,13470924,1498,12,24152258,12353062,-1117862,1117862
2023-01-01,5079,5264,4981,5093,22005232,1069,9,14956522,7048710,1388,13,18569228,3436004,-3612706,3612706
2023-01-02,5285,5350,5268,5350,19981607,411,2,19700323,281284,792,9,4526907,15454700,15173416,-15173416
2023-01-03,5466,5573,5366,5466,36290635,1387,22,20840378,15450257,1419,22,25094507,11196128,-4254129,4254129
2023-01-04,5404,5752,5404,5752,43670839,1342,22,32954093,10716746,1940,32,18724575,24946264,14229518,-14229518
2023-01-07,5938,6006,5811,5879,27215186,2004,16,20907550,6307636,1858,18,20533212,6681974,374338,-374338
2023-01-08,5957,6004,5748,5957,34402552,2444,24,22738790,11663762,2205,22,26983881,7418671,-4245091,4245091
2023-01-09,5767,5996,5767,5938,29091676,1630,16,22628116,6465610,1478,21,20634017,8459709,1994099,-1994099
2023-01-10,6111,6125,5881,5934,22297072,1385,17,17138020,5159052,1122,19,15252265,7044807,1885755,-1885755
2023-01-11,5934,6092,5708,5861,16966155,1364,14,14448845,2517310,1173,13,12876444,4089711,1572401,-1572401
2023-01-14,5767,5906,5606,5871,12419577,1029,15,10158579,2260998,1140,8,9866327,2553250,292252,-292252
2023-01-16,5956,6088,5956,6015,14694860,1051,14,11892902,2801958,1299,13,11281777,3413083,611125,-611125
2023-01-17,6075,6188,5861,5938,15846632,1215,20,10712772,5133860,1475,11,12390325,3456307,-1677553,1677553
2023-01-18,5977,6052,5765,5804,15197189,1395,22,10334531,4862658,1225,11,12930177,2267012,-2595646,2595646
2023-01-21,5613,5756,5558,5558,9968565,1230,10,5786850,4181715,243,3,6688555,3280010,-901705,901705
2023-01-22,5439,5477,5296,5333,69573354,4401,32,45664309,23909045,2249,12,63338388,6234966,-17674079,17674079
2023-01-23,5256,5469,5060,5256,21779628,2033,9,17565137,4214491,1627,9,20826526,953102,-3261389,3261389
2023-01-24,5285,5362,5208,5293,12380327,1019,13,7323321,5057006,985,10,9113517,3266810,-1790196,1790196
2023-01-25,5141,5296,5048,5083,23410023,1057,14,9212340,14197683,1216,9,21087404,2322619,-11875064,11875064
2023-01-28,4983,5181,4874,4899,20521332,1791,16,15915314,4606018,1168,11,16138760,4382572,-223446,223446
2023-01-29,4747,4901,4670,4674,23400730,1052,13,15072192,8328538,1248,3,22038041,1362689,-6965849,6965849
2023-01-30,4612,4910,4581,4910,24072608,1365,14,21466018,2606590,1427,17,12974824,11097784,8491194,-8491194
2023-01-31,4956,5062,4847,4949,11351496,1214,5,9704901,1646595,857,6,10939478,412018,-1234577,1234577
2023-02-01,4958,5006,4822,4839,9386236,875,11,5947769,3438467,752,6,9365194,21042,-3417425,3417425
2023-02-05,4824,4824,4651,4651,14268898,976,9,8125578,6143320,678,5,12915332,1353566,-4789754,4789754
2023-02-06,4583,4899,4460,4802,15806537,625,14,7391069,8415468,1076,7,8761127,7045410,-1370058,1370058
2023-02-07,4910,4949,4785,4806,8736460,698,3,5896192,2840268,572,6,6845217,1891243,-949025,949025
2023-02-08,4843,4974,4787,4864,8512850,531,8,5923456,2589394,742,12,5331624,3181226,591832,-591832
2023-02-12,4718,4833,4718,4826,5867830,323,5,3470024,2397806,555,2,5365830,502000,-1895806,1895806
2023-02-13,4824,4910,4745,4751,6823970,548,7,4676666,2147304,526,2,6603258,220712,-1926592,1926592
2023-02-14,4766,4804,4608,4608,7003827,622,10,3662074,3341753,562,3,5986650,1017177,-2324576,2324576
2023-02-15,4464,4718,4464,4578,5281594,430,6,2303740,2977854,502,4,5129353,152241,-2825613,2825613
2023-02-19,4574,4835,4574,4835,7309759,415,16,5506476,1803283,989,7,6061656,1248103,-555180,555180
2023-02-20,4991,4997,4897,4997,4546993,88,2,4513993,33000,504,4,2359993,2187000,2154000,-2154000
2023-02-21,5221,5221,5221,5221,7577383,94,5,7040112,537271,536,10,3412655,4164728,3627457,-3627457
2023-02-22,5287,5481,5210,5375,36705395,1628,27,24891914,11813481,1864,27,23657752,13047643,1234162,-1234162
2023-02-25,5544,5617,5544,5617,38370765,1125,20,24221294,14149471,1235,25,15103437,23267328,9117857,-9117857
2023-02-26,5612,5898,5567,5671,36997441,1914,31,16460810,20536631,2253,20,30915647,6081794,-14454837,14454837
2023-02-27,5514,5869,5514,5640,34922539,1133,27,9997119,24925420,1605,12,21289827,13632712,-11292708,11292708
2023-02-28,5698,5785,5571,5736,20259239,759,21,10155516,10103723,1176,19,18510339,1748900,-8354823,8354823
2023-03-01,5683,5875,5565,5565,21513950,760,21,9851734,11662216,1156,14,15550619,5963331,-5698885,5698885
2023-03-04,5573,5642,5392,5414,27295776,1065,19,11422052,15873724,1200,11,23153500,4142276,-11731448,11731448
2023-03-05,5642,5794,5550,5727,16607610,967,10,14613763,1993847,1486,11,13693025,2914585,920738,-920738
2023-03-06,5744,5967,5612,5877,19242410,843,17,12354899,6887511,1078,13,12460766,6781644,-105867,105867
2023-03-07,5956,6102,5888,6102,30317860,1522,12,24506175,5811685,2112,19,18347039,11970821,6159136,-6159136
2023-03-11,6282,6301,5948,5948,21063940,1329,13,12319428,8744512,1285,13,17382733,3681207,-5063305,5063305
2023-03-12,5917,5934,5767,5781,46403904,1667,21,14855008,31548896,1555,13,24467855,21936049,-9612847,9612847
2023-03-25,6107,6107,6107,6107,14962147,295,2,14962147,0,238,7,289473,14672674,14672674,-14672674
2023-03-26,6411,6411,6411,6411,17857935,201,12,16459935,1398000,279,4,857855,17000080,15602080,-15602080
2023-03-27,6730,6730,6606,6730,181418788,5208,23,150706438,30712350,2284,30,119575050,61843738,31131388,-31131388
2023-03-28,7023,7023,6694,6797,70199778,5237,12,63681901,6517877,2276,17,59723060,10476718,3958841,-3958841
2023-03-29,6822,7177,6714,7177,83873023,3885,14,51618729,32254294,2760,26,66751235,17121788,-15132506,15132506
2023-04-03,7116,7203,6745,7116,54311866,3611,16,46678942,7632924,2247,10,45256269,9055597,1422673,-1422673
2023-04-04,7049,7270,6812,7075,46965231,2822,12,35425140,11540091,2089,8,40685740,6279491,-5260600,5260600
2023-04-05,6853,7038,6792,6941,38193418,2746,14,31850543,6342875,1770,5,35857971,2335447,-4007428,4007428
2023-04-08,7172,7270,6879,7270,122625668,2991,29,62307213,60318455,2665,25,78457387,44168281,-16150174,16150174
2023-04-09,7347,7568,7306,7568,166680272,4637,31,132447754,34232518,2403,33,48203763,118476509,84243991,-84243991
2023-04-10,7280,7862,7193,7285,76600248,3973,16,51499300,25100948,2875,7,72542039,4058209,-21042739,21042739
2023-04-11,7563,7857,7311,7769,55916734,2158,10,44634250,11282484,1680,16,29830910,26085824,14803340,-14803340
2023-04-15,7846,8052,7846,8052,81081161,2489,18,51991707,29089454,1945,19,30955053,50126108,21036654,-21036654
2023-04-16,8433,8433,8047,8433,123858935,4475,22,103145817,20713118,2670,28,60449333,63409602,42696484,-42696484
2023-04-17,8567,8762,8237,8762,116068060,2422,19,79335599,36732461,1926,19,32875011,83193049,46460588,-46460588
2023-04-18,9102,9163,9030,9163,127344074,3021,27,85028473,42315601,1567,12,35304074,92040000,49724399,-49724399
2023-04-19,9616,9616,9364,9616,184895163,5412,21,145631040,39264123,2731,19,65746935,119148228,79884105,-79884105
2023-04-24,9750,9930,9133,9431,107809296,6021,19,69604360,38204936,3891,21,90868822,16940474,-21264462,21264462
2023-04-25,9529,9657,9148,9184,136853286,6075,31,81098571,55754715,4409,19,123848474,13004812,-42749903,42749903
2023-04-26,9184,9477,9014,9349,73981313,3420,25,52930911,21050402,3254,19,56773609,17207704,-3842698,3842698
2023-04-29,9287,9518,9210,9215,74784594,3319,22,47617245,27167349,2557,13,52820446,21964148,-5203201,5203201
2023-04-30,9544,9678,9261,9565,45864916,2446,17,27917399,17947517,2012,9,42043741,3821175,-14126342,14126342
2023-05-01,9812,9997,9565,9812,93747128,3462,23,78023133,15723995,3497,23,56489934,37257194,21533199,-21533199
2023-05-02,10290,10393,10059,10393,51586190,3469,20,35719157,15867033,2256,17,34976565,16609625,742592,-742592
2023-05-03,10532,10625,9879,9915,74360456,5467,23,54300710,20059746,3308,6,68563480,5796976,-14262770,14262770
2023-05-06,9832,10198,9791,9827,92468881,4032,24,52413895,40054986,3668,15,78049767,14419114,-25635872,25635872
2023-05-07,10023,10028,9426,9426,52276626,2047,11,16637391,35639235,1618,4,52106667,169959,-35469276,35469276
2023-05-08,8973,9050,8973,8973,61232437,1046,14,11875716,49356721,1918,3,60003955,1228482,-48128239,48128239
2023-05-09,8525,8947,8525,8793,83153549,3344,21,53640189,29513360,4077,10,77911177,5242372,-24270988,24270988
2023-05-10,9050,9050,8232,8242,86228976,2218,12,27655117,58573859,2598,13,73004111,13224865,-45348994,45348994
2023-05-13,8232,8443,7929,8129,94727941,1802,19,30873636,63854305,3279,12,75102958,19624983,-44229322,44229322
2023-05-14,8232,8453,8232,8453,46621184,1163,7,44069357,2551827,1504,18,27259173,19362011,16810184,-16810184
2023-05-15,8865,8865,8592,8865,106720420,2346,11,93590098,13130322,2000,29,51080293,55640127,42509805,-42509805
2023-05-17,9266,9292,8891,9143,38818652,2234,8,33408652,5410000,1546,9,29975009,8843643,3433643,-3433643
2023-05-20,9071,9256,8721,8747,67302544,3425,14,37280770,30021774,1961,10,63765046,3537498,-26484276,26484276
2023-05-21,8618,9235,8618,8952,30847955,1806,9,29715927,1132028,1497,10,25005081,5842874,4710846,-4710846
2023-05-22,9133,9323,8886,9030,34385108,1742,16,23107954,11277154,1403,4,25994608,8390500,-2886654,2886654
2023-05-23,9205,9349,8952,9122,41228611,1263,22,18729461,22499150,1554,9,29737566,11491045,-11008105,11008105
2023-05-24,9174,9333,9035,9112,18854735,986,14,13428360,5426375,1381,6,17795069,1059666,-4366709,4366709
2023-05-27,9385,9621,9148,9380,96446187,2123,12,82065146,14381041,3263,28,51115518,45330669,30949628,-30949628
2023-05-28,9416,9503,9004,9205,66741631,1427,16,26715947,40025684,2116,16,41296636,25444995,-14580689,14580689
2023-05-29,9256,9441,9148,9261,46869583,1192,13,21304970,25564613,1122,13,16328651,30540932,4976319,-4976319
2023-05-30,9241,9570,9220,9416,21823080,992,13,17355157,4467923,1424,11,18666697,3156383,-1311540,1311540
2023-05-31,9416,9426,9230,9313,26933015,654,10,11085472,15847543,1251,9,21254933,5678082,-10169461,10169461
2023-06-03,9297,9416,9225,9297,19602125,628,6,15001619,4600506,1168,10,12542716,7059409,2458903,-2458903
2023-06-06,9493,9529,9271,9493,26537680,735,9,14292125,12245555,1574,12,18796977,7740703,-4504852,4504852
2023-06-07,9493,9585,9266,9405,18991363,604,10,7630007,11361356,1367,8,15699069,3292294,-8069062,8069062
2023-06-10,9261,9261,8978,8978,44457660,962,15,18428303,26029357,1603,9,43779410,678250,-25351107,25351107
2023-06-11,8988,9153,8839,8932,20674423,628,6,11307111,9367312,1959,6,18115966,2558457,-6808855,6808855
2023-06-12,9107,9112,8556,8577,46361698,1079,11,17045754,29315944,1291,11,39809012,6552686,-22763258,22763258
2023-06-13,8747,8952,8592,8747,15430936,721,6,9609301,5821635,801,5,11734085,3696851,-2124784,2124784
2023-06-14,8803,8937,8685,8685,12299233,876,7,9188337,3110896,777,7,10997775,1301458,-1809438,1809438
2023-06-17,8747,8752,8453,8587,26292830,1012,9,15572825,10720005,952,11,19026833,7265997,-3454008,3454008
2023-06-18,8500,8592,8350,8495,26098523,593,7,10620451,15478072,947,9,18806817,7291706,-8186366,8186366
2023-06-19,8438,8844,8428,8644,28286096,974,11,19246754,9039342,1083,15,21238413,7047683,-1991659,1991659
2023-06-20,8721,8896,8546,8798,12734978,531,7,6552099,6182879,746,6,7421812,5313166,-869713,869713
2023-06-21,8798,8880,8628,8680,15361521,560,12,5104863,10256658,775,5,13083670,2277851,-7978807,7978807
2023-06-24,8628,8685,8387,8644,12414792,631,6,4832955,7581837,725,5,12298089,116703,-7465134,7465134
2023-06-25,8597,8742,8479,8484,12048925,582,4,3508446,1223647,442,4,4358635,373458,-850189,850189
2023-06-26,8402,8644,8402,8489,13054015,690,12,5896883,7157132,766,5,10121392,2932623,-4224509,4224509
2023-06-27,8464,8618,8191,8340,15041165,864,9,8183528,6857637,648,6,13188103,1853062,-5004575,5004575
2023-06-28,8201,8330,8001,8196,9142230,688,8,4258350,4883880,584,5,7914166,1228064,-3655816,3655816
2023-07-01,8176,8253,8057,8129,10047666,596,9,5554535,4493131,612,3,9527367,520299,-3972832,3972832
2023-07-02,8217,8376,8011,8181,6412947,713,10,4180983,2231964,550,4,5949363,463584,-1768380,1768380
2023-07-03,8284,8577,8201,8577,11786626,663,12,7128594,4658032,911,5,11133075,653551,-4004481,4004481
2023-07-04,8803,8808,8592,8711,27512790,1720,8,25524574,1988216,1250,15,14549687,12963103,10974887,-10974887
2023-07-05,8752,9050,8649,8916,13596002,1009,6,11064078,2531924,881,8,9255021,4340981,1809057,-1809057
2023-07-08,8880,9117,8788,8870,8093657,397,8,5327821,2765836,545,2,5090405,3003252,237416,-237416
2023-07-09,8927,8927,8705,8731,13743122,410,5,4307726,9435396,772,4,12642335,1100787,-8334609,8334609
2023-07-10,8695,8747,8587,8603,11749130,387,5,4515327,7233803,685,1,11049130,700000,-6533803,6533803
2023-07-11,8721,8721,8284,8299,27306318,486,10,6586418,20719900,823,10,20152076,7154242,-13565658,13565658
2023-07-12,8232,8345,8001,8093,58641348,1243,14,13937632,44703716,753,6,53822009,4819339,-39884377,39884377
2023-07-15,8006,8227,7743,7862,10722524,710,8,6614268,4108256,612,2,9199604,1522920,-2585336,2585336
2023-07-16,7821,7965,7512,7527,24628912,673,14,7729349,16899563,868,7,20452402,4176510,-12723053,12723053
2023-07-17,7363,7584,7321,7347,26817409,797,14,12518114,14299295,811,3,23896612,2920797,-11378498,11378498
2023-07-18,7517,7707,7517,7707,14763471,299,2,14522555,240916,468,7,5833469,8930002,8689086,-8689086
2023-07-19,8083,8083,7923,8068,70591056,891,12,50163302,20427754,1292,11,47411517,23179539,2751785,-2751785
2023-07-22,8062,8284,7718,7754,26876602,809,8,25484829,1391773,888,6,20084256,6792346,5400573,-5400573
2023-07-23,8417,8417,7949,8417,20189157,474,1,19807558,381599,898,9,14621211,5567946,5186347,-5186347
2023-07-24,8695,8721,8515,8721,51930309,1329,11,46232738,5697571,1342,19,30190206,21740103,16042532,-16042532
2023-07-25,8273,8273,8273,8273,5416568,450,1,3716568,1700000,15,1,4916568,500000,-1200000,1200000
2023-07-26,7985,7985,7985,7985,9469183,584,2,2769183,6700000,104,7,8569183,900000,-5800000,5800000
2023-07-29,7589,7687,7589,7589,77962620,2441,25,47131957,30830663,411,13,65817674,12144946,-18685717,18685717
2023-07-30,7306,7502,7213,7213,92112567,2980,25,56285611,35826956,1600,17,74556816,17555751,-18271205,18271205
2023-07-31,7347,7399,7213,7234,16336962,892,11,11571876,4765086,699,8,12590917,3746045,-1019041,1019041
2023-08-01,7347,7589,7213,7424,17450266,631,9,7701779,9748487,616,6,11424905,6025361,-3723126,3723126
2023-08-05,7584,7651,7466,7553,12690644,727,6,9940604,2750040,652,9,11387618,1303026,-1447014,1447014
2023-08-06,7620,7620,7321,7337,12388490,723,5,7865867,4522623,649,5,12109990,278500,-4244123,4244123
2023-08-07,7337,7527,7203,7275,13645540,821,9,10169074,3507466,687,6,12061446,1615094,-1892372,1892372
2023-08-08,7378,7378,7203,7219,8761592,578,5,6692757,2068835,471,4,7853436,908156,-1160679,1160679
2023-08-09,7234,7327,7157,7208,7694544,570,7,5033045,2661499,434,5,7042250,652294,-2009205,2009205
2023-08-12,6848,7183,6848,6848,24043643,1121,7,11347868,12695775,539,5,22288813,1754830,-10940945,10940945
2023-08-13,6874,7152,6740,6879,12214327,651,3,9120299,3094028,581,5,8402565,3811762,717734,-717734
2023-08-14,7147,7147,6807,6833,11043765,578,3,5838466,5205299,417,5,6915521,4128244,-1077055,1077055
2023-08-15,6745,6833,6611,6689,12883458,594,6,7187868,5695590,466,3,9073449,3810009,-1885581,1885581
2023-08-16,6689,6807,6473,6565,14097688,622,4,5830796,8266892,527,3,8496273,5601415,-2665477,2665477
2023-08-19,6447,6647,6298,6442,18943550,815,5,11195379,7748171,585,6,18322946,620604,-7127567,7127567
2023-08-20,6406,6509,6318,6406,9170354,605,6,6208999,2961355,444,1,8670354,500000,-2461355,2461355
2023-08-21,6385,6529,6287,6385,8488937,430,7,3425980,5062957,361,3,7424185,1064752,-3998205,3998205
2023-08-22,6390,6390,6138,6256,12970804,594,5,7309092,5661712,490,5,11476360,1494444,-4167268,4167268
2023-08-23,6200,6539,6200,6539,14583544,532,4,13163544,1420000,604,6,10174173,4409371,2989371,-2989371
2023-08-26,6632,6781,6591,6781,27048158,750,9,15572754,11475404,564,6,8115637,18932521,7457117,-7457117
2023-08-27,6864,7095,6689,7038,34293887,936,8,23132105,11161782,928,8,19111443,15182444,4020662,-4020662
2023-08-28,7044,7255,6869,7049,20768993,594,10,6820106,13948887,737,6,12266898,8502095,-5446792,5446792
2023-08-29,7100,7285,6946,7013,9469471,481,5,5866025,3603446,592,5,7505239,1964232,-1639214,1639214
2023-08-30,7111,7147,6977,7059,23643181,669,10,8298177,15345004,628,5,7551763,16091418,746414,-746414
2023-09-02,6982,7152,6786,6848,9399165,790,7,8320277,1078888,444,4,8178784,1220381,141493,-141493
2023-09-03,6817,7023,6776,6828,13338929,832,6,10044199,3294730,435,3,12086929,1252000,-2042730,2042730
2023-09-04,6977,7172,6766,6982,25298760,822,6,13460773,11837987,619,7,10549594,14749166,2911179,-2911179
2023-09-05,7064,7188,6992,6997,20405508,891,4,13276404,7129104,572,8,11868196,8537312,1408208,-1408208
2023-09-09,7023,7085,6817,6838,15467608,577,4,7396824,8070784,607,4,15015208,452400,-7618384,7618384
2023-09-10,6797,6977,6714,6781,9433261,554,4,7749214,1684047,433,4,7581253,1852008,167961,-167961
2023-09-11,6822,6874,6740,6822,12020019,468,3,6449559,5570460,383,7,6575281,5444738,-125722,125722
2023-09-12,6802,6925,6802,6838,19962743,409,3,6424251,13538492,376,4,17985096,1977647,-11560845,11560845
2023-09-13,6894,6920,6704,6735,16451577,713,4,13286867,3164710,326,3,13394030,3057547,-107163,107163
2023-09-17,6786,6874,6637,6714,30120133,1462,5,26025932,4094201,493,7,26309914,3810219,-283982,283982
2023-09-18,6766,6822,6653,6704,19743782,760,6,14078352,5665430,524,4,11413251,8330531,2665101,-2665101
2023-09-19,6658,6771,6601,6606,11498834,833,5,6723170,4775664,349,4,8240583,3258251,-1517413,1517413
2023-09-20,6689,6925,6611,6807,22255872,682,5,17250185,5005687,606,5,14899919,7355953,2350266,-2350266
2023-09-23,7059,7136,6972,7069,63517437,1752,5,62416806,1206372,1245,14,34940549,28682629,27476257,-27476257
2023-09-25,6864,7085,6761,6910,14814350,852,8,11090685,3723665,678,4,14791798,22552,-3701113,3701113
2023-09-26,6910,7028,6776,7002,11098508,618,4,10361258,737250,604,5,9805282,1293226,555976,-555976
2023-09-27,7080,7152,6858,6966,18090251,649,5,12987857,5102394,568,7,10621954,7468297,2365903,-2365903
2023-09-30,6997,7111,6879,6925,12318146,574,5,9578326,2739820,602,1,12015379,302767,-2437053,2437053
2023-10-01,6905,7157,6869,7038,32047470,984,12,23995299,8052171,896,8,23993539,8053931,1760,-1760
2023-10-24,6681,6681,6681,6681,10521339,678,3,5836309,4685030,22,0,10521339,0,-4685030,4685030
2023-10-25,6364,6451,6352,6383,60637783,2806,12,52350408,8287375,1109,6,56288481,4349302,-3938073,3938073
2023-10-28,6203,6203,6048,6048,10730370,865,3,8027293,2703077,220,2,10523511,206859,-2496218,2496218
2023-10-29,5893,6178,5893,6061,20653078,980,6,17161248,3491830,751,3,19139359,1513719,-1978111,1978111
2023-10-30,6209,6296,6079,6265,11419446,638,6,9921420,1498026,534,2,10412586,1006860,-491166,491166
2023-10-31,6302,6302,5992,6067,9645416,650,5,8960180,685236,441,5,7257059,2388357,1703121,-1703121
2023-11-01,5905,6123,5850,6042,24666969,972,10,12638120,12028849,527,4,22512093,2154876,-9873973,9873973
2023-11-04,6129,6178,5998,6123,13077920,686,3,12842920,235000,489,6,10951560,2126360,1891360,-1891360
2023-11-05,6141,6216,6054,6098,10905434,501,8,8607142,2298292,434,5,9970805,934629,-1363663,1363663
2023-11-06,6178,6278,6023,6234,16508961,618,7,13489655,3019306,525,8,14891594,1617367,-1401939,1401939
2023-11-07,6253,6482,6178,6482,24393064,407,4,14700788,9692276,740,5,14354259,10038805,346529,-346529
2023-11-08,6464,6619,6414,6464,27176537,1014,11,24516933,2659604,657,8,19886892,7289645,4630041,-4630041
2023-11-11,6557,6606,6439,6458,11281111,572,8,10017371,1263740,497,2,10292863,988248,-275492,275492
2023-11-12,6445,6557,6371,6426,13171346,668,1,12140549,1030797,435,3,9215504,3955842,2925045,-2925045
2023-11-13,6389,6631,6389,6439,14169005,616,5,11036658,3132347,483,4,11574848,2594157,-538190,538190
2023-11-14,6433,6823,6420,6786,44158397,1186,8,34976436,9181961,1206,9,29037223,15121174,5939213,-5939213
2023-11-15,6805,7034,6761,6954,20749550,1060,1,20392133,357417,857,8,17775126,2974424,2617007,-2617007
2023-11-18,6706,6898,6668,6699,14535376,640,4,9262448,5272928,543,7,11040051,3495325,-1777603,1777603
2023-11-19,6768,6842,6594,6768,9710249,523,3,7879059,1831190,452,2,9705489,4760,-1826430,1826430
2023-11-20,6606,6693,6464,6470,18119444,677,4,9915694,8203750,538,4,16197065,1922379,-6281371,6281371
2023-11-21,6482,6606,6426,6495,9138209,634,5,6504911,2633298,369,1,7614187,1524022,-1109276,1109276
2023-11-22,6538,6594,6420,6426,11016619,770,2,10248219,768400,378,3,10831926,184693,-583707,583707
2023-11-25,6513,6513,6383,6445,7921102,484,2,7802057,119045,425,5,7399725,521377,402332,-402332
2023-11-26,6495,6619,6420,6513,14700662,643,4,14072133,628529,460,8,7423547,7277115,6648586,-6648586
2023-11-27,6606,6619,6383,6395,9889187,674,5,8535552,1353635,396,4,7341264,2547923,1194288,-1194288
2023-11-28,6402,6699,6346,6594,10725080,544,7,9272269,1452811,486,6,9151718,1573362,120551,-120551
2023-11-29,6848,6848,6644,6848,39266430,483,6,33972930,5293500,826,6,19916821,19349609,14056109,-14056109
2023-12-02,7134,7177,7078,7177,43041820,307,2,42041820,1000000,572,7,11949730,31092090,30092090,-30092090
2023-12-03,7276,7524,7239,7524,99432653,1976,21,75715555,23717098,1879,13,79202866,20229787,-3487311,3487311
2023-12-04,7760,7841,7729,7841,97274225,2632,12,94506028,2768197,1779,23,54841933,42432292,39664095,-39664095
2023-12-05,7940,8219,7841,8021,74789086,2805,10,71296322,3492764,2056,21,56083116,18705970,15213206,-15213206
2023-12-06,7990,8126,7859,7990,27755003,1521,7,21354906,6400097,1317,5,26667033,1087970,-5312127,5312127
2023-12-09,7940,8052,7624,7673,44370972,1559,7,25649834,18721138,1052,9,34626402,9744570,-8976568,8976568
2023-12-10,7630,8145,7630,8139,61420978,1949,8,54923947,6497031,1450,17,26521119,34899859,28402828,-28402828
2023-12-11,8399,8436,8126,8157,25874270,1571,6,23829266,2045004,1042,11,21393272,4480998,2435994,-2435994
2023-12-12,8250,8263,7996,8015,22480283,1187,7,14292496,8187787,812,7,19247422,3232861,-4954926,4954926
2023-12-13,8039,8157,7946,8002,12852006,769,3,11157264,1694742,581,3,10242699,2609307,914565,-914565
2023-12-16,8145,8443,8145,8387,52019716,1274,13,40977826,11041890,1400,14,27878911,24140805,13098915,-13098915
2023-12-18,8536,8641,8306,8374,31385454,1586,6,28363861,3021593,1055,11,26955953,4429501,1407908,-1407908
2023-12-19,8405,8449,8213,8219,35334529,1274,1,24819503,10515026,872,8,22445586,12888943,2373917,-2373917
2023-12-20,8182,8312,8021,8027,26181748,1203,7,13484592,12697156,577,9,14640600,11541148,-1156008,1156008
2023-12-23,7921,8219,7890,7921,23785619,1356,5,17025287,6760332,631,5,21397009,2388610,-4371722,4371722
2023-12-24,8095,8188,7977,8052,16254337,856,3,16185440,68897,978,8,10530078,5724259,5655362,-5655362
2023-12-25,8077,8077,7884,7890,14720398,859,6,9574751,5145647,563,3,11038701,3681697,-1463950,1463950
2023-12-26,7816,7940,7698,7704,18781247,1045,7,8958285,9822962,591,4,18626916,154331,-9668631,9668631
2023-12-27,7680,7971,7680,7804,10406521,686,2,9232661,1173860,609,3,9506521,900000,-273860,273860
2023-12-30,7828,7952,7748,7779,13737416,714,5,8751858,4985558,528,3,12976542,760874,-4224684,4224684
2023-12-31,7853,7859,7692,7698,12149416,777,2,8459043,3690373,491,4,11792810,356606,-3333767,3333767
2024-01-01,7723,7754,7555,7562,13580316,1027,5,10517177,3063139,556,4,12835691,744625,-2318514,2318514
2024-01-02,7475,7636,7413,7500,18544384,1185,2,17286502,1257882,541,3,18235217,309167,-948715,948715
2024-01-03,7500,7642,7456,7481,11596089,747,3,9786040,1810049,436,3,8485015,3111074,1301025,-1301025
2024-01-06,7636,7692,7394,7630,12300447,728,7,8293188,4007259,609,5,10685844,1614603,-2392656,2392656
2024-01-07,7537,7692,7506,7531,7728893,505,2,7204900,523993,440,1,7724756,4137,-519856,519856
2024-01-08,7586,7593,7456,7487,8033185,589,3,6174039,1859146,421,1,8024187,8998,-1850148,1850148
2024-01-09,7512,7555,7431,7444,13870340,760,8,7935080,5935260,407,4,13583565,286775,-5648485,5648485
2024-01-10,7431,7649,7431,7611,16728502,681,7,13792995,2935507,517,2,16627678,100824,-2834683,2834683
2024-01-13,7506,7655,7450,7555,12862903,530,9,10878884,2085812,656,2,12762019,202677,-1883135,1883135
2024-01-14,7599,7952,7580,7952,66402330,815,16,45565479,20836851,990,9,33545150,32857180,12020329,-12020329
2024-01-15,8126,8238,7990,8027,40287047,1392,13,32376489,7910558,1398,6,37821327,2465720,-5444838,5444838
2024-01-16,8058,8120,7909,8015,18584369,709,8,14120287,4464082,805,1,17384369,1200000,-3264082,3264082
2024-01-17,8027,8027,7791,7791,17059250,670,3,13812106,3247144,500,2,15759250,1300000,-1947144,1947144
2024-01-20,7878,7878,7599,7754,21263064,573,5,9212010,12051054,680,5,20243064,1020000,-11031054,11031054
2024-01-21,7630,8058,7524,7822,23848560,713,10,19683901,4164659,832,5,21841711,2006849,-2157810,2157810
2024-01-22,7605,7990,7512,7605,20534179,735,10,18406334,2127845,588,5,19999678,534501,-1593344,1593344
2024-01-23,7568,7655,7307,7568,20973259,768,6,15395436,5577823,632,4,20278634,694625,-4883198,4883198
2024-01-24,7704,7816,7506,7698,14346078,461,4,10220288,4125790,518,4,13874924,471154,-3654636,3654636
2024-01-27,7599,7785,7506,7630,16028359,792,10,10986712,5041647,477,5,15215500,812859,-4228788,4228788
2024-01-28,7673,7754,7506,7630,15756070,698,10,13077364,2678706,539,1,15706070,50000,-2628706,2628706
2024-01-29,7624,7760,7444,7562,44601744,1050,10,29131586,15470158,679,5,13751729,30850015,15379857,-15379857
2024-01-30,7413,7543,7326,7345,25767885,1176,12,17780387,7987498,685,4,24604248,1163637,-6823861,6823861
2024-01-31,7332,7605,7320,7500,19330476,697,5,18044296,1286180,596,3,15001673,4328803,3042623,-3042623
2024-02-03,7506,7680,7475,7518,13418215,566,4,11764113,1654102,521,7,12752553,665662,-988440,988440
2024-02-04,7518,7568,7450,7469,8101670,442,6,5444246,2657424,377,3,7526956,574714,-2082710,2082710
2024-02-05,7450,7717,7450,7630,14314945,551,5,13873832,441113,607,7,12325809,1989136,1548023,-1548023
2024-02-06,7555,7692,7506,7618,7831415,393,1,7510309,321106,375,2,7259083,572332,251226,-251226
2024-02-07,7574,7692,7524,7661,9373077,328,1,7011119,2361958,549,4,8992783,380294,-1981664,1981664
2024-02-10,7680,7680,7580,7599,6644735,371,1,6466535,178200,402,2,6110456,534279,356079,-356079
2024-02-12,7630,7661,7438,7444,13055568,622,4,9859405,3196163,417,7,9920253,3135315,-60848,60848
2024-02-13,7493,7599,7400,7438,9620571,651,4,9309031,311540,372,5,7701437,1919134,1607594,-1607594
2024-02-14,7481,7549,7363,7382,10113416,584,1,9604686,508730,474,4,9342442,770974,262244,-262244
2024-02-17,7357,7413,7121,7189,16068725,880,4,11528735,4539990,501,4,12404587,3664138,-875852,875852
2024-02-18,7165,7425,7158,7276,9243578,518,3,8507430,736148,354,4,7063308,2180270,1444122,-1444122
2024-02-19,7320,7419,7252,7332,10165156,482,3,7905071,2260085,378,2,8752545,1412611,-847474,847474
2024-02-20,7376,7493,7227,7438,13632141,514,6,8612161,5019980,423,3,11182586,2449555,-2570425,2570425
2024-02-21,7444,7444,7258,7301,10368257,354,4,5806163,4562094,281,3,9718231,650026,-3912068,3912068
2024-02-24,7301,7382,7165,7289,18781003,612,2,8014317,10766686,455,5,17549942,1231061,-9535625,9535625
2024-02-26,7183,7289,6923,7016,17437309,772,7,14357091,3820543,861,3,15583019,2594615,-1225928,1225928
2024-02-27,7016,7115,6948,7041,7078719,472,2,6877436,201283,377,4,6083659,995060,793777,-793777
2024-02-28,7127,7245,6972,7034,7184711,566,2,7156211,28500,273,4,5641711,1543000,1514500,-1514500
2024-03-02,7028,7549,7028,7549,19084866,545,2,17188513,1896353,726,6,17152418,1932448,36095,-36095
2024-03-03,7835,7940,7692,7785,46871702,2310,6,42869034,4002668,1207,12,39678683,7193019,3190351,-3190351
2024-03-04,7785,7878,7586,7754,16815922,1212,6,12129056,4686866,727,2,16295479,520443,-4166423,4166423
2024-03-05,7649,7952,7555,7667,14281449,940,6,12228298,2053151,563,2,12463928,1817521,-235630,235630
2024-03-06,7692,7754,7438,7444,24045530,1262,6,19839632,4205898,623,4,22555521,1490009,-2715889,2715889
2024-03-09,7475,7493,7320,7332,6309126,535,2,6105626,203500,249,2,5609126,700000,496500,-496500
2024-03-10,7444,7531,7338,7351,6527350,545,2,6313350,214000,436,4,6237350,290000,76000,-76000
2024-03-11,7264,7599,7264,7376,12837900,629,9,10011983,2825917,576,7,11424496,1413404,-1412513,1412513
2024-03-12,7593,7593,7338,7363,8600716,512,6,5140275,3460441,434,2,8170716,430000,-3030441,3030441
2024-03-13,7363,7493,7227,7258,9313020,610,2,8389144,923876,366,2,6913020,2400000,1476124,-1476124
2024-03-16,7314,7537,7196,7382,10453399,599,6,7665697,2787702,452,2,8223399,2230000,-557702,557702
2024-03-17,7357,7500,7264,7400,7983258,494,4,6912347,1070911,348,3,4424938,3558320,2487409,-2487409
2024-03-18,7500,7667,7450,7593,8848961,920,2,7743527,1105434,381,6,6164540,2684421,1578987,-1578987
2024-03-24,7655,7909,7555,7884,13863576,785,8,12750510,1113066,538,6,12311119,1552457,439391,-439391
2024-03-25,7946,8027,7804,7828,12786947,675,5,12331266,455681,687,4,12452677,334270,-121411,121411
2024-03-26,7760,7884,7723,7766,6942102,538,8,5405686,1536416,451,0,6942102,0,-1536416,1536416
2024-03-27,7704,7859,7704,7754,8402064,482,6,5593156,2808908,423,1,8397002,5062,-2803846,2803846
2024-03-30,7729,7847,7704,7785,5229637,326,4,4555166,674471,431,1,5146637,83000,-591471,591471
2024-04-02,7338,7822,7338,7748,17161204,495,5,8446255,8714949,685,4,16893733,267471,-8447478,8447478
2024-04-03,7667,7735,7524,7680,11382115,387,2,4942128,6439987,608,1,11318252,63863,-6376124,6376124
2024-04-06,7531,7680,7103,7245,19333852,733,7,11109459,8224393,750,5,19112858,220994,-8003399,8003399
2024-04-07,7146,7475,7146,7345,9510457,459,4,6944976,2565481,475,0,9510457,0,-2565481,2565481
2024-04-08,7444,7543,7369,7419,5508649,366,5,4933463,575186,343,1,5493899,14750,-560436,560436
2024-04-09,7419,7462,7320,7400,14938517,404,4,6590271,8348246,434,3,13143373,1795144,-6553102,6553102
2024-04-13,7041,7326,6861,6929,32487192,990,6,15976859,16510333,780,4,31649508,837684,-15672649,15672649
2024-04-14,6886,6886,6886,6886,2102090,183,2,1101639,1000451,16,2,1902090,200000,-800451,800451
2024-04-15,6892,7010,6892,7010,5723881,183,2,5556843,167038,314,3,5025741,698140,531102,-531102
2024-04-16,6904,6948,6904,6904,19060316,438,6,11632075,7428241,238,2,18670330,389986,-7038255,7038255
2024-04-17,6904,6972,6836,6910,13393742,618,3,11920163,1473579,281,4,8193742,5200000,3726421,-3726421
2024-04-28,7066,7350,6942,7066,27428989,805,4,25079903,2349086,554,8,22026750,5402239,3053153,-3053153
2024-04-29,7572,7572,7288,7297,19402888,717,3,17964097,1438791,497,6,14369732,5033156,3594365,-3594365
2024-04-30,7217,7297,7137,7199,7421112,421,1,6921112,500000,376,3,7174198,246914,-253086,253086
2024-05-01,7270,7403,7181,7270,8178014,409,1,6945636,1232378,413,2,7065705,1112309,-120069,120069
2024-05-05,7279,7394,7244,7279,7886142,304,3,5618820,2267322,409,2,7878465,7677,-2259645,2259645
2024-05-06,7252,7385,7093,7288,12880690,348,4,10525330,2355360,422,5,12236814,643876,-1711484,1711484
2024-05-07,7137,7350,7128,7279,15230832,312,5,13162209,2068623,376,7,7923197,7307635,5239012,-5239012
2024-05-08,7314,7376,7164,7359,14275826,271,2,13912095,363681,456,1,14265776,10000,-353681,353681
2024-05-11,7288,7465,7244,7244,9503721,308,4,7568755,1934966,451,3,8613919,889802,-1045164,1045164
2024-05-12,7252,7332,7146,7173,8303128,324,6,5848907,2454221,297,2,7489828,813300,-1640921,1640921
2024-05-13,7181,7217,6862,7004,15282450,547,4,10830815,4451635,797,6,15045953,236497,-4215138,4215138
2024-05-14,7004,7164,6827,6889,7003004,371,3,6961051,41953,487,1,6995286,7718,-34235,34235
2024-05-15,7075,7075,6782,6898,8099932,390,1,5337151,2762781,318,2,7815784,284148,-2478633,2478633
2024-05-18,7004,7164,6729,6765,8626320,606,3,8575321,89768,552,4,5851006,2814083,2724315,-2724315
2024-05-19,6623,6898,6472,6623,7095960,537,4,6461773,634187,331,3,6835867,260093,-374094,374094
2024-05-21,6827,6827,6623,6747,6693428,284,3,4411681,2281747,236,0,6693428,0,-2281747,2281747
2024-05-25,6809,6827,6587,6587,12304643,337,1,3262643,9042000,244,0,12304643,0,-9042000,9042000
2024-05-26,6499,6561,6499,6499,10385356,172,1,1344226,9042000,99,0,10386226,0,-9042000,9042000
2024-05-27,6419,6419,6419,6419,7657354,208,2,2020785,5636569,9,0,7657354,0,-5636569,5636569
2024-05-28,6357,6587,6357,6472,42847506,839,8,25126319,17721187,480,4,36865761,5981745,-11739442,11739442
2024-05-29,6543,6552,6463,6552,14016780,474,6,10631085,3385695,240,2,10916780,3100000,-285695,285695
2024-06-01,6410,6623,6401,6428,12740669,486,3,8078865,4661804,347,1,12740669,0,-4661804,4661804
2024-06-02,6401,6463,6330,6454,9660961,342,1,5747590,3913371,306,2,9590310,70651,-3842720,3842720
2024-06-05,6330,6490,6268,6268,4043830,368,0,4043830,0,235,0,4043830,0,0,0
2024-06-08,6242,6268,6242,6242,18714627,237,5,3108462,15606165,285,1,18436688,277939,-15328226,15328226
2024-06-09,6188,6330,6118,6304,6341710,238,2,4946509,1395201,304,2,6192291,149419,-1245782,1245782
2024-06-10,6357,6357,6304,6357,5635651,152,1,5399730,235921,261,2,5425918,209733,-26188,26188
2024-06-11,6401,6401,6295,6339,12690307,229,7,7193642,5496665,284,2,12583307,107000,-5389665,5389665
2024-06-12,6268,6428,6242,6348,10165147,171,3,7432014,2733133,238,1,10025483,139664,-2593469,2593469
2024-06-15,6428,6463,6215,6339,11750660,232,5,8878521,2872139,408,2,11311900,438760,-2433379,2433379
2024-06-16,6242,6348,6242,6277,6846287,161,3,4436287,2410000,251,4,3693438,3152849,742849,-742849
2024-06-18,6375,6375,6188,6206,8908799,276,4,5447542,3461257,208,0,8908799,0,-3461257,3461257
2024-06-19,6268,6392,6180,6375,10162512,169,3,5762534,3667878,218,5,6345924,3084488,-583390,583390
2024-06-22,6251,6437,6251,6437,7968634,142,4,4591249,3377385,305,5,5611333,2357301,-1020084,1020084
2024-06-23,6366,6454,6286,6375,3927000,185,5,2698599,1228401,181,4,2491588,1435412,207011,-207011
2024-06-24,6481,6481,6339,6481,3523079,39,2,2012574,1510505,211,4,3129456,393623,-1116882,1116882
2024-06-26,6508,6508,6508,6508,5957407,7,2,1947139,4010268,129,2,1392163,4565244,554976,-554976
2024-06-29,6809,6809,6649,6800,46290701,387,3,42696166,3594535,416,8,27919640,18371061,14776526,-14776526
2024-06-30,6774,6915,6623,6774,17840281,326,6,16898420,941861,482,5,16544566,1295715,353854,-353854
2024-07-01,6632,7146,6632,7146,18591831,195,4,17024024,1567807,487,4,14623432,3968399,2400592,-2400592
2024-07-02,7412,7430,7270,7430,10989214,77,2,9790714,1198500,362,2,10967214,22000,-1176500,1176500
2024-07-03,7713,7713,7509,7625,91278598,955,10,60309359,30969239,1364,23,64840771,26437827,-4531412,4531412
2024-07-06,8121,8121,8121,8121,13988909,65,6,12788909,1200000,327,3,3406270,10582639,9382639,-9382639
2024-07-07,8600,8600,8183,8272,75747405,1046,9,58432914,17314491,1082,20,49978436,25768969,8454478,-8454478
2024-07-08,8263,8263,7962,7979,38173429,899,10,24536370,13637059,893,6,35885034,2288395,-11348664,11348664
2024-07-09,7979,8050,7784,7917,11149691,401,6,6382130,4767561,439,4,9802691,1347000,-3420561,3420561
2024-07-10,7971,8219,7731,7988,16682317,397,4,9677157,7005160,574,12,12834254,3848063,-3157097,3157097
2024-07-13,8148,8254,7891,7997,20597309,339,5,8048231,12549078,431,7,15684856,4912453,-7636625,7636625
2024-07-14,7962,8041,7864,7962,16967869,297,4,4149051,12818818,330,5,11727859,5240010,-7578808,7578808
2024-07-17,8015,8121,7935,8095,18951841,221,5,7712802,11239039,390,6,14167600,4784241,-6454798,6454798
2024-07-20,7953,8112,7820,7935,19628796,293,6,6393513,13235283,355,2,18228796,1400000,-11835283,11835283
2024-07-21,7935,7935,7669,7784,9118502,215,4,2986518,6131984,319,2,9011502,107000,-6024984,6024984
2024-07-22,7802,8006,7802,7979,8006136,159,1,3107138,4898998,323,4,7653450,352686,-4546312,4546312
2024-07-23,8006,8157,7900,7944,7679392,227,6,3914567,3764825,312,8,4638053,3041339,-723486,723486
2024-07-24,8006,8015,7926,7962,5205544,147,5,2122321,3083223,266,1,5178772,26772,-3056451,3056451
2024-07-27,8050,8050,7908,7935,6536695,136,1,2021447,4515248,276,5,5046695,1490000,-3025248,3025248
2024-07-29,7979,7979,7642,7731,18094231,225,6,3247644,14846587,371,3,17640899,453332,-14393255,14393255
2024-07-30,7846,7846,7580,7838,6475613,185,4,2714492,3761121,303,2,6459603,16010,-3745111,3745111
2024-07-31,7323,7642,7323,7625,27270970,213,7,9894541,17376429,485,4,26371970,899000,-16477429,16477429
2024-08-03,7288,7368,7093,7093,30903641,333,9,3735105,27168536,546,6,27577496,3326145,-23842391,23842391
2024-08-04,7075,7217,7075,7217,6802456,135,4,4698780,2103676,250,1,6772456,30000,-2073676,2073676
2024-08-05,7111,7217,7084,7119,5557284,168,6,2740433,2816851,232,4,4732284,825000,-1991851,1991851
2024-08-06,7155,7155,7066,7066,6359141,157,5,1611639,4747502,142,4,2515123,3844018,-903484,903484
2024-08-10,7190,7190,7111,7190,7430836,112,6,2998655,4432181,252,2,6530836,900000,-3532181,3532181
2024-08-11,7128,7226,7128,7226,3054112,22,3,2973438,80674,182,1,2982712,71400,-9274,9274
2024-08-12,7235,7235,7093,7199,9669936,213,5,6332601,3337335,388,2,8569936,1100000,-2237335,2237335
2024-08-13,7119,7119,7119,7119,2887854,104,3,1587854,1300000,35,0,2887854,0,-1300000,1300000
2024-08-14,7244,7244,7208,7244,3992995,22,1,3592995,400000,190,1,3840940,152055,-247945,247945
2024-08-17,7332,7332,7332,7332,1693818,7,2,1450000,243818,149,0,1693818,0,-243818,243818
2024-08-18,7350,7350,7350,7350,7005073,35,4,6205073,800000,316,3,6284615,720458,-79542,79542
2024-08-19,7421,7421,7288,7421,63766671,414,9,40604908,23161763,806,13,45117913,18648758,-4513005,4513005
2024-08-20,7492,7527,7341,7359,16980341,349,8,11784729,5195612,541,3,14151852,2828489,-2367123,2367123
2024-08-21,7368,7589,7368,7589,16941750,240,6,5965561,10976189,590,4,13926859,3014891,-7961298,7961298
2024-08-24,7660,7660,7660,7660,5981702,9,2,1573064,4408638,278,2,4980201,1001501,-3407137,3407137
2024-08-26,7731,7731,7625,7678,20004056,351,7,11766175,8237881,548,6,13081484,6922572,-1315309,1315309
2024-08-27,7758,7873,7625,7873,26303137,365,14,12912506,13390631,653,9,15075685,11227452,-2163179,2163179
2024-08-28,7873,7962,7864,7962,32968249,214,3,21690407,11277842,386,9,11899740,21068509,9790667,-9790667
2024-09-01,8272,8272,8104,8272,68464728,722,9,29741287,38723441,1025,16,40457009,28007719,-10715722,10715722
2024-09-03,8316,8316,8095,8095,31256894,563,9,13571590,17685304,564,8,20516901,10739993,-6945311,6945311
2024-09-07,8139,8139,7873,7873,45792528,670,13,20778409,25014119,964,12,22956625,22835903,-2178216,2178216
2024-09-08,7749,8015,7669,7802,34458593,481,13,12815093,21643500,445,7,18535362,15923231,-5720269,5720269
2024-09-09,7802,7953,7758,7953,52775788,247,6,22018479,30757309,389,13,6016403,46759385,16002076,-16002076
2024-09-10,7988,8121,7864,7988,10997134,291,10,8071718,2925416,342,4,10642939,354195,-2571221,2571221
2024-09-11,8174,8174,7846,8174,61992959,299,11,19393353,42599606,665,8,25871133,36121826,-6477780,6477780
2024-09-14,8104,8245,7971,7979,13153836,370,6,8275384,4878452,432,4,12507534,646302,-4232150,4232150
2024-09-15,8077,8077,7855,7855,22059330,479,12,8009562,14049768,327,7,17204391,4854939,-9194829,9194829
2024-09-16,7749,8104,7749,8104,60902914,380,9,16489523,44413391,647,12,45886646,15016268,-29397123,29397123
2024-09-17,8228,8334,8095,8334,56440020,448,14,25706122,30733898,614,10,15192266,41247754,10513856,-10513856
2024-09-18,8334,8565,8290,8476,43005164,560,9,25732216,17272948,828,11,31544575,11460589,-5812359,5812359
2024-09-22,8299,8529,8299,8369,98829922,981,17,27725076,71104846,721,11,81487937,17341985,-53762861,53762861
2024-09-23,8316,8565,8316,8565,35172847,224,7,20665032,14507815,619,12,17388336,17784511,3276696,-3276696
2024-09-24,8671,8760,8573,8760,48493886,647,11,38519647,9974239,818,10,29234630,19259256,9285017,-9285017
2024-09-25,8857,8928,8582,8627,26836650,574,9,19906204,6930446,644,11,21018075,5818575,-1111871,1111871
2024-09-28,8644,8644,8644,8644,980199,93,0,980199,0,7,1,780199,200000,200000,-200000
2024-09-29,8635,8768,8635,8662,52318381,403,10,15555009,36763372,784,7,50775723,1542658,-35220714,35220714
2024-09-30,8600,8715,8556,8556,35788958,674,4,22028958,13760000,495,6,28525053,7263905,-6496095,6496095
2024-10-05,8290,8290,8210,8210,14414835,281,2,6893835,7521000,123,2,12624386,1790449,-5730551,5730551
2024-10-06,8160,8190,8160,8160,23729656,167,6,16884083,6845573,145,0,23729656,0,-6845573,6845573
2024-10-07,8160,8240,8080,8160,79550659,493,22,50648567,28902092,768,12,45897885,33652774,4750682,-4750682
2024-10-08,8240,8240,8240,8240,3583455,47,1,3507596,70000,223,7,2526326,1051270,981270,-981270
2024-10-09,8260,8260,8260,8260,2946491,17,0,2946491,0,204,2,2696491,250000,250000,-250000
2024-10-12,8440,8440,8440,8440,14185451,79,2,13785451,400000,238,4,2529384,11656067,11256067,-11256067
2024-10-13,8670,8680,8550,8680,39256759,452,5,31656759,7600000,611,8,35829107,3427652,-4172348,4172348
2024-10-14,8420,8690,8410,8420,42914085,459,9,12341651,30572434,619,10,36820243,6093842,-24478592,24478592
2024-10-15,8190,8390,8180,8190,30667470,414,9,16621150,14046320,424,3,28257111,2410359,-11635961,11635961
2024-10-16,8430,8430,8290,8430,21938885,72,4,16210797,5728088,374,7,12695954,9242931,3514843,-3514843
2024-10-19,8180,8560,8180,8180,36247048,385,9,16610420,19636628,460,7,22519315,13727733,-5908895,5908895
2024-10-20,8060,8170,7980,7980,15829946,277,5,3709245,12120701,183,5,9989796,5840150,-6280551,6280551
2024-10-21,7750,8210,7750,8070,32784355,322,8,19759564,13024791,641,5,30730949,2053406,-10971385,10971385
2024-10-22,8070,8260,7790,7790,30808827,418,11,8371514,22437313,379,1,29508827,1300000,-21137313,21137313
2024-10-23,7680,8080,7620,7960,21216554,306,11,6713230,14503324,538,2,19077695,2138859,-12364465,12364465
2024-10-26,8020,8020,8020,8020,11231423,48,3,10631423,600000,187,1,2189423,9042000,8442000,-8442000
2024-10-27,8190,8190,8190,8190,10122647,52,1,9922647,200000,107,1,1080647,9042000,8842000,-8842000
2024-10-28,8350,8350,8350,8350,16336673,86,2,15936673,400000,210,2,7294068,9042605,8642605,-8642605
2024-10-29,8550,8600,8200,8370,73202158,688,12,53356966,19845192,806,14,63022496,10179662,-9665530,9665530
2024-10-30,8320,8750,8320,8600,35178785,453,7,25570519,9608266,531,10,23753155,11425630,1817364,-1817364
2024-11-02,8610,8750,8360,8370,23828839,382,6,13811851,10016988,513,4,20421673,3407166,-6609822,6609822
2024-11-03,8470,8470,8290,8290,25539568,149,5,2522596,23016972,164,3,24090207,1449361,-21567611,21567611
2024-11-04,8080,8390,8080,8310,21250828,231,10,8339325,12911503,407,7,16542739,4708089,-8203414,8203414
2024-11-05,8250,8500,8170,8280,7225383,217,3,5601901,1623482,269,3,6090779,1134604,-488878,488878
2024-11-06,8110,8390,8050,8230,22972442,437,11,13189783,9782659,389,3,21618213,1354229,-8428430,8428430
2024-11-09,8370,8370,8350,8370,15154350,68,1,13964026,1190324,239,3,5794157,9360193,8169869,-8169869
2024-11-10,8620,8620,8620,8620,14449866,60,1,11365514,3084352,197,2,2059212,12390654,9306302,-9306302
2024-11-11,8860,8860,8650,8820,57542381,514,12,31566237,25976144,774,4,56522381,1020000,-24956144,24956144
2024-11-12,8890,9090,8710,8850,14880296,383,5,7203876,7676420,450,3,13691099,1189197,-6487223,6487223
2024-11-13,8630,9120,8630,8970,18285391,260,9,8734743,9550648,642,3,17484798,800593,-8750055,8750055
2024-11-16,9300,9300,8990,9300,69363928,815,15,51352846,18011082,695,17,47118914,22245014,4233932,-4233932
2024-11-17,9350,9420,9000,9000,61383232,1099,13,28869324,32513908,826,9,52170898,9212334,-23301574,23301574
2024-11-18,9250,9300,8930,9250,65972235,1118,16,38770610,27201625,754,7,50996471,14975764,-12225861,12225861
2024-11-19,8900,9200,8900,8900,110015454,1267,17,48259387,61756067,1581,16,92475952,17539502,-44216565,44216565
2024-11-20,8720,9000,8710,8760,26696885,539,12,13496033,13200852,659,5,25244058,1452827,-11748025,11748025
2024-11-23,8700,9050,8700,9050,31958123,429,10,13204240,18753883,643,7,20687778,11270345,-7483538,7483538
2024-11-24,9220,9220,9120,9220,16437473,41,5,8429973,8007500,399,4,10537473,5900000,-2107500,2107500
2024-11-25,9490,9490,9490,9490,16729571,77,2,15129571,1600000,377,5,8510274,8219297,6619297,-6619297
2024-11-26,9770,9770,9310,9500,49249713,558,13,27468635,21781078,1102,8,44348006,4901707,-16879371,16879371
2024-11-27,9640,9930,9420,9900,27105285,466,7,15467257,11638028,765,6,24015489,3089796,-8548232,8548232
2024-11-30,10010,10010,9430,9600,45097340,667,10,18936235,26161105,726,3,42622240,2475100,-23686005,23686005
2024-12-01,9330,9810,9330,9650,19198868,228,9,6354168,12844700,435,4,18109175,1089693,-11755007,11755007
2024-12-02,9820,9870,9720,9870,12053448,88,5,8253464,3799984,469,2,7053448,5000000,1200016,-1200016
2024-12-03,10150,10150,9700,9980,31448840,560,12,15980724,15468116,712,6,24221461,7227379,-8240737,8240737
2024-12-04,9900,10140,9780,9890,28192998,582,8,13975071,14217927,650,8,24189089,4003909,-10214018,10214018
2024-12-07,9800,9900,9650,9650,23837101,529,7,12080648,11756453,407,2,22718131,1118970,-10637483,10637483
2024-12-08,9380,9960,9380,9740,41765969,514,8,15076355,26689614,755,9,34800592,6965377,-19724237,19724237
2024-12-09,9900,9900,9890,9900,27513039,149,7,13588039,13925000,361,5,8786537,18726502,4801502,-4801502
2024-12-10,10170,10190,9900,10040,43686227,388,11,23645414,20040813,925,10,31744666,11941561,-8099252,8099252
2024-12-11,10430,10430,9910,10430,44358805,311,15,25841489,18517316,861,7,25388204,18970601,453285,-453285
2024-12-14,10680,10680,10680,10680,18812654,27,9,4462357,14350297,372,3,2012654,16800000,2449703,-2449703
2024-12-15,11000,11000,10720,11000,108150139,458,22,22813530,85336609,787,18,43061475,65088664,-20247945,20247945
2024-12-16,11300,11330,11000,11200,92011859,644,14,46272039,45739820,1047,15,38606584,53405275,7665455,-7665455
2024-12-17,11000,11540,10970,10970,42216779,689,9,17702778,24514001,634,5,32718066,9498713,-15015288,15015288
2024-12-18,10720,11200,10720,11140,25794593,573,10,18353622,7440971,1040,5,24342792,1451801,-5989170,5989170
2024-12-21,11210,11210,11100,11210,28075358,166,6,15160358,12915000,394,8,10568482,17506876,4591876,-4591876
2024-12-22,11340,11340,10940,11190,26391432,578,9,14490209,11901223,670,6,20520311,5871121,-6030102,6030102
2024-12-23,10810,11460,10810,11460,26629457,315,12,8098029,18531428,936,10,17604649,9024808,-9506620,9506620
2024-12-24,11580,11730,11540,11730,46685755,501,6,17585353,29100402,948,9,35000812,11684943,-17415459,17415459
2024-12-25,11970,11970,11370,11600,45197629,801,16,17996065,27201564,869,4,30422321,14775308,-12426256,12426256
2024-12-28,11600,11710,11130,11310,24528885,591,7,10435296,14093589,757,6,16198819,8330066,-5763523,5763523
2024-12-29,11010,11310,11010,11010,37356932,646,11,9237197,28119735,559,10,26953523,10403409,-17716326,17716326
2024-12-30,10720,11000,10700,10700,23956981,543,12,8788670,15168311,849,4,21186981,2770000,-12398311,12398311
2024-12-31,10540,11050,10540,11050,24808224,235,11,11944794,12863430,752,10,13463589,11344635,-1518795,1518795
2025-01-01,11330,11330,11070,11330,29470311,282,9,16775920,12694391,1427,10,12989882,16480429,3786038,-3786038
2025-01-04,11630,11630,11420,11630,10876104,95,6,3315594,7560510,472,7,5998734,4877370,-2683140,2683140
2025-01-05,11900,11950,11350,11600,28976704,491,12,12046123,16930581,774,6,23129550,5847154,-11083427,11083427
2025-01-06,11800,11920,11440,11800,18305612,451,15,7316699,10988913,620,10,13886961,4418651,-6570262,6570262
2025-01-07,11850,11970,11810,11970,27305348,228,12,8243531,19061817,671,9,14336963,12968385,-6093432,6093432
2025-01-08,12310,12310,12050,12310,33685624,434,10,22443788,11241836,959,8,24757163,8928461,-2313375,2313375
2025-01-11,12150,12630,11910,12620,41063329,764,11,16711125,24352204,774,10,26675148,14388181,-9964023,9964023
2025-01-12,11750,12140,11740,11860,36815622,530,10,11266282,25549340,744,11,23422648,13392974,-12156366,12156366
2025-01-13,11870,12140,11740,11940,28188468,307,16,14850613,13337855,827,10,11760244,16428224,3090369,-3090369
2025-01-15,12430,12430,11960,12110,17456212,476,10,11726068,5730144,547,5,14999979,2456233,-3273911,3273911
2025-01-18,12200,12250,11870,11870,24128611,397,5,6682763,17445848,563,5,19930864,4197747,-13248101,13248101
2025-01-19,11920,12200,11800,11840,12577668,334,7,7405513,5172155,411,7,9198960,3378708,-1793447,1793447
2025-01-20,11880,12160,11610,11800,21013658,234,7,4400803,16612855,502,9,14967096,6046562,-10566293,10566293
2025-01-21,11670,12190,11620,12130,31689667,279,13,12948861,18740806,693,16,10932661,20757006,2016200,-2016200
2025-01-22,12410,12410,12200,12410,48147325,73,9,7526041,16768773,443,8,8255511,16039303,-729470,729470
2025-01-25,12440,12760,12200,12450,13524258,432,8,10302764,3221494,503,2,11324258,2200000,-1021494,1021494
2025-01-26,12190,12590,12170,12360,14064370,267,9,4787992,9276378,465,8,9723959,4340411,-4935967,4935967
2025-01-27,12400,12400,12000,12110,21445605,220,10,10221523,11224082,434,12,6859451,14586154,3362072,-3362072
2025-01-29,12130,12300,12040,12130,6940043,218,8,4013262,2926781,361,4,5247734,1692309,-1234472,1234472
2025-02-01,12200,12220,11800,11870,21828436,335,7,4527641,17300795,486,10,14910275,6918161,-10382634,10382634
2025-02-02,12150,12200,11940,11980,11903973,202,8,2758471,9145502,386,11,7685634,4218339,-4927163,4927163
2025-02-03,11940,12200,11940,11940,16335651,185,6,2082894,14252757,384,6,13473359,2862292,-11390465,11390465
2025-02-04,12120,12380,12120,12130,6871330,195,7,2769307,4102023,309,6,5203556,1667774,-2434249,2434249
2025-02-05,12150,12370,11970,12000,14837315,197,7,4419324,10417991,435,9,10907799,3929516,-6488475,6488475
2025-02-09,11750,12250,11740,11800,53357363,433,10,8359999,44997364,873,19,40543732,12813631,-32183733,32183733
2025-02-11,11970,11970,11570,11570,47612756,192,8,1314002,46298754,508,8,21955616,25657140,-20641614,20641614
2025-02-15,11500,11500,11250,11250,21453083,123,6,628674,20824409,215,4,17420709,4032374,-16792035,16792035
2025-02-16,11040,11040,10940,10960,21805264,318,7,4931971,16873293,740,7,18467569,3337695,-13535598,13535598
2025-02-17,10730,11200,10730,10880,9678431,247,8,3059101,6619330,349,8,5289004,4389427,-2229903,2229903
2025-02-18,10950,11100,10830,10910,5122499,175,2,3817259,1305240,260,3,3344609,1777890,472650,-472650
2025-02-19,11000,11150,10830,10890,10789463,195,5,2160286,8629177,277,2,6723453,4066010,-4563167,4563167
2025-02-22,10890,11170,10800,10810,9824517,149,5,1245904,8578613,381,2,7214131,2610386,-5968227,5968227
2025-02-23,10990,11150,10650,10880,7299034,277,5,5377434,1921600,302,3,4834081,2464953,543353,-543353
2025-02-24,11170,11210,10930,11210,25230522,311,4,17809932,7420590,393,6,7000587,18229935,10809345,-10809345
2025-02-25,11310,11510,11060,11160,10795199,390,4,6655807,4139392,461,4,9885199,910000,-3229392,3229392
2025-02-26,11230,11280,11010,11010,13515096,270,4,4649066,8866030,447,2,12094859,1420237,-7445793,7445793
2025-03-01,11000,11290,10870,11080,14613478,174,15,5264067,9349411,339,3,13701399,912079,-8437332,8437332
2025-03-02,11200,11300,11000,11200,14108331,287,11,8489279,5619052,393,7,8860262,5248069,-370983,370983
2025-03-03,10930,10930,10860,10860,24038394,210,5,1496394,22542000,92,5,13545642,10492752,-12049248,12049248
2025-03-04,10620,11100,10600,10630,17009737,287,3,7186257,9823480,312,5,8237585,8772152,-1051328,1051328
2025-03-05,10760,10960,10570,10600,21879891,193,6,5939015,15940876,321,7,10625107,11254784,-4686092,4686092
2025-03-08,10990,10990,10650,10650,33572404,345,12,18619867,14952537,559,11,23950445,9621959,-5330578,5330578
2025-03-09,10860,10910,10610,10720,21530050,177,5,4934316,16595734,448,10,12699754,8830296,-7765438,7765438
2025-03-10,10800,11080,10650,10980,32208260,329,7,27311761,4896499,574,11,12838355,19369905,14473406,-14473406
2025-03-11,11080,11140,10660,10660,28884014,267,10,6567425,22316589,330,6,21347565,7536449,-14780140,14780140
2025-03-12,10810,11010,10610,10920,16027870,205,9,6074464,9953406,279,12,4472987,11554883,1601477,-1601477
2025-03-15,11100,11150,10930,11000,23063283,341,12,19947379,3115904,380,7,12989869,10073414,6957510,-6957510
2025-03-16,11040,11220,10790,11140,33121741,251,9,5453812,31827937,384,10,11097669,26184080,-5643857,5643857
2025-03-16,11090,11100,10910,11010,859682,251,9,5453812,31827937,384,10,11097669,26184080,-5643857,5643857
2025-03-17,10810,11100,10770,10800,7783520,145,2,2421511,5362009,244,3,6848697,934823,-4427186,4427186
2025-03-18,10640,10880,10580,10630,47632170,218,6,3133277,44498893,335,5,45974837,1657333,-42841560,42841560
2025-03-25,10920,10920,10580,10840,10454934,197,6,7708020,2746914,199,4,4467932,5987002,3240088,-3240088
2025-03-26,10900,11190,10870,10880,6085237,146,3,2711328,3373909,240,5,4315836,1769401,-1604508,1604508
2025-03-29,10870,11140,10830,10860,11954965,148,4,2115675,9839290,260,7,8022277,3932688,-5906602,5906602
2025-03-30,10700,11090,10700,11020,7435431,219,4,3789681,3645750,281,5,6574739,860692,-2785058,2785058
2025-04-05,10920,11200,10840,10920,9224707,203,5,2740120,6484587,268,6,8188943,1035764,-5448823,5448823
2025-04-06,10790,10930,10630,10790,9942592,146,5,987591,8955001,285,3,9205474,737118,-8217883,8217883
2025-04-07,10700,10790,10610,10710,9500651,102,4,4137734,5362917,262,2,8975651,525000,-4837917,4837917
2025-04-08,11030,11030,11030,11030,29927827,149,4,17127827,12800000,180,3,1285827,28642000,15842000,-15842000
2025-04-09,11360,11360,11160,11360,77472782,355,8,54022782,23450000,583,12,19130067,58342715,34892715,-34892715
2025-04-12,11700,11700,11700,11700,114003989,572,14,101694978,12309011,320,10,4103989,109900000,97590989,-97590989
2025-04-13,12050,12050,12050,12050,66174172,581,70,58624609,7549563,129,5,534662,65639510,58089947,-58089947
2025-04-14,12410,12410,12410,12410,99521678,850,72,88024968,11496710,194,7,1543953,97977725,86481015,-86481015
2025-04-15,12780,12780,12610,12780,373936831,1647,49,206529819,167407012,1505,39,142230905,231705926,64298914,-64298914
2025-04-16,13160,13160,13140,13160,67797010,410,11,52897010,14900000,563,15,30049849,37747161,22847161,-22847161
2025-04-19,13550,13550,13550,13550,29222675,261,26,26372675,2850000,285,6,3708395,25514280,22664280,-22664280
2025-04-20,13950,13950,13950,13950,10298682,114,11,9198682,1100000,142,3,539609,9759073,8659073,-8659073
