Date,Open,High,Low,Close,Volume,person_buyer_count,person_buy_volume,person_seller_count,company_seller_count,person_sell_volume,company_sell_volume,person_owner_change,company_owner_change,company_buyer_count,company_buy_volume
2015-06-23,107,107,104,107,95297,11,95297,10,0,95297,0,0,0,0,0
2015-06-24,107,107,103,107,79583,14,79583,11,0,79583,0,0,0,0,0
2015-06-27,105,107,105,107,47526,4,47526,7,0,47526,0,0,0,0,0
2015-06-28,105,107,103,107,37172,7,37172,9,0,37172,0,0,0,0,0
2015-06-29,103,106,103,104,148416,8,148416,8,0,148416,0,0,0,0,0
2015-06-30,106,109,103,109,322868,16,322868,22,2,140196,182672,182672,-182672,0,0
2015-07-01,109,109,106,107,31369,7,31369,3,1,19041,12328,12328,-12328,0,0
2015-07-04,108,112,108,112,1664889,17,419315,33,4,820690,844199,-401375,401375,2,1245574
2015-07-05,107,112,106,107,109926,11,109926,7,0,109926,0,0,0,0,0
2015-07-06,108,110,108,108,18115,3,18115,3,0,18115,0,0,0,0,0
2015-07-07,107,112,107,111,343304,15,343304,19,0,343304,0,0,0,0,0
2015-07-11,111,113,111,113,53298,10,53298,6,0,53298,0,0,0,0,0
2015-07-12,111,114,111,111,231619,13,230799,14,1,130799,100000,100000,-100000,0,0
2015-07-13,114,116,114,116,2591631,13,464000,20,5,240131,2351500,223869,-223869,1,2127631
2015-07-14,121,121,113,116,5537046,23,337046,28,2,446017,5091029,-108971,108971,2,5200000
2015-07-15,114,114,111,111,413513,13,263513,17,1,392825,20688,-129312,129312,1,150000
2015-07-20,110,112,110,110,134482,10,134482,11,0,134482,0,0,0,0,0
2015-07-21,116,116,110,110,255864,16,204364,12,0,255864,0,-51500,51500,2,51500
2015-07-22,110,110,109,110,218750,6,218750,3,0,218750,0,0,0,0,0
2015-07-25,110,110,107,107,106855,10,105723,13,0,106855,0,-1132,1132,1,1132
2015-07-26,110,112,108,112,113222,8,113222,9,0,113222,0,0,0,0,0
2015-07-27,111,111,107,107,834592,12,734592,4,1,734701,99891,-109,109,1,100000
2015-07-28,106,110,106,110,60922,4,10922,7,0,60922,0,-50000,50000,1,50000
2015-07-29,108,108,106,106,356784,18,156784,8,0,356784,0,-200000,200000,1,200000
2015-08-01,106,110,106,110,99106,2,2337,2,0,2337,0,0,0,0,0
2015-08-02,107,107,106,106,53076,9,53076,6,0,53076,0,0,0,0,0
2015-08-03,106,107,106,107,5708,1,5708,3,0,5708,0,0,0,0,0
2015-08-04,106,107,105,107,422955,28,322955,9,0,422955,0,-100000,100000,1,100000
2015-08-05,109,109,104,106,155324,10,55324,10,0,155324,0,-100000,100000,1,100000
2015-08-08,105,106,104,104,461719,20,454944,4,1,318998,142721,135946,-135946,1,6775
2015-08-09,103,105,103,105,19690,3,19690,4,0,19690,0,0,0,0,0
2015-08-10,104,105,104,105,43208,4,43208,7,0,43208,0,0,0,0,0
2015-08-12,104,104,103,104,38964,6,38964,4,0,38964,0,0,0,0,0
2015-08-15,103,104,103,104,46808,2,46808,4,0,46808,0,0,0,0,0
2015-08-16,103,104,103,104,48827,5,48827,7,0,48827,0,0,0,0,0
2015-08-17,104,105,104,104,61676,3,61676,10,0,61676,0,0,0,0,0
2015-08-18,103,104,103,104,60482,5,21625,4,0,21625,0,0,0,0,0
2015-08-19,104,104,104,104,8000,3,8000,4,0,8000,0,0,0,0,0
2015-08-22,103,104,103,103,136546,8,136546,4,0,136546,0,0,0,0,0
2015-08-23,103,104,103,103,260385,13,160385,5,0,260385,0,-100000,100000,1,100000
2015-08-24,102,104,102,102,1200405,19,100405,15,1,1168827,31578,-1068422,1068422,2,1100000
2015-08-25,101,103,101,101,651438,11,51438,10,1,151438,500000,-100000,100000,2,600000
2015-08-29,104,104,100,101,91236,14,49109,4,0,89236,0,-40127,40127,1,40127
2015-08-30,100,101,100,101,39982,11,39982,7,0,39982,0,0,0,0,0
2015-08-31,101,102,100,102,732300,12,47588,11,1,232300,500000,-184712,184712,2,684712
2015-09-01,101,101,99,99,88135,17,88135,8,0,88135,0,0,0,0,0
2015-09-02,99,99,99,99,232835,25,132835,9,0,232835,0,-100000,100000,1,100000
2015-09-05,98,101,98,101,871840,43,771840,16,0,871840,0,-100000,100000,1,100000
2015-09-06,104,104,98,98,145813,14,145813,7,0,145813,0,0,0,0,0
2015-09-07,97,99,97,99,33669,3,33669,6,0,33669,0,0,0,0,0
2015-09-08,99,99,98,99,5280,4,5280,4,0,5280,0,0,0,0,0
2015-09-09,98,98,97,97,63331,7,63331,8,0,63331,0,0,0,0,0
2015-09-12,97,97,97,97,194758,24,94758,4,0,194758,0,-100000,100000,1,100000
2015-09-13,97,97,96,96,150132,10,131904,7,0,150132,0,-18228,18228,1,18228
2015-09-14,96,98,96,96,176824,12,76824,8,0,176824,0,-100000,100000,1,100000
2015-09-15,96,97,96,96,179450,8,100323,8,0,179450,0,-79127,79127,1,79127
2015-09-16,95,96,95,95,61759,5,48276,6,0,61759,0,-13483,13483,1,13483
2015-09-19,96,96,95,96,2062604,9,35307,11,1,62604,2000000,-27297,27297,2,2027297
2015-09-20,94,96,92,92,865714,15,166016,6,2,34148,831566,131868,-131868,2,699698
2015-09-21,97,97,92,92,13867,6,13867,5,1,9867,4000,4000,-4000,0,0
2015-09-22,92,92,91,91,451511,22,151511,9,1,247072,204439,-95561,95561,1,300000
2015-09-23,93,93,92,93,59142,8,59142,6,0,59142,0,0,0,0,0
2015-09-26,92,93,91,93,27114,10,25592,9,0,27114,0,-1522,1522,1,1522
2015-09-27,92,92,91,91,57812,10,57812,4,1,37201,20611,20611,-20611,0,0
2015-09-28,91,92,90,92,182306,15,82306,4,0,182306,0,-100000,100000,1,100000
2015-09-29,91,92,91,91,13139,5,13139,8,0,13139,0,0,0,0,0
2015-09-30,91,93,91,91,115641,3,15641,11,0,115641,0,-100000,100000,1,100000
2015-10-03,90,93,90,90,1062242,11,62242,11,1,885360,176882,-823118,823118,2,1000000
2015-10-04,89,91,89,91,169435,4,14996,10,0,169435,0,-154439,154439,2,154439
2015-10-05,91,91,90,90,959731,7,30731,6,1,609731,350000,-579000,579000,1,929000
2015-10-06,89,95,89,95,401933,4,62786,22,1,301933,100000,-239147,239147,1,339147
2015-10-07,95,95,94,95,152414,6,18026,15,1,69594,82820,-51568,51568,1,134388
2015-10-10,92,93,89,93,576801,16,152260,15,1,337989,238812,-185729,185729,1,424541
2015-10-11,90,93,88,92,216110,12,72888,11,1,175123,40987,-102235,102235,2,143222
2015-10-12,92,94,92,94,229163,3,29163,14,2,114163,115000,-85000,85000,1,200000
2015-10-13,93,93,93,93,436067,7,136067,3,1,195000,241067,-58933,58933,1,300000
2015-10-14,95,95,94,94,143704,10,143704,10,1,47704,96000,96000,-96000,0,0
2015-10-17,94,97,94,97,267115,6,67115,11,1,206271,60844,-139156,139156,1,200000
2015-10-18,95,95,91,95,298091,6,48091,12,1,65160,232931,-17069,17069,1,250000
2015-10-19,94,94,92,92,218015,3,18015,5,0,218015,0,-200000,200000,1,200000
2015-10-20,93,96,93,96,13419,2,12791,3,0,13419,0,-628,628,1,628
2015-10-25,93,93,93,93,32136,3,14400,3,0,32136,0,-17736,17736,1,17736
2015-10-26,92,92,92,92,2000,1,2000,1,0,2000,0,0,0,0,0
2015-10-27,92,94,92,93,139185,5,45804,8,0,139185,0,-93381,93381,1,93381
2015-10-28,95,95,93,93,207550,3,7550,3,1,9510,198040,-1960,1960,1,200000
2015-10-31,94,94,91,91,156558,9,156558,3,0,156558,0,0,0,0,0
2015-11-01,94,96,93,96,110981,0,0,10,0,110981,0,-110981,110981,1,110981
2015-11-02,93,97,92,93,53800,4,16400,4,1,20000,33800,-3600,3600,1,37400
2015-11-03,97,97,93,93,65868,8,65868,4,0,65868,0,0,0,0,0
2015-11-04,95,95,92,92,101006,2,1006,8,1,51006,50000,-50000,50000,1,100000
2015-11-07,92,94,92,93,7466017,8,68017,3,1,6766017,700000,-6698000,6698000,2,7398000
2015-11-08,93,94,92,94,326918,3,33784,12,0,326918,0,-293134,293134,1,293134
2015-11-09,93,93,93,93,26591,1,126,3,0,26591,0,-26465,26465,1,26465
2015-11-10,93,93,93,93,95362,3,11194,5,0,95362,0,-84168,84168,1,84168
2015-11-11,93,94,93,94,202730,1,2730,0,1,0,202730,2730,-2730,1,200000
2015-11-14,93,93,89,89,1037564,37,737564,5,1,39541,998023,698023,-698023,2,300000
2015-11-15,92,92,88,88,2193042,56,663042,12,3,350994,1842048,312048,-312048,3,1530000
2015-11-16,89,89,85,85,957968,41,637968,3,1,25710,932258,612258,-612258,3,320000
2015-11-17,85,86,85,85,217324,6,17324,7,1,132870,84454,-115546,115546,1,200000
2015-11-18,87,88,84,84,1219681,62,911681,6,1,49681,1170000,862000,-862000,3,308000
2015-11-21,82,87,82,82,8688194,377,8238194,49,1,676073,8012121,7562121,-7562121,3,450000
2015-11-22,83,83,81,82,3869651,168,3449651,33,2,1264501,2605150,2185150,-2185150,5,420000
2015-11-23,83,85,82,84,1405458,86,1155956,62,2,1005458,400000,150498,-150498,2,249502
2015-11-24,83,84,83,84,806186,74,651596,52,0,806186,0,-154590,154590,1,154590
2015-11-25,83,84,83,83,576188,27,546783,39,0,575378,0,-28595,28595,1,28595
2015-11-28,83,83,81,82,365402,27,165402,24,0,365402,0,-200000,200000,1,200000
2015-11-29,81,83,80,80,911686,73,711686,47,0,911686,0,-200000,200000,1,200000
2015-11-30,82,82,78,79,2697957,108,1587957,66,1,1031276,1666681,556681,-556681,3,1110000
2015-12-01,78,79,76,77,641668,50,431668,42,1,521488,120180,-89820,89820,2,210000
2015-12-05,77,78,75,76,3014804,128,2714704,50,1,1360595,1654209,1354109,-1354109,3,300100
2015-12-06,73,76,73,74,949789,67,749789,30,1,645360,304429,104429,-104429,1,200000
2015-12-07,74,75,72,73,1257729,55,1057729,34,1,489170,768559,568559,-568559,1,200000
2015-12-08,72,73,72,73,573619,50,373619,32,1,507619,66000,-134000,134000,1,200000
2015-12-09,73,73,72,73,1094807,22,366082,21,1,335018,431064,31064,-31064,1,400000
2015-12-13,73,73,72,72,811303,39,611303,18,1,279847,531456,331456,-331456,1,200000
2015-12-14,73,73,71,71,897700,43,697700,12,1,85526,812174,612174,-612174,1,200000
2015-12-15,72,73,71,72,852380,35,452380,21,1,370320,482060,82060,-82060,1,400000
2015-12-16,73,74,72,72,855869,31,455869,32,2,322302,533567,133567,-133567,1,400000
2015-12-19,73,73,71,71,929497,23,729497,25,2,282763,646734,446734,-446734,1,200000
2015-12-20,72,72,70,70,377320,25,177320,24,2,181379,195941,-4059,4059,1,200000
2015-12-21,70,73,70,72,10928309,32,8728209,28,4,486534,10441775,8241675,-8241675,2,2200100
2015-12-22,72,72,70,71,374700,23,174700,7,3,172050,202650,2650,-2650,1,200000
2015-12-23,71,71,70,71,137930,22,137930,15,1,65718,72212,72212,-72212,0,0
2015-12-26,71,71,70,70,107163,18,107163,14,1,103011,4152,4152,-4152,0,0
2015-12-27,70,72,70,70,544662,38,544662,23,2,274127,270535,270535,-270535,0,0
2015-12-28,71,72,70,71,227343,28,227343,14,1,162127,65216,65216,-65216,0,0
2015-12-30,70,75,70,72,1419084,64,1169084,37,4,540508,878576,628576,-628576,1,250000
2016-01-02,73,73,71,71,498323,38,468323,16,3,367129,131194,101194,-101194,2,30000
2016-01-03,73,73,70,71,940844,49,776844,30,2,830683,110161,-53839,53839,1,164000
2016-01-04,72,73,71,73,1227162,32,927162,44,3,828407,398755,98755,-98755,1,300000
2016-01-05,73,76,72,76,3027092,51,3002092,75,6,1185281,1841811,1816811,-1816811,1,25000
2016-01-06,76,79,74,79,3540199,76,2960199,64,4,1437675,2102524,1522524,-1522524,4,580000
2016-01-09,78,78,75,75,1385505,39,1085505,39,2,982505,403000,103000,-103000,1,300000
2016-01-10,75,76,75,75,596086,26,296086,34,1,367731,228355,-71645,71645,2,300000
2016-01-11,76,79,76,79,3892808,38,1492915,68,2,2771163,1121645,-1278248,1278248,10,2399893
2016-01-12,79,80,78,80,2321253,35,1621146,56,1,1821253,500000,-200107,200107,3,700107
2016-01-13,78,83,77,83,3333256,23,1243127,87,3,1633256,1700000,-390129,390129,4,2090129
2016-01-16,85,85,85,85,2600000,18,2600000,18,3,247786,2352214,2352214,-2352214,0,0
2016-01-17,89,89,84,86,13068824,169,10773839,181,13,9343824,3725000,1430015,-1430015,5,2294985
2016-01-18,87,88,84,88,1957177,45,1692291,88,1,1947177,10000,-254886,254886,2,264886
2016-01-19,88,91,87,87,3555317,84,2347792,54,1,3535317,20000,-1187525,1187525,3,1207525
2016-01-20,89,90,86,89,1614819,65,1144551,72,0,1614819,0,-470268,470268,4,470268
2016-01-23,90,93,86,92,5689705,68,3611705,97,0,5689705,0,-2078000,2078000,5,2078000
2016-01-24,93,95,92,93,6897869,82,3530248,97,5,6539784,358085,-3009536,3009536,6,3367621
2016-01-25,94,98,91,98,7994691,46,2900777,105,3,5014691,2980000,-2113914,2113914,12,5093914
2016-01-26,103,103,100,103,4178392,39,3723872,53,10,1719082,2459310,2004790,-2004790,3,454520
2016-01-27,107,107,97,102,3429513,65,2441246,90,5,2466077,963436,-24831,24831,3,988267
2016-01-30,101,104,98,99,2679613,52,1617422,57,0,2679613,0,-1062191,1062191,3,1062191
2016-01-31,99,101,97,98,1784666,30,1298276,51,1,1584666,200000,-286390,286390,3,486390
2016-02-01,98,104,98,104,2549429,48,1696721,60,0,2549429,0,-852708,852708,2,852708
2016-02-02,104,105,98,98,2677583,63,1130291,47,8,2173189,504394,-1042898,1042898,3,1547292
2016-02-03,103,107,97,107,21205602,203,12665153,139,20,7436050,13769552,5229103,-5229103,8,8540449
2016-02-06,110,110,110,110,3308743,39,3208743,33,4,2342743,966000,866000,-866000,1,100000
2016-02-07,115,115,115,115,2764718,31,2464718,22,3,414718,2350000,2050000,-2050000,2,300000
2016-02-08,121,121,121,121,3099816,28,2499816,33,4,311708,2788108,2188108,-2188108,3,600000
2016-02-09,127,127,117,118,16910168,202,13560168,145,7,9467869,7442299,4092299,-4092299,7,3350000
2016-02-10,120,130,120,124,11927647,289,9927647,203,7,9677624,2250023,250023,-250023,4,2000000
2016-02-13,124,127,119,119,3086381,60,2326381,78,2,2815088,271293,-488707,488707,4,760000
2016-02-14,116,123,115,115,5881681,112,3706681,85,5,3575774,2305907,130907,-130907,6,2175000
2016-02-15,117,120,111,113,4758846,117,3598846,90,4,3471716,1287130,127130,-127130,4,1160000
2016-02-16,121,121,121,121,2846835,21,2470000,38,3,546835,2300000,1923165,-1923165,2,376835
2016-02-17,127,127,127,127,2860375,32,2760375,46,5,360375,2500000,2400000,-2400000,1,100000
2016-02-20,129,130,121,122,9011668,246,6761668,176,6,7799468,1212200,-1037800,1037800,3,2250000
2016-02-21,123,125,119,119,1766205,81,1664739,37,1,1752205,14000,-87466,87466,2,101466
2016-02-22,122,123,116,120,4290784,111,1874076,108,2,3744389,546395,-1870313,1870313,5,2416708
2016-02-23,123,123,115,115,1981153,87,1297331,63,1,1447683,533470,-150352,150352,2,683822
2016-02-24,119,119,113,114,750364,56,750364,46,1,736014,14350,14350,-14350,0,0
2016-02-27,116,118,113,113,1643319,62,1043319,54,2,1217255,426064,-173936,173936,2,600000
2016-02-28,113,114,111,112,1278802,63,778802,53,0,1278802,0,-500000,500000,1,500000
2016-02-29,111,114,109,110,1506962,105,1367128,64,2,1066587,440375,300541,-300541,2,139834
2016-03-01,111,117,110,117,3422251,46,2256592,101,1,3022251,400000,-765659,765659,4,1165659
2016-03-02,114,118,114,118,5312637,91,3612637,118,5,2025515,3287122,1587122,-1587122,2,1700000
2016-03-05,114,123,114,123,8407098,97,7087126,163,12,4043792,4363306,3043334,-3043334,3,1319972
2016-03-06,127,127,122,125,5355123,86,3495123,169,3,4346123,1009000,-851000,851000,2,1860000
2016-03-07,126,130,122,128,11531479,65,2702977,187,6,7594903,3936576,-4891926,4891926,6,8828502
2016-03-08,124,131,124,127,19023638,111,5507331,178,9,8785142,10238496,-3277811,3277811,7,13516307
2016-03-15,136,143,136,143,12061351,40,4316283,102,5,4333351,7728000,-17068,17068,3,7745068
2016-03-16,141,143,136,140,3865876,65,865876,77,3,3747086,118790,-2881210,2881210,1,3000000
2016-03-26,132,143,132,136,1233512,45,733512,34,1,1233412,100,-499900,499900,1,500000
2016-03-27,139,139,132,132,1912654,71,1812654,23,1,1897654,15000,-85000,85000,1,100000
2016-03-28,130,132,128,129,756502,47,756502,36,0,756502,0,0,0,0,0
2016-03-29,129,136,128,134,678925,31,379441,48,0,678925,0,-299484,299484,3,299484
2016-03-30,134,137,131,135,1128261,41,1054765,43,0,1128261,0,-73496,73496,2,73496
2016-04-02,139,139,130,133,2775352,36,840996,38,0,2775352,0,-1934356,1934356,5,1934356
2016-04-03,131,133,129,133,861596,23,285355,24,0,861596,0,-576241,576241,2,576241
2016-04-04,133,133,128,129,1256570,36,839419,26,3,1116248,140322,-276829,276829,4,417151
2016-04-05,128,132,128,129,752194,32,702194,31,2,522634,229560,179560,-179560,1,50000
2016-04-06,132,132,128,129,1072581,20,365338,27,2,824869,247712,-459531,459531,3,707243
2016-04-09,128,136,128,131,1019067,28,299067,50,0,1019067,0,-720000,720000,2,720000
2016-04-10,129,130,126,127,677812,31,329755,23,0,677812,0,-348057,348057,2,348057
2016-04-11,126,130,126,129,329538,11,63595,22,1,324538,5000,-260943,260943,2,265943
2016-04-12,131,133,124,124,1359326,48,956228,26,1,1070287,289039,-114059,114059,3,403098
2016-04-13,124,124,122,124,964986,53,913680,29,1,783986,181000,129694,-129694,2,51306
2016-04-16,124,124,120,120,340076,28,240076,8,0,340076,0,-100000,100000,1,100000
2016-04-17,119,124,119,121,840788,47,740788,30,0,840788,0,-100000,100000,1,100000
2016-04-18,120,126,120,124,543825,42,543825,33,0,543825,0,0,0,0,0
2016-04-19,124,124,118,119,507744,41,493130,21,0,507744,0,-14614,14614,1,14614
2016-04-20,123,123,118,121,568055,35,359194,20,0,568055,0,-208861,208861,1,208861
2016-04-23,123,126,123,123,574551,17,351598,30,0,574551,0,-222953,222953,1,222953
2016-04-24,125,127,122,126,299356,25,299356,29,1,261743,37613,37613,-37613,0,0
2016-04-25,126,127,123,123,511024,22,501381,19,1,510161,863,-8780,8780,1,9643
2016-04-26,117,125,117,123,100174,15,100174,13,0,100174,0,0,0,0,0
2016-04-27,124,124,121,121,541926,36,291926,32,1,421426,120500,-129500,129500,2,250000
2016-04-30,121,123,120,120,185081,22,176081,18,0,185081,0,-9000,9000,1,9000
2016-05-01,119,123,117,122,536365,48,315443,19,1,274841,261524,40602,-40602,2,220922
2016-05-02,117,120,116,119,333668,26,136377,20,0,333668,0,-197291,197291,2,197291
2016-05-03,121,121,118,119,213056,21,213056,21,0,213056,0,0,0,0,0
2016-05-04,119,126,119,123,1797883,44,1294040,75,2,1259227,538656,34813,-34813,1,503843
2016-05-07,125,125,117,119,260051,16,130051,18,1,259051,1000,-129000,129000,1,130000
2016-05-08,117,120,116,116,1686904,41,582419,20,1,1597842,89062,-1015423,1015423,3,1104485
2016-05-09,117,118,115,116,534455,29,328427,13,0,534455,0,-206028,206028,1,206028
2016-05-10,118,118,115,118,492420,10,492420,18,1,420092,72328,72328,-72328,0,0
2016-05-11,114,117,113,113,1663101,24,503561,20,0,1663101,0,-1159540,1159540,3,1159540
2016-05-14,114,115,114,115,111512,17,111512,9,0,111512,0,0,0,0,0
2016-05-15,114,114,110,112,2190949,51,1593549,20,0,2190949,0,-597400,597400,4,597400
2016-05-17,109,114,109,113,213182,17,213182,22,0,213182,0,0,0,0,0
2016-05-18,114,114,110,114,424167,28,175638,28,0,424167,0,-248529,248529,2,248529
2016-05-21,114,115,112,115,1175588,17,122008,12,1,175588,1000000,-53580,53580,3,1053580
2016-05-23,116,116,113,114,829794,26,269690,13,0,829794,0,-560104,560104,3,560104
2016-05-24,116,116,113,113,1273228,20,81968,21,1,273228,1000000,-191260,191260,2,1191260
2016-05-25,113,116,112,113,588869,28,528869,15,1,302471,286398,226398,-226398,2,60000
2016-05-28,115,115,112,112,1114126,13,249524,15,2,216704,897422,32820,-32820,1,864602
2016-05-29,112,115,110,115,5895217,21,166218,19,1,381732,5513485,-215514,215514,4,5728999
2016-05-30,113,113,110,110,355886,34,345886,12,1,354886,1000,-9000,9000,1,10000
2016-05-31,110,111,110,110,115376,10,115376,5,0,115376,0,0,0,0,0
2016-06-01,112,112,109,110,314450,24,314450,21,0,314450,0,0,0,0,0
2016-06-05,112,112,110,111,86459,16,86459,15,0,86459,0,0,0,0,0
2016-06-06,110,112,110,112,157415,13,57415,17,0,157415,0,-100000,100000,1,100000
2016-06-07,110,111,109,110,698164,23,548164,26,0,698164,0,-150000,150000,1,150000
2016-06-08,110,110,107,108,356900,34,256900,18,2,126939,229961,129961,-129961,1,100000
2016-06-11,106,109,106,106,401515,36,251515,11,0,401515,0,-150000,150000,2,150000
2016-06-12,106,109,105,105,261645,16,159027,17,0,261645,0,-102618,102618,2,102618
2016-06-13,105,109,105,106,617369,20,293895,17,1,361000,256369,-67105,67105,2,323474
2016-06-14,106,109,104,104,315780,28,215780,18,0,315780,0,-100000,100000,1,100000
2016-06-15,104,107,104,105,139311,12,71770,11,1,90576,48735,-18806,18806,2,67541
2016-06-18,105,105,104,104,409483,33,301483,17,1,376464,33019,-74981,74981,2,108000
2016-06-19,103,103,103,103,349597,20,249597,6,1,95406,254191,154191,-154191,1,100000
2016-06-20,102,105,102,102,1072130,23,771130,17,1,783812,288318,-12682,12682,2,301000
2016-06-21,102,104,101,104,802977,22,802977,17,1,778505,24472,24472,-24472,0,0
2016-06-22,106,108,104,106,475913,34,470913,17,0,475913,0,-5000,5000,1,5000
2016-06-25,106,106,102,103,529318,12,527318,15,1,329318,200000,198000,-198000,1,2000
2016-06-26,102,105,102,105,224572,13,224572,12,0,224572,0,0,0,0,0
2016-06-28,104,109,104,107,777985,21,177985,35,0,777985,0,-600000,600000,1,600000
2016-06-29,106,106,104,104,610673,23,559813,22,0,610673,0,-50860,50860,1,50860
2016-07-02,103,105,102,104,191803,9,189938,10,0,191803,0,-1865,1865,1,1865
2016-07-03,103,106,102,106,31041323,26,447249,19,1,541323,30500000,-94074,94074,1,30594074
2016-07-04,102,103,102,102,97200,18,91200,8,0,97200,0,-6000,6000,1,6000
2016-07-05,102,103,101,102,323757,26,323757,10,2,317207,6550,6550,-6550,0,0
2016-07-09,102,102,100,101,117592,22,113579,15,0,117592,0,-4013,4013,1,4013
2016-07-10,102,102,101,102,30064,8,30064,6,0,30064,0,0,0,0,0
2016-07-11,101,101,100,101,336408,26,332408,17,0,336408,0,-4000,4000,1,4000
2016-07-12,100,102,100,102,239807,12,239807,14,1,239806,1,1,-1,0,0
2016-07-13,101,102,101,102,460043,10,355043,12,2,159943,300100,195100,-195100,2,105000
2016-07-16,101,104,101,104,762799,8,706570,22,0,762799,0,-56229,56229,1,56229
2016-07-17,103,106,102,105,367273,13,67273,26,0,367273,0,-300000,300000,1,300000
2016-07-18,104,108,103,103,231949,14,131949,19,1,210949,21000,-79000,79000,1,100000
2016-07-19,105,105,103,104,392964,19,389264,7,1,355162,37802,34102,-34102,1,3700
2016-07-20,105,107,104,107,427591,6,117106,27,0,427591,0,-310485,310485,1,310485
2016-07-23,107,108,107,108,704937,36,389937,27,0,704937,0,-315000,315000,1,315000
2016-07-24,108,110,107,110,912920,33,632920,56,1,812920,100000,-180000,180000,1,280000
2016-07-25,111,111,110,111,863443,18,563443,46,3,638675,224768,-75232,75232,1,300000
2016-07-26,113,113,111,111,571966,37,571966,38,0,571966,0,0,0,0,0
2016-07-27,109,114,109,110,755207,27,750207,45,1,754966,241,-4759,4759,1,5000
2016-07-31,114,114,111,111,359579,16,359579,24,0,359579,0,0,0,0,0
2016-08-01,111,113,110,113,494435,15,282348,31,0,494435,0,-212087,212087,5,212087
2016-08-02,113,115,113,113,529931,12,229931,27,0,529931,0,-300000,300000,1,300000
2016-08-03,113,116,113,116,642568,14,243483,52,1,562568,100000,-319085,319085,1,419085
2016-08-06,116,117,113,117,633286,12,401623,41,1,533286,100000,-131663,131663,4,231663
2016-08-07,117,118,114,117,1426186,20,226186,41,2,326186,1100000,-100000,100000,7,1200000
2016-08-08,116,119,116,119,288714,15,288714,37,0,288714,0,0,0,0,0
2016-08-09,119,121,117,119,1236410,13,766410,37,2,612202,624208,154208,-154208,3,470000
2016-08-10,118,119,116,119,270955,16,215250,25,0,270955,0,-55705,55705,2,55705
2016-08-13,117,119,114,116,58330,9,42978,18,0,58330,0,-15352,15352,1,15352
2016-08-14,115,119,115,116,387724,11,243848,24,0,387724,0,-143876,143876,1,143876
2016-08-15,117,117,115,116,571063,14,252010,26,1,337232,233831,-85222,85222,1,319053
2016-08-16,113,117,113,117,12337813,9,138618,24,3,665335,11672478,-526717,526717,2,12199195
2016-08-17,117,119,116,117,1922980,9,1623380,32,0,1922980,0,-299600,299600,2,299600
2016-08-20,116,117,116,117,420940,13,156566,16,0,420940,0,-264374,264374,1,264374
2016-08-21,117,119,117,117,317483,6,171857,17,0,317483,0,-145626,145626,3,145626
2016-08-22,117,118,115,117,2099764,13,392338,15,0,2099764,0,-1707426,1707426,3,1707426
2016-08-23,116,119,115,116,176786,6,27524,18,1,149403,27383,-121879,121879,2,149262
2016-08-24,116,117,116,116,117848,7,57642,11,0,117848,0,-60206,60206,1,60206
2016-08-27,115,119,114,119,361914,3,6530,25,0,361914,0,-355384,355384,3,355384
2016-08-28,117,118,116,117,943514,8,175165,43,1,570897,372617,-395732,395732,4,768349
2016-08-29,117,118,116,117,724236,1,95634,22,2,324236,400000,-228602,228602,2,628602
2016-08-30,119,123,119,121,5855934,68,1775964,91,4,3446934,2409000,-1670970,1670970,6,4079970
2016-08-31,123,125,121,122,1725783,16,441053,48,1,1625783,100000,-1184730,1184730,2,1284730
2016-09-03,121,125,118,118,369073,8,119073,26,1,362708,6365,-243635,243635,2,250000
2016-09-04,117,119,117,119,149062,8,133966,18,0,149062,0,-15096,15096,1,15096
2016-09-05,117,119,117,119,407697,11,407697,15,0,407697,0,0,0,0,0
2016-09-06,117,119,117,119,256416,11,256416,19,1,156416,100000,100000,-100000,0,0
2016-09-07,119,119,118,118,32554,7,32554,9,0,32554,0,0,0,0,0
2016-09-10,118,118,116,116,676271,17,451083,23,0,676271,0,-225188,225188,2,225188
2016-09-11,118,118,116,116,419629,7,73198,11,0,419629,0,-346431,346431,1,346431
2016-09-13,116,120,116,119,1299391,16,160514,28,0,1299391,0,-1138877,1138877,2,1138877
2016-09-14,117,117,116,117,285166,7,226116,5,0,285166,0,-59050,59050,1,59050
2016-09-17,116,117,115,116,1030695,19,644195,14,1,830695,200000,-186500,186500,1,386500
2016-09-18,114,117,114,115,873273,8,201417,11,2,450832,422441,-249415,249415,3,671856
2016-09-19,119,119,115,115,31936,6,31936,7,1,11436,20500,20500,-20500,0,0
2016-09-21,118,123,118,122,4045012,5,233487,62,4,1840012,2205000,-1606525,1606525,1,3811525
2016-09-24,122,124,120,124,47605,8,47605,7,0,47605,0,0,0,0,0
2016-09-25,120,121,120,121,154609,11,154609,11,0,154609,0,0,0,0,0
2016-09-26,120,120,118,119,52851,8,52851,9,0,52851,0,0,0,0,0
2016-09-27,119,119,118,118,234905,15,234905,9,0,234905,0,0,0,0,0
2016-09-28,118,126,118,123,897491,28,497491,38,2,789791,107700,-292300,292300,1,400000
2016-10-01,122,123,120,120,119334,12,119334,16,0,119334,0,0,0,0,0
2016-10-02,119,119,117,117,380261,20,380261,9,0,380261,0,0,0,0,0
2016-10-03,117,119,117,119,226844,15,226844,21,0,226844,0,0,0,0,0
2016-10-04,119,123,119,123,1059204,4,59204,55,0,1059204,0,-1000000,1000000,1,1000000
2016-10-05,118,119,117,118,241621,26,241621,11,0,241621,0,0,0,0,0
2016-10-08,117,119,117,118,54896,12,54896,7,0,54896,0,0,0,0,0
2016-10-09,118,121,118,118,49242,10,49242,5,1,14242,35000,35000,-35000,0,0
2016-10-10,118,118,117,117,341902,23,341902,4,1,48606,293296,293296,-293296,0,0
2016-10-15,118,118,117,117,275091,23,275091,7,1,211021,64070,64070,-64070,0,0
2016-10-16,119,123,118,119,1082739,21,577739,46,1,982739,100000,-405000,405000,2,505000
2016-10-17,122,123,119,121,1215437,14,115437,33,0,1215437,0,-1100000,1100000,1,1100000
2016-10-18,121,121,119,119,252373,18,252373,9,0,252373,0,0,0,0,0
2016-10-19,118,119,118,118,153017,15,148017,7,1,128317,24700,19700,-19700,1,5000
2016-10-22,120,121,118,118,381453,33,376453,9,1,310088,71365,66365,-66365,1,5000
2016-10-23,119,119,118,118,416920,25,416920,15,2,355762,61158,61158,-61158,0,0
2016-10-24,119,121,118,119,235105,8,235105,11,0,235105,0,0,0,0,0
2016-10-25,118,119,117,117,330104,30,330104,8,1,147170,182934,182934,-182934,0,0
2016-10-26,119,119,118,119,181039,14,181039,10,0,181039,0,0,0,0,0
2016-10-29,118,123,118,119,1104490,32,904490,28,0,1104490,0,-200000,200000,1,200000
2016-10-30,122,122,119,119,439467,22,439467,19,1,239467,200000,200000,-200000,0,0
2016-10-31,121,122,119,119,132929,18,132929,20,0,132929,0,0,0,0,0
2016-11-01,119,120,118,119,234240,14,234240,11,0,234240,0,0,0,0,0
2016-11-02,117,118,117,117,301275,29,301275,13,0,301275,0,0,0,0,0
2016-11-05,117,119,117,118,276868,26,276868,13,0,276868,0,0,0,0,0
2016-11-06,117,118,117,117,108311,16,108311,14,0,108311,0,0,0,0,0
2016-11-07,117,118,117,118,285851,19,280851,8,0,285851,0,-5000,5000,1,5000
2016-11-08,117,117,117,117,61808,14,61808,8,0,61808,0,0,0,0,0
2016-11-09,113,115,113,114,1017043,60,967043,21,0,1017043,0,-50000,50000,1,50000
2016-11-12,116,116,111,114,410399,37,410399,14,1,371797,38602,38602,-38602,0,0
2016-11-13,113,115,111,113,162426,24,162426,11,0,162426,0,0,0,0,0
2016-11-14,112,115,112,113,256683,12,241473,13,0,256683,0,-15210,15210,1,15210
2016-11-15,113,114,113,114,268248,11,89128,7,0,268248,0,-179120,179120,1,179120
2016-11-16,113,113,112,113,245740,16,245740,12,0,245740,0,0,0,0,0
2016-11-19,113,113,112,112,107956,7,107956,10,0,107956,0,0,0,0,0
2016-11-21,112,113,111,112,123033,14,173595,14,1,126435,47160,47160,-47160,0,0
2016-11-22,112,112,111,111,154434,19,154434,9,1,51594,102840,102840,-102840,0,0
2016-11-23,111,111,110,110,130342,17,130342,14,0,130342,0,0,0,0,0
2016-11-26,109,111,109,110,223006,35,223006,12,0,223006,0,0,0,0,0
2016-11-27,113,113,110,110,91195,15,91195,6,1,44345,46850,46850,-46850,0,0
2016-11-29,110,112,110,110,69157,11,69157,15,0,69157,0,0,0,0,0
2016-12-03,110,111,110,111,48183,3,48183,6,0,48183,0,0,0,0,0
2016-12-04,111,111,111,111,45793,2,45793,9,0,45793,0,0,0,0,0
2016-12-05,110,113,110,113,230813,4,205139,15,1,230579,234,-25440,25440,1,25674
2016-12-06,111,112,110,110,47983,13,47983,7,0,47983,0,0,0,0,0
2016-12-07,112,115,112,115,159421,9,60161,24,0,159421,0,-99260,99260,1,99260
2016-12-10,116,116,108,111,244440,34,239440,8,2,244099,341,-4659,4659,1,5000
2016-12-11,110,110,109,110,48543,5,48543,6,0,48543,0,0,0,0,0
2016-12-12,113,114,110,112,88209,9,84209,14,0,88209,0,-4000,4000,1,4000
2016-12-13,111,111,110,110,93861,12,93861,8,0,93861,0,0,0,0,0
2016-12-14,113,113,110,111,92047,8,92047,8,0,92047,0,0,0,0,0
2016-12-18,109,113,109,113,116093,2,12859,17,0,116093,0,-103234,103234,2,103234
2016-12-19,113,113,110,110,46801,7,46801,6,0,46801,0,0,0,0,0
2016-12-20,110,112,108,109,227108,16,227108,5,0,227108,0,0,0,0,0
2016-12-21,108,111,108,111,28394,5,28394,3,1,27348,1046,1046,-1046,0,0
2016-12-24,110,110,108,109,84727,10,80727,4,0,84727,0,-4000,4000,1,4000
2016-12-25,112,112,107,108,133945,20,126179,7,0,133945,0,-7766,7766,1,7766
2016-12-26,107,108,107,108,147078,17,147078,12,0,147078,0,0,0,0,0
2016-12-27,107,107,106,106,2538018,55,1038018,16,1,538018,2000000,500000,-500000,1,1500000
2016-12-28,107,107,104,106,103319,18,103319,12,0,103319,0,0,0,0,0
2016-12-31,104,108,104,108,64354,4,64354,8,0,64354,0,0,0,0,0
2017-01-01,109,109,106,108,71654,8,71654,12,0,71654,0,0,0,0,0
2017-01-02,105,108,102,102,535300,32,535300,5,1,35300,500000,500000,-500000,0,0
2017-01-03,101,104,101,104,36550,9,36550,7,0,36550,0,0,0,0,0
2017-01-04,103,104,102,104,60331,6,24609,8,0,69271,0,-44662,44662,1,44662
2017-01-07,104,105,102,105,204712,8,204712,19,0,204712,0,0,0,0,0
2017-01-08,104,104,103,104,65668,9,39354,9,0,65668,0,-26314,26314,1,26314
2017-01-09,108,108,102,102,19200,7,16787,6,0,19200,0,-2413,2413,1,2413
2017-01-11,102,102,102,102,262288,19,145019,9,2,102288,160000,42731,-42731,1,117269
2017-01-14,103,105,100,105,332466,26,232466,14,0,332466,0,-100000,100000,1,100000
2017-01-15,102,106,102,105,369724,16,135324,23,1,197228,172496,-61904,61904,1,234400
2017-01-16,106,106,104,106,109063,8,77448,14,0,109063,0,-31615,31615,1,31615
2017-01-17,103,105,102,105,137464,8,115930,13,0,137464,0,-21534,21534,1,21534
2017-01-18,103,106,102,105,316610,12,101281,9,1,61248,255362,40033,-40033,1,215329
2017-01-21,105,107,102,105,1140825,22,115825,18,1,290924,849901,-175099,175099,1,1025000
2017-01-22,102,105,100,104,146928,24,107495,6,1,46928,100000,60567,-60567,1,39433
2017-01-23,104,106,104,105,146612,10,104747,13,0,146612,0,-41865,41865,1,41865
2017-01-24,106,106,104,104,197699,8,172000,14,0,197699,0,-25699,25699,1,25699
2017-01-25,105,105,103,104,473932,7,43932,9,1,99112,374820,-55180,55180,1,430000
2017-01-28,105,106,104,106,281368,5,281368,20,0,281368,0,0,0,0,0
2017-01-29,104,106,104,106,228441,6,228441,10,1,128441,100000,100000,-100000,0,0
2017-01-30,104,108,104,105,429245,12,229245,20,1,309328,119917,-80083,80083,1,200000
2017-01-31,105,108,105,108,90222,4,10082,15,0,90222,0,-80140,80140,1,80140
2017-02-01,107,107,103,103,412946,15,312946,5,0,412946,0,-100000,100000,1,100000
2017-02-04,105,105,104,104,45924,5,45924,7,0,45924,0,0,0,0,0
2017-02-05,104,106,103,105,88026,5,88026,12,0,88026,0,0,0,0,0
2017-02-06,104,104,103,103,227997,10,227997,12,0,227997,0,0,0,0,0
2017-02-07,103,106,103,105,238260,14,238260,21,0,238260,0,0,0,0,0
2017-02-08,104,105,104,105,79404,4,79404,9,0,79404,0,0,0,0,0
2017-02-11,104,106,104,104,140290,10,140290,13,0,140290,0,0,0,0,0
2017-02-12,103,106,103,104,294938,8,48798,15,0,294938,0,-246140,246140,2,246140
2017-02-13,105,106,104,105,502575,12,144087,14,2,479135,23440,-335048,335048,2,358488
2017-02-14,103,106,103,106,166408,6,67560,11,1,156408,10000,-88848,88848,2,98848
2017-02-15,104,106,104,106,222834,7,217666,9,1,212834,10000,4832,-4832,1,5168
2017-02-18,106,106,105,106,162225,13,148225,10,0,162225,0,-14000,14000,1,14000
2017-02-19,106,110,106,110,2116534,59,2116534,69,1,2111534,5000,5000,-5000,0,0
2017-02-20,112,112,110,111,525367,31,525367,20,0,525367,0,0,0,0,0
2017-02-21,108,110,107,107,861281,30,761281,20,1,361281,500000,400000,-400000,1,100000
2017-02-22,109,110,108,109,254965,9,54965,14,0,254965,0,-200000,200000,1,200000
2017-02-25,109,110,109,109,756909,11,131909,27,0,756909,0,-625000,625000,1,625000
2017-02-26,109,113,109,110,801302,13,234199,36,0,801302,0,-567103,567103,1,567103
2017-02-27,112,115,110,115,1124251,5,653751,35,3,897114,227137,-243363,243363,2,470500
2017-02-28,117,117,117,117,1765747,20,1667747,21,2,165747,1600000,1502000,-1502000,1,98000
2017-03-01,121,121,121,121,2790655,25,2790655,49,5,2186755,603900,603900,-603900,0,0
2017-03-04,122,125,116,116,8607182,110,5177829,159,4,7409144,1198038,-2231315,2231315,6,3429353
2017-03-05,121,121,115,115,395683,20,295683,8,1,166330,229353,129353,-129353,1,100000
2017-03-06,114,114,114,114,132050,9,32050,3,0,132050,0,-100000,100000,1,100000
2017-03-07,114,114,114,114,103800,5,3800,3,0,103800,0,-100000,100000,1,100000
2017-03-08,114,114,114,114,104296,4,4296,2,0,104296,0,-100000,100000,1,100000
2017-03-11,114,114,114,114,120000,5,20000,3,0,120000,0,-100000,100000,1,100000
2017-03-12,113,113,113,113,106390,7,6390,2,0,106390,0,-100000,100000,1,100000
2017-03-13,113,113,113,113,157659,3,57659,1,0,157659,0,-100000,100000,1,100000
2017-03-14,113,113,113,113,3513756,24,313756,62,1,3486285,27471,-3172529,3172529,2,3200000
2017-03-15,110,115,109,110,525951,35,525951,19,1,521204,4747,4747,-4747,0,0
2017-03-18,115,115,110,113,227518,11,227518,9,0,227518,0,0,0,0,0
2017-03-25,111,114,110,110,154765,17,154765,9,1,94765,60000,60000,-60000,0,0
2017-03-26,113,116,113,116,203000,0,0,15,0,203000,0,-203000,203000,4,203000
2017-03-27,113,116,111,111,62372,11,62372,7,0,62372,0,0,0,0,0
2017-03-28,116,116,113,116,139240,4,39240,17,0,139240,0,-100000,100000,1,100000
2017-03-29,111,116,111,113,28256,7,28256,6,0,28256,0,0,0,0,0
2017-04-03,113,115,111,111,192340,19,171340,16,0,192340,0,-21000,21000,1,21000
2017-04-04,114,114,111,111,134883,16,134883,7,0,134883,0,0,0,0,0
2017-04-05,115,115,111,111,87178,13,67178,10,1,77463,9715,-10285,10285,1,20000
2017-04-08,112,114,111,113,878920,41,471377,24,1,778920,100000,-307543,307543,1,407543
2017-04-09,114,115,112,115,264022,24,263922,22,0,264022,0,-100,100,1,100
2017-04-10,115,116,113,114,263141,33,263141,28,0,263141,0,0,0,0,0
2017-04-12,113,115,113,113,557115,27,262115,10,0,557115,0,-295000,295000,1,295000
2017-04-15,113,113,110,113,1574208,75,1244208,42,1,1322467,251741,-78259,78259,1,330000
2017-04-24,110,113,108,109,361604,31,361604,25,0,361604,0,0,0,0,0
2017-04-26,108,117,107,115,972027,38,722027,64,0,972027,0,-250000,250000,1,250000
2017-04-29,112,117,112,114,622847,20,622847,20,0,622847,0,0,0,0,0
2017-04-30,113,114,112,112,349210,18,349210,15,0,349210,0,0,0,0,0
2017-05-01,112,114,112,113,115519,5,115519,16,0,115519,0,0,0,0,0
2017-05-02,113,114,112,113,229604,9,229604,9,0,229604,0,0,0,0,0
2017-05-03,113,113,109,111,444012,17,444012,14,1,443912,100,100,-100,0,0
2017-05-06,110,110,110,110,359161,12,359161,16,0,359161,0,0,0,0,0
2017-05-07,110,110,107,107,522416,33,522416,11,1,502418,19998,19998,-19998,0,0
2017-05-08,108,108,108,108,25200,3,25200,3,0,25200,0,0,0,0,0
2017-05-09,108,117,107,116,1613259,10,222323,57,0,1613259,0,-1390936,1390936,3,1390936
2017-05-10,115,115,110,110,395867,15,138867,18,0,395867,0,-257000,257000,1,257000
2017-05-13,115,115,111,114,438602,9,282602,27,0,438602,0,-156000,156000,2,156000
2017-05-14,113,113,109,109,293274,16,278974,8,0,293274,0,-14300,14300,1,14300
2017-05-15,108,110,108,109,90003,8,90003,8,0,90003,0,0,0,0,0
2017-05-16,113,113,110,110,83650,7,70450,11,0,83650,0,-13200,13200,1,13200
2017-05-17,110,111,109,109,160330,8,160330,10,0,160330,0,0,0,0,0
2017-05-20,117,117,112,113,367168,13,367168,21,0,367168,0,0,0,0,0
2017-05-21,113,113,112,113,208688,7,208688,9,1,189248,19440,19440,-19440,0,0
2017-05-22,113,113,112,113,119593,6,119593,6,0,119593,0,0,0,0,0
2017-05-23,113,116,112,116,255218,7,255218,29,2,243593,11625,11625,-11625,0,0
2017-05-24,113,115,112,112,124896,8,124896,6,0,124896,0,0,0,0,0
2017-05-27,112,112,109,109,409970,24,409970,7,0,409970,0,0,0,0,0
2017-05-28,109,109,109,109,34742,3,34742,4,0,34742,0,0,0,0,0
2017-05-29,111,113,108,108,221112,15,221112,12,0,221112,0,0,0,0,0
2017-05-30,108,109,108,108,264011,10,264011,11,0,264011,0,0,0,0,0
2017-05-31,108,109,107,108,142671,16,142671,10,0,142671,0,0,0,0,0
2017-06-03,108,110,108,108,182727,9,182727,6,0,182727,0,0,0,0,0
2017-06-06,108,108,107,107,58059,7,58059,7,0,58059,0,0,0,0,0
2017-06-07,107,108,106,106,475688,21,475688,14,0,475688,0,0,0,0,0
2017-06-10,106,109,106,107,78618,7,78618,7,0,78618,0,0,0,0,0
2017-06-11,107,109,106,106,168241,9,168241,11,0,168241,0,0,0,0,0
2017-06-12,108,108,106,106,170322,11,170322,9,0,170322,0,0,0,0,0
2017-06-13,106,106,105,105,380201,35,380201,6,1,126469,253732,253732,-253732,0,0
2017-06-14,105,105,105,105,57850,10,57850,6,0,57850,0,0,0,0,0
2017-06-17,105,107,105,105,16532,4,16532,4,0,16532,0,0,0,0,0
2017-06-18,105,106,105,106,178919,7,178919,10,0,178919,0,0,0,0,0
2017-06-19,105,105,105,105,49999,9,49999,6,0,49999,0,0,0,0,0
2017-06-20,105,105,105,105,47343,5,47343,7,0,47343,0,0,0,0,0
2017-06-24,106,106,105,105,42439,7,41439,2,0,42439,0,-1000,1000,1,1000
2017-06-25,105,106,105,105,55319,8,55319,7,0,55319,0,0,0,0,0
2017-06-28,105,105,105,105,5343,4,5343,3,0,5343,0,0,0,0,0
2017-07-01,105,105,105,105,213697,4,213697,7,0,213697,0,0,0,0,0
2017-07-02,105,105,104,104,151028,13,151028,15,0,151028,0,0,0,0,0
2017-07-03,104,104,103,103,57627,13,57627,4,0,57627,0,0,0,0,0
2017-07-04,103,103,103,103,96316,12,90316,9,0,96316,0,-6000,6000,1,6000
2017-07-05,103,103,103,103,173207,12,173207,9,1,63207,110000,110000,-110000,0,0
2017-07-08,102,103,102,102,100321,12,100321,10,0,100321,0,0,0,0,0
2017-07-09,103,103,102,103,106535,13,106535,8,0,106535,0,0,0,0,0
2017-07-10,103,106,103,105,146306,11,146306,25,0,146306,0,0,0,0,0
2017-07-11,103,105,103,104,55290,11,55290,8,1,35850,19440,19440,-19440,0,0
2017-07-12,104,105,103,103,302595,13,302595,8,0,302595,0,0,0,0,0
2017-07-15,103,104,101,104,319370,20,319370,12,0,319370,0,0,0,0,0
2017-07-16,102,102,101,102,20193,10,20193,6,0,20193,0,0,0,0,0
2017-07-17,102,103,101,103,138504,16,138504,8,0,138504,0,0,0,0,0
2017-07-18,103,103,101,101,972793,42,971630,7,1,99933,872860,871697,-871697,1,1163
2017-07-19,100,104,99,104,286353,16,286353,18,0,286353,0,0,0,0,0
2017-07-22,105,108,103,107,318483,17,315844,33,0,318483,0,-2639,2639,1,2639
2017-07-23,108,108,105,106,106376,12,103853,10,2,80268,26108,23585,-23585,1,2523
2017-07-24,106,107,106,106,143284,8,141167,13,1,123284,20000,17883,-17883,1,2117
2017-07-25,106,107,105,106,210067,16,210067,23,1,180067,30000,30000,-30000,0,0
2017-07-26,106,106,102,102,264714,20,264714,15,0,264714,0,0,0,0,0
2017-07-29,102,105,102,102,88057,10,88057,11,0,88057,0,0,0,0,0
2017-07-30,102,104,101,101,132196,13,132196,9,1,82196,50000,50000,-50000,0,0
2017-07-31,102,102,99,101,207536,30,207536,6,2,116076,91460,91460,-91460,0,0
2017-08-01,100,102,99,99,242274,28,242274,8,1,130028,112246,112246,-112246,0,0
2017-08-02,100,101,99,101,109335,10,109335,4,1,13041,96294,96294,-96294,0,0
2017-08-06,101,101,100,101,150133,13,150133,5,1,30802,119331,119331,-119331,0,0
2017-08-07,99,101,99,100,427916,18,327916,11,1,320806,107110,7110,-7110,2,100000
2017-08-08,98,100,98,99,239324,20,225896,11,1,238992,332,-13096,13096,1,13428
2017-08-09,100,100,98,98,137892,17,137892,10,1,95002,42890,42890,-42890,0,0
2017-08-12,99,103,99,103,216370,4,156370,15,0,216370,0,-60000,60000,1,60000
2017-08-13,101,101,100,101,125805,2,35805,5,1,113320,12485,-77515,77515,1,90000
2017-08-14,100,102,98,98,499597,25,449597,11,1,484597,15000,-35000,35000,1,50000
2017-08-15,99,100,97,97,268590,25,268590,6,0,268590,0,0,0,0,0
2017-08-16,98,99,97,99,81407,8,81407,9,0,81407,0,0,0,0,0
2017-08-19,99,100,97,97,145566,14,145566,8,0,145566,0,0,0,0,0
2017-08-20,97,98,97,98,375650,23,375650,11,0,375650,0,0,0,0,0
2017-08-21,98,98,97,98,1743693,11,163693,9,2,117825,1625868,45868,-45868,1,1580000
2017-08-22,98,98,97,98,268027,10,268027,9,1,207069,60958,60958,-60958,0,0
2017-08-23,98,98,96,97,364758,17,364758,12,1,360387,4371,4371,-4371,0,0
2017-08-26,96,97,96,97,295397,22,290397,14,1,195397,100000,95000,-95000,1,5000
2017-08-27,96,98,96,98,142341,13,142341,9,0,142341,0,0,0,0,0
2017-08-28,98,99,98,99,175394,17,175394,10,1,162566,12828,12828,-12828,0,0
2017-08-30,98,98,98,98,280827,14,280827,13,0,280827,0,0,0,0,0
2017-09-02,97,100,97,100,167977,7,167977,12,1,147977,20000,20000,-20000,0,0
2017-09-03,100,100,98,98,271930,12,271930,11,1,243930,28000,28000,-28000,0,0
2017-09-04,98,99,97,98,705712,18,705712,14,0,705712,0,0,0,0,0
2017-09-05,98,99,98,99,244651,7,244651,7,1,230984,13667,13667,-13667,0,0
2017-09-06,98,99,97,99,60516,8,60516,14,0,60516,0,0,0,0,0
2017-09-10,98,100,97,98,256253,8,256253,10,1,157113,99140,99140,-99140,0,0
2017-09-11,98,98,97,98,205329,9,205329,13,0,205329,0,0,0,0,0
2017-09-12,98,98,97,97,223282,14,220782,13,2,159905,63377,60877,-60877,1,2500
2017-09-13,97,97,97,97,43295,8,43295,9,0,43295,0,0,0,0,0
2017-09-16,98,100,98,100,1816278,4,55733,20,2,216278,1600000,-160545,160545,1,1760545
2017-09-17,100,101,98,101,649626,8,151547,18,2,248126,401500,-96579,96579,2,498079
2017-09-18,99,99,98,98,531784,22,236044,8,1,231784,300000,4260,-4260,1,295740
2017-09-19,101,102,99,99,359302,18,230474,10,1,353729,5573,-123255,123255,1,128828
2017-09-20,99,101,96,96,1273584,42,1035038,7,2,364311,909273,670727,-670727,2,238546
2017-09-23,97,102,97,100,400756,8,124032,14,1,117102,283654,6930,-6930,1,276724
2017-09-24,99,101,98,99,131595,7,91891,10,0,131595,0,-39704,39704,1,39704
2017-09-25,99,99,98,98,97076,9,89414,4,0,97076,0,-7662,7662,1,7662
2017-09-26,98,99,97,98,158742,6,11212,9,0,158742,0,-147530,147530,1,147530
2017-09-27,98,99,98,98,688067,13,151292,8,1,633446,54621,-482154,482154,1,536775
2017-10-02,98,99,96,99,323206,14,164409,8,0,323206,0,-158797,158797,2,158797
2017-10-03,97,98,97,98,229076,6,21030,8,0,229076,0,-208046,208046,1,208046
2017-10-04,98,99,98,99,569451,6,229698,18,0,569451,0,-339753,339753,1,339753
2017-10-07,98,98,98,98,553473,3,41478,16,0,553473,0,-511995,511995,1,511995
2017-10-08,98,100,98,100,1040603,7,131510,43,0,1040603,0,-909093,909093,1,909093
2017-10-09,98,98,98,98,377008,8,114238,13,0,377008,0,-262770,262770,1,262770
2017-10-10,98,98,97,97,256518,14,256518,5,1,244518,12000,12000,-12000,0,0
2017-10-11,97,98,97,98,70337,6,70337,6,0,70337,0,0,0,0,0
2017-10-14,97,99,97,98,313390,5,32946,10,1,263390,50000,-230444,230444,1,280444
2017-10-15,99,99,98,98,185690,5,69589,9,1,121498,64192,-51909,51909,1,116101
2017-10-16,99,99,98,99,3273518,7,93387,16,1,461082,2812436,-367695,367695,2,3180131
2017-10-17,98,99,98,99,527053,4,42321,14,0,527053,0,-484732,484732,3,484732
2017-10-18,99,102,98,99,626550,5,97398,32,2,520877,105673,-423479,423479,1,529152
2017-10-21,99,103,99,103,884060,6,66479,35,2,819060,65000,-752581,752581,2,817581
2017-10-22,101,105,101,103,247668,7,29597,24,0,247668,0,-218071,218071,1,218071
2017-10-23,101,104,100,100,174461,7,74461,14,0,174461,0,-100000,100000,1,100000
2017-10-24,100,101,99,100,140760,13,140760,8,0,140760,0,0,0,0,0
2017-10-25,100,100,99,99,899519,11,168852,8,2,85342,814177,83510,-83510,1,730667
2017-10-28,98,102,98,99,81615,12,65030,6,0,81615,0,-16585,16585,1,16585
2017-10-29,102,105,101,101,675781,13,125781,31,2,628353,47428,-502572,502572,2,550000
2017-10-30,104,106,99,102,867183,10,71934,39,3,549724,317459,-477790,477790,2,795249
2017-10-31,101,105,101,105,10810,4,10810,6,0,10810,0,0,0,0,0
2017-11-01,101,103,101,103,250258,9,124418,13,0,250258,0,-125840,125840,1,125840
2017-11-04,101,105,101,102,172900,6,72900,20,0,172900,0,-100000,100000,1,100000
2017-11-05,103,103,101,101,239544,14,239544,7,2,190244,49300,49300,-49300,0,0
2017-11-06,101,101,101,101,39993,5,39993,3,0,39993,0,0,0,0,0
2017-11-07,101,101,101,101,36196,4,36196,5,0,36196,0,0,0,0,0
2017-11-08,101,105,101,103,183090,4,20759,17,1,114192,68898,-93433,93433,1,162331
2017-11-11,102,102,101,101,27721,5,27721,2,0,27721,0,0,0,0,0
2017-11-12,101,101,101,101,130450,10,130450,9,1,99750,30700,30700,-30700,0,0
2017-11-13,101,101,100,101,118012,10,118012,9,0,118012,0,0,0,0,0
2017-11-14,101,101,99,99,172247,15,172247,8,0,172247,0,0,0,0,0
2017-11-15,99,101,99,100,182683,16,182683,14,0,182683,0,0,0,0,0
2017-11-18,99,100,99,99,115511,13,115511,9,0,115511,0,0,0,0,0
2017-11-20,99,101,99,100,101591,8,101591,11,0,101591,0,0,0,0,0
2017-11-21,99,100,99,99,419418,10,440106,13,0,440106,0,0,0,0,0
2017-11-22,99,101,99,101,117847,9,117847,9,0,117847,0,0,0,0,0
2017-11-25,101,106,101,104,1418522,8,1418522,51,1,818522,600000,600000,-600000,0,0
2017-11-26,101,101,101,101,438363,23,438363,9,0,438363,0,0,0,0,0
2017-11-28,103,108,101,108,2053969,28,1353969,67,1,1553969,500000,-200000,200000,2,700000
2017-11-29,108,108,105,105,171725,14,171725,16,0,171725,0,0,0,0,0
2017-12-02,102,106,102,106,284106,11,215189,11,0,283406,0,-68217,68217,1,68217
2017-12-03,107,107,103,105,461371,14,161956,21,0,461371,0,-299415,299415,1,299415
2017-12-04,106,106,103,103,104572,14,104572,4,0,104572,0,0,0,0,0
2017-12-05,105,105,103,105,165956,9,165956,10,0,165956,0,0,0,0,0
2017-12-09,103,103,102,102,443128,18,443128,5,1,343128,100000,100000,-100000,0,0
2017-12-10,102,105,102,104,1480471,19,874526,18,1,1469583,10888,-595057,595057,1,605945
2017-12-11,102,109,102,109,1362918,10,384020,52,1,1202918,160000,-818898,818898,1,978898
2017-12-12,108,111,108,111,1053238,8,467673,60,1,753238,300000,-285565,285565,2,585565
2017-12-13,110,112,107,109,1509674,25,602714,47,4,614141,895533,-11427,11427,2,906960
2017-12-16,109,114,108,113,1703428,20,544499,39,2,765816,936912,-221317,221317,2,1158229
2017-12-17,114,116,114,116,2419919,9,1352919,39,2,730986,1688933,621933,-621933,3,1067000
2017-12-18,119,119,113,117,1126350,24,320844,43,0,1126350,0,-805506,805506,2,805506
2017-12-19,117,119,114,119,1048398,8,186084,40,0,1048398,0,-862314,862314,2,862314
2017-12-20,119,120,118,120,962800,3,387400,28,0,481400,0,-94000,94000,1,94000
2017-12-23,120,120,119,120,458208,16,458208,23,0,458208,0,0,0,0,0
2017-12-24,120,120,117,118,937741,11,151974,17,0,937741,0,-785767,785767,1,785767
2017-12-25,117,118,116,116,523380,13,179934,10,0,179934,0,0,0,0,0
2017-12-26,116,116,115,115,430310,10,430310,9,0,430310,0,0,0,0,0
2017-12-27,117,117,115,115,273837,13,273837,14,1,272837,1000,1000,-1000,0,0
2017-12-30,115,115,112,113,408432,13,408432,16,1,308432,100000,100000,-100000,0,0
2017-12-31,111,114,111,114,117938,11,62435,11,0,117938,0,-55503,55503,2,55503
2018-01-01,111,116,111,111,285767,8,162767,8,0,285767,0,-123000,123000,1,123000
2018-01-02,113,113,111,112,33001,8,33001,5,0,33001,0,0,0,0,0
2018-01-03,113,113,111,113,135820,10,67910,5,0,67910,0,0,0,0,0
2018-01-06,111,116,111,113,292219,7,292219,10,0,292219,0,0,0,0,0
2018-01-07,111,114,111,112,70170,11,70170,5,0,70170,0,0,0,0,0
2018-01-08,111,114,111,111,13324,4,13324,4,0,13324,0,0,0,0,0
2018-01-09,111,113,110,110,660872,25,646872,17,0,660872,0,-14000,14000,1,14000
2018-01-10,109,112,109,112,1262940,46,1111940,9,0,1262940,0,-151000,151000,1,151000
2018-01-13,111,117,108,117,525201,22,237878,41,0,525201,0,-287323,287323,1,287323
2018-01-14,113,117,111,114,508677,17,302177,24,0,508677,0,-206500,206500,2,206500
2018-01-15,111,116,111,115,200604,15,160604,19,0,200604,0,-40000,40000,1,40000
2018-01-16,113,115,110,114,438189,27,238189,11,2,220204,217985,17985,-17985,1,200000
2018-01-17,114,114,110,114,422769,22,222769,16,2,306769,116000,-84000,84000,1,200000
2018-01-20,113,114,110,114,643086,21,543086,14,1,363086,280000,180000,-180000,1,100000
2018-01-21,111,113,110,113,144316,8,44316,8,1,112603,31713,-68287,68287,1,100000
2018-01-22,111,113,108,112,515726,26,405726,7,2,53207,462519,352519,-352519,2,110000
2018-01-23,109,112,109,112,302271,10,267271,10,1,118596,183675,148675,-148675,1,35000
2018-01-24,112,112,108,111,1791432,44,1611432,13,3,271007,1520425,1340425,-1340425,2,180000
2018-01-27,110,111,108,110,419320,16,279320,18,0,419320,0,-140000,140000,1,140000
2018-01-28,110,110,106,109,1099776,26,850334,14,1,299776,800000,550558,-550558,1,249442
2018-01-29,110,110,108,110,353478,9,250478,14,0,353478,0,-103000,103000,2,103000
2018-01-30,108,110,108,110,261624,10,212624,17,0,261624,0,-49000,49000,10,49000
2018-01-31,110,111,108,111,830244,6,779244,13,1,120244,710000,659000,-659000,2,51000
2018-02-03,111,111,107,110,187705,16,142705,6,0,187705,0,-45000,45000,1,45000
2018-02-04,107,110,106,110,674603,19,531185,13,1,624603,50000,-93418,93418,2,143418
2018-02-05,109,109,108,109,159610,8,148700,4,2,15414,144196,133286,-133286,1,10910
2018-02-06,108,109,108,108,59500,5,14500,8,2,27092,32408,-12592,12592,1,45000
2018-02-07,108,110,105,109,1967867,49,1259100,22,2,425364,1542503,833736,-833736,1,708767
2018-02-10,110,110,107,109,168250,4,147750,16,0,167750,0,-20000,20000,1,20000
2018-02-12,109,110,107,109,409872,19,361872,22,0,409872,0,-48000,48000,1,48000
2018-02-13,107,109,107,109,168060,7,68060,10,0,168060,0,-100000,100000,2,100000
2018-02-14,109,109,108,109,64340,5,35742,8,0,64340,0,-28598,28598,1,28598
2018-02-17,108,108,106,107,444399,20,244399,13,0,444399,0,-200000,200000,1,200000
2018-02-18,107,107,106,106,185527,14,185527,5,0,185527,0,0,0,0,0
2018-02-19,109,111,106,109,106890,9,53028,14,0,106890,0,-53862,53862,1,53862
2018-02-21,106,110,106,106,549062,16,276311,19,0,549062,0,-272751,272751,2,272751
2018-02-24,106,109,106,106,82126,13,62126,3,1,72948,9178,-10822,10822,1,20000
2018-02-25,108,108,106,108,179387,8,108938,12,0,179387,0,-70449,70449,2,70449
2018-02-26,106,109,105,108,998635,26,749635,14,2,982225,16410,-232590,232590,1,249000
2018-02-27,108,108,106,106,385790,17,239290,10,0,385790,0,-146500,146500,1,146500
2018-02-28,106,108,105,106,542412,26,275412,18,1,532656,9756,-257244,257244,1,267000
2018-03-03,105,105,103,105,701096,21,336096,8,1,120931,580165,215165,-215165,1,365000
2018-03-04,106,107,102,106,503309,27,358904,16,1,409109,94200,-50205,50205,3,144405
2018-03-05,107,107,103,106,211937,8,93937,11,1,205637,6300,-111700,111700,2,118000
2018-03-06,105,106,103,104,166598,5,80598,9,1,45900,120698,34698,-34698,1,86000
2018-03-07,103,105,101,102,512210,22,413210,7,2,159575,352635,253635,-253635,1,99000
2018-03-10,101,106,100,100,1242613,60,1162113,18,2,207687,1034926,954426,-954426,1,80500
2018-03-11,99,99,98,98,3392857,67,2987319,8,3,380200,3012657,2607119,-2607119,1,405538
2018-03-12,95,98,93,95,5308638,70,4300646,16,1,272982,5035656,4027664,-4027664,2,1007992
2018-03-13,94,95,93,93,2212047,69,1708847,14,1,1394191,817856,314656,-314656,2,503200
2018-03-14,93,93,91,91,24441730,123,7380730,17,3,9310042,15131688,-1929312,1929312,5,17061000
2018-03-17,91,92,89,89,5379888,80,3970788,10,1,4245513,1134375,-274725,274725,2,1409100
2018-03-18,91,91,90,90,14083746,66,5410896,9,2,5415877,8667869,-4981,4981,2,8672850
2018-03-19,91,95,90,95,11412684,59,1797647,18,3,2500073,8912611,-702426,702426,3,9615037
2018-03-25,96,96,92,95,815465,27,777465,18,2,575343,240122,202122,-202122,1,38000
2018-03-26,96,96,94,95,1020629,32,658129,17,1,820629,200000,-162500,162500,1,362500
2018-03-27,96,96,94,96,2029312,19,1129312,22,0,2029312,0,-900000,900000,2,900000
2018-03-28,96,99,96,99,5708476,17,4699786,46,1,5672976,35500,-973190,973190,4,1008690
2018-04-03,102,103,101,101,636089,44,427019,44,0,636089,0,-209070,209070,1,209070
2018-04-04,102,103,100,102,1414434,36,830122,35,2,1280377,134057,-450255,450255,2,584312
2018-04-07,102,103,101,103,560931,8,107841,35,2,434003,126928,-326162,326162,1,453090
2018-04-08,102,104,100,101,1307435,21,301576,35,1,1195735,111700,-894159,894159,1,1005859
2018-04-09,103,103,101,102,3393759,15,155160,51,1,2505459,888300,-2350299,2350299,1,3238599
2018-04-10,102,102,97,98,3292206,35,750492,21,2,1507218,1784988,-756726,756726,1,2541714
2018-04-11,100,100,95,95,6236567,31,1536567,20,2,764696,5471871,771871,-771871,3,4700000
2018-04-15,98,100,96,100,1564873,14,75357,30,0,1564873,0,-1489516,1489516,1,1489516
2018-04-16,100,100,98,100,4492891,20,156109,22,1,1492891,3000000,-1336782,1336782,2,4336782
2018-04-17,100,102,99,102,3637874,13,123858,53,1,3537874,100000,-3414016,3414016,1,3514016
2018-04-30,102,102,96,98,743392,11,243392,10,0,743392,0,-500000,500000,1,500000
2018-05-01,95,96,94,95,942479,39,928479,16,0,942479,0,-14000,14000,1,14000
2018-05-05,94,95,93,93,322911,30,322911,13,0,322911,0,0,0,0,0
2018-05-06,92,94,92,92,220026,15,201643,11,0,220026,0,-18383,18383,1,18383
2018-05-07,92,93,92,93,14108,5,14108,3,0,14108,0,0,0,0,0
2018-05-08,94,96,94,96,114930,9,45930,10,1,109930,5000,-64000,64000,1,69000
2018-05-09,93,100,92,93,380209,11,33173,27,0,380209,0,-347036,347036,2,347036
2018-05-12,93,93,92,93,278858,19,252990,7,1,259701,19157,-6711,6711,1,25868
2018-05-13,93,96,93,95,667882,18,667882,19,3,272882,395000,395000,-395000,0,0
2018-05-14,98,98,96,96,543920,27,543920,13,2,293920,250000,250000,-250000,0,0
2018-05-15,95,95,93,94,352281,24,252281,12,2,221192,131089,31089,-31089,1,100000
2018-05-16,94,95,93,95,366165,23,361057,9,2,234565,131600,126492,-126492,1,5108
2018-05-19,92,95,92,94,652696,25,590696,11,2,140584,512112,450112,-450112,1,62000
2018-05-20,93,95,93,93,1132328,24,968328,13,1,525296,607032,443032,-443032,1,164000
2018-05-21,93,94,92,93,838048,23,755048,11,2,775298,62750,-20250,20250,1,83000
2018-05-22,92,94,92,92,515168,27,432455,8,1,125956,389212,306499,-306499,1,82713
2018-05-23,92,92,90,92,933400,49,849366,13,3,338544,594856,510822,-510822,1,84034
2018-05-26,94,94,90,90,726577,50,708577,12,2,626565,100012,82012,-82012,1,18000
2018-05-27,90,92,89,89,636415,35,550872,9,1,533990,102425,16882,-16882,1,85543
2018-05-28,90,90,89,89,369748,27,369748,8,2,120925,248823,248823,-248823,0,0
2018-05-29,89,90,87,87,1106145,59,976835,9,1,848145,258000,128690,-128690,1,129310
2018-05-30,87,92,87,88,1196161,26,831786,18,3,1056946,139215,-225160,225160,2,364375
2018-06-02,89,89,87,87,850730,0,0,0,0,0,0,0,0,0,0
2018-06-03,87,88,86,87,1126661,40,1126661,13,1,268725,857936,857936,-857936,0,0
2018-06-09,86,89,86,89,1228916,26,1098016,18,3,452856,776060,645160,-645160,2,130900
2018-06-10,88,89,87,87,423989,24,367989,18,2,224702,219287,143287,-143287,1,76000
2018-06-11,88,89,87,88,1858817,37,1838817,19,1,1428104,430713,410713,-410713,1,20000
2018-06-12,87,92,87,92,5307756,58,5307756,51,5,709315,4598441,4598441,-4598441,0,0
2018-06-13,94,94,94,94,1736788,31,1736788,32,3,436788,1300000,1300000,-1300000,0,0
2018-06-17,97,97,96,97,6547808,57,3647808,20,6,547808,6000000,3100000,-3100000,2,2900000
2018-06-18,102,102,98,98,10180595,129,8280595,107,3,4117188,6063407,4163407,-4163407,2,1900000
2018-06-19,100,106,99,106,12719291,67,10219291,93,5,3320893,9398398,6898398,-6898398,3,2500000
2018-06-20,111,111,111,111,2024913,11,1124913,6,1,24913,2000000,1100000,-1100000,5,900000
2018-06-23,108,115,105,115,21211922,72,4034137,113,6,9855484,11356438,-5821347,5821347,8,17177785
2018-06-24,118,120,116,120,21823947,93,5272047,119,4,6088667,15711280,-816620,816620,19,16527900
2018-06-25,125,126,125,126,3925189,13,3242128,53,3,1353526,2571663,1888602,-1888602,1,683061
2018-06-26,129,129,119,119,8914263,97,5114263,117,3,4943163,3971100,171100,-171100,5,3800000
2018-06-27,118,120,115,115,6069192,39,2041821,79,1,5529927,539265,-3488106,3488106,3,4027371
2018-06-30,116,119,112,114,1247699,0,0,0,0,0,0,0,0,0,0
2018-07-01,112,112,110,110,3490860,28,990860,40,1,2458317,1032543,-1467457,1467457,3,2500000
2018-07-02,106,113,106,112,515543,8,65543,25,1,465543,50000,-400000,400000,1,450000
2018-07-03,115,115,108,108,1104396,34,954396,16,1,1084396,20000,-130000,130000,1,150000
2018-07-04,108,112,107,110,927511,26,827111,28,0,927111,0,-100000,100000,1,100000
2018-07-07,112,115,108,112,2464751,28,690957,40,1,1964751,500000,-1273794,1273794,2,1773794
2018-07-08,113,113,108,111,490712,13,364506,34,1,356558,134154,7948,-7948,1,126206
2018-07-10,110,110,106,106,726422,29,576422,25,0,726422,0,-150000,150000,2,150000
2018-07-11,105,106,105,105,917718,23,459112,37,0,917718,0,-458606,458606,2,458606
2018-07-14,108,111,104,104,328515,17,187121,22,0,328515,0,-141394,141394,1,141394
2018-07-15,104,104,103,103,1781300,50,931300,20,1,1692900,88400,-761600,761600,2,850000
2018-07-16,102,102,102,102,63980,9,63980,9,0,63980,0,0,0,0,0
2018-07-17,101,102,101,101,145533,8,145533,6,0,145533,0,0,0,0,0
2018-07-18,102,105,100,101,353064,20,353064,12,1,87107,265957,265957,-265957,0,0
2018-07-21,101,103,100,102,1231730,17,1231730,11,1,531730,700000,700000,-700000,0,0
2018-07-22,103,103,99,102,514902,25,514902,8,1,391071,123831,123831,-123831,0,0
2018-07-23,101,102,99,99,572672,0,0,0,0,0,0,0,0,0,0
2018-07-24,98,101,98,99,1892866,16,709110,15,2,428110,1464756,281000,-281000,1,1183756
2018-07-25,99,99,95,99,1379416,43,1379416,24,1,1296148,83268,83268,-83268,0,0
2018-07-28,101,104,100,104,4192203,39,2942203,52,2,1188456,3003747,1753747,-1753747,5,1250000
2018-07-29,109,109,109,109,1426524,8,1426524,31,1,626524,800000,800000,-800000,0,0
2018-07-30,111,111,111,111,1069787,10,1069787,14,4,69787,1000000,1000000,-1000000,0,0
2018-07-31,113,113,113,113,88031,1,88031,15,0,88031,0,0,0,0,0
2018-08-01,114,114,114,114,1586513,19,1486513,29,2,486513,1100000,1000000,-1000000,1,100000
2018-08-04,117,117,116,117,45475134,184,31763534,103,9,8791378,36683756,22972156,-22972156,13,13711600
2018-08-05,123,123,123,123,2907980,25,2507980,34,2,807980,2100000,1700000,-1700000,4,400000
2018-08-06,129,129,126,129,35043093,185,25333093,101,3,20143093,14900000,5190000,-5190000,8,9710000
2018-08-07,123,129,122,122,8952467,129,7252467,100,1,8412467,540000,-1160000,1160000,2,1700000
2018-08-08,119,119,117,117,2518921,45,2418921,29,2,2054282,464639,364639,-364639,1,100000
2018-08-11,114,117,112,114,7794862,80,5894862,102,1,6388408,1406454,-493546,493546,2,1900000
2018-08-12,117,117,112,113,1510804,66,1510804,30,4,790804,720000,720000,-720000,0,0
2018-08-13,115,115,109,109,4887002,106,4887002,29,1,2087002,2800000,2800000,-2800000,0,0
2018-08-14,111,116,111,116,13294010,81,8244010,82,6,6188153,7105857,2055857,-2055857,8,5050000
2018-08-15,119,121,119,121,26852844,161,25352844,152,6,11522844,15330000,13830000,-13830000,3,1500000
2018-08-18,121,127,116,123,9009885,90,7529885,125,3,7574951,1434934,-45066,45066,3,1480000
2018-08-19,124,130,124,130,15106212,132,12106212,156,3,9229282,5876930,2876930,-2876930,3,3000000
2018-08-20,135,135,135,135,3036065,29,3036065,37,1,1036065,2000000,2000000,-2000000,0,0
2018-08-21,142,149,142,149,65251833,310,45481833,211,18,33931230,31320603,11550603,-11550603,8,19770000
2018-08-25,156,156,153,156,29920945,112,11389069,168,5,23459584,6461361,-12070515,12070515,4,18531876
2018-08-26,164,164,161,164,10707813,72,10207813,125,3,7177826,3529987,3029987,-3029987,1,500000
2018-08-27,171,171,155,155,25179888,163,6126629,133,5,4658306,1605482,1468323,-1468323,1,137159
2018-08-28,153,164,152,154,36915447,193,10241223,209,5,26414447,10501000,-16173224,16173224,4,26674224
2018-08-29,155,159,153,153,12575739,231,4812276,118,4,10640415,1935324,-5828139,5828139,3,7763463
2018-09-01,154,154,149,152,17505087,184,2629628,125,5,10243471,7261616,-7613843,7613843,3,14875459
2018-09-02,152,156,144,156,40813169,139,5532498,192,12,17079473,23733696,-11546975,11546975,3,35280671
2018-09-03,157,160,153,153,4538599,162,4038599,83,13,3218713,1319886,819886,-819886,1,500000
2018-09-04,154,163,152,163,69397136,93,4897136,251,13,21795402,47601734,-16898266,16898266,4,64500000
2018-09-09,171,179,171,179,3774932,129,3274932,151,2,3608932,166000,-334000,334000,1,500000
2018-09-10,184,184,181,184,4962756,114,3856453,105,3,3712756,1250000,143697,-143697,2,1106303
2018-09-11,186,186,174,174,4870791,187,4487094,118,1,4770791,100000,-283697,283697,4,383697
2018-09-12,175,182,172,178,9650357,328,9650357,203,3,7281102,2369255,2369255,-2369255,0,0
2018-09-15,181,182,170,172,3558841,195,3457248,154,2,3257321,301520,199927,-199927,2,101593
2018-09-16,172,175,169,174,2301301,106,2301301,107,0,2301301,0,0,0,0,0
2018-09-17,176,177,169,172,3264639,145,3264639,91,3,2243951,1020688,1020688,-1020688,0,0
2018-09-18,174,175,169,173,2578842,80,2578842,109,1,2158855,419987,419987,-419987,0,0
2018-09-22,175,182,173,182,5796628,76,4153027,141,4,2711304,3085324,1441723,-1441723,1,1643601
2018-09-23,189,190,189,190,2376853,91,2376853,118,0,2376853,0,0,0,0,0
2018-09-24,196,196,186,192,2707705,125,2707705,110,0,2707705,0,0,0,0,0
2018-09-25,199,201,198,201,2392863,38,2392863,91,0,2392863,0,0,0,0,0
2018-09-26,209,209,201,209,1753042,52,1753042,68,2,1153042,600000,600000,-600000,0,0
2018-09-29,216,216,216,216,487594,2,487594,44,0,487594,0,0,0,0,0
2018-09-30,217,217,217,217,618947,8,618947,35,0,618947,0,0,0,0,0
2018-10-01,220,220,212,220,8372070,156,8272070,158,1,7372070,1000000,900000,-900000,1,100000
2018-10-02,226,226,208,208,3114098,163,3114098,122,2,2954098,160000,160000,-160000,0,0
2018-10-03,203,213,203,213,3774708,102,3418408,133,2,3404708,370000,13700,-13700,2,356300
2018-10-06,220,220,200,200,2242225,95,2242225,68,0,2242225,0,0,0,0,0
2018-10-07,199,199,199,199,2630669,35,2630669,79,0,2630669,0,0,0,0,0
2018-10-08,190,190,190,190,475400,32,475400,32,0,475400,0,0,0,0,0
2018-10-09,189,208,189,193,3347713,64,2047713,114,1,2347713,1000000,-300000,300000,1,1300000
2018-10-10,194,199,194,194,1231127,44,1231127,54,2,965901,265226,265226,-265226,0,0
2018-10-13,190,190,190,190,2685801,14,285801,40,1,2646801,39000,-2361000,2361000,1,2400000
2018-10-14,181,181,181,181,1948302,10,943350,53,2,1613226,335076,-669876,669876,3,1004952
2018-10-15,177,190,177,184,2625233,84,2238872,74,4,1553483,1071750,685389,-685389,1,386361
2018-10-16,181,188,181,182,1695275,52,1595275,57,2,1149134,546141,446141,-446141,1,100000
2018-10-17,179,186,175,185,2618286,42,1035504,81,2,1993320,624966,-957816,957816,1,1582782
2018-10-20,185,191,185,190,3121111,84,3121111,51,3,1211212,1909899,1909899,-1909899,0,0
2018-10-21,191,192,183,190,1201783,48,1201783,48,0,1201783,0,0,0,0,0
2018-10-22,192,192,181,185,1425326,24,1379372,62,0,1425326,0,-45954,45954,1,45954
2018-10-23,185,186,179,186,1119723,29,655677,35,0,1119723,0,-464046,464046,2,464046
2018-10-24,179,181,176,181,2575788,18,415293,63,0,2575788,0,-2160495,2160495,1,2160495
2018-10-27,176,184,171,179,1119797,30,324018,49,0,1119797,0,-795779,795779,1,795779
2018-10-28,172,179,172,177,3001102,20,1174018,32,2,501102,2500000,672916,-672916,1,1827084
2018-10-29,180,186,176,186,2231518,22,721518,67,1,1395846,835672,-674328,674328,2,1510000
2018-10-31,178,192,178,188,755454,16,505454,39,1,572950,182504,-67496,67496,2,250000
2018-11-03,184,189,183,185,544644,18,544644,18,1,160949,383695,383695,-383695,0,0
2018-11-06,179,192,179,183,93732,13,93732,11,0,93732,0,0,0,0,0
2018-11-10,189,189,181,181,595235,32,595235,49,0,595235,0,0,0,0,0
2018-11-11,181,181,175,176,548712,36,548712,19,1,407441,141271,141271,-141271,0,0
2018-11-12,177,180,175,179,1000604,56,1000604,31,0,1000604,0,0,0,0,0
2018-11-13,178,186,177,177,2225436,80,2175436,86,1,2043612,181824,131824,-131824,1,50000
2018-11-14,178,182,176,176,1521954,44,1521954,33,1,651360,870594,870594,-870594,0,0
2018-11-17,177,177,172,172,522988,30,522988,48,0,522988,0,0,0,0,0
2018-11-18,176,176,170,170,678342,35,678342,36,0,678342,0,0,0,0,0
2018-11-19,168,175,168,170,467603,39,467603,25,1,267603,200000,200000,-200000,0,0
2018-11-20,170,173,170,173,1908098,26,490028,24,1,491793,1416305,-1765,1765,1,1418070
2018-11-21,170,173,170,171,416075,17,130801,26,2,287940,128135,-157139,157139,1,285274
2018-11-24,172,173,164,164,1621059,31,970059,32,1,1336753,284306,-366694,366694,1,651000
2018-11-26,163,163,161,161,1081404,31,363400,50,0,1081404,0,-718004,718004,1,718004
2018-11-27,166,166,158,159,281864,46,255225,28,0,281864,0,-26639,26639,1,26639
2018-11-28,159,162,159,159,329572,33,329046,25,0,329572,0,-526,526,1,526
2018-12-01,162,162,157,157,369009,26,369009,13,0,369009,0,0,0,0,0
2018-12-02,157,165,157,161,567010,28,141946,42,0,567010,0,-425064,425064,2,425064
2018-12-03,164,167,159,161,1747945,33,1346945,28,3,695649,1052296,651296,-651296,1,401000
2018-12-04,161,162,158,160,597287,22,597287,30,1,468344,128943,128943,-128943,0,0
2018-12-05,159,161,159,160,453999,18,453999,17,2,281005,172994,172994,-172994,0,0
2018-12-08,160,161,159,161,264025,29,264025,23,1,248843,15182,15182,-15182,0,0
2018-12-09,159,160,157,157,547517,23,547517,25,1,347517,200000,200000,-200000,0,0
2018-12-10,157,159,157,157,592241,38,592241,23,1,364241,228000,228000,-228000,0,0
2018-12-11,157,159,156,156,617035,28,617035,9,1,122128,494907,494907,-494907,0,0
2018-12-12,155,156,153,154,1141280,45,1141280,22,1,346367,794913,794913,-794913,0,0
2018-12-15,156,156,150,150,1079268,48,1079268,23,1,953487,125781,125781,-125781,0,0
2018-12-16,154,154,150,150,234883,23,234883,17,0,234883,0,0,0,0,0
2018-12-17,150,150,147,147,1551784,43,1251784,22,2,444539,1107245,807245,-807245,1,300000
2018-12-18,145,148,145,147,583549,13,583549,25,1,433549,150000,150000,-150000,0,0
2018-12-19,146,147,144,144,377547,16,377547,18,1,327547,50000,50000,-50000,0,0
2018-12-22,144,146,144,146,454764,22,454764,22,0,454764,0,0,0,0,0
2018-12-23,146,152,146,152,635241,21,635241,22,2,341267,293974,293974,-293974,0,0
2018-12-24,149,153,147,153,688037,22,358037,29,1,532011,156026,-173974,173974,1,330000
2018-12-25,150,152,148,148,652766,26,652766,15,2,463072,189694,189694,-189694,0,0
2018-12-26,148,153,148,149,461767,19,461767,23,1,361767,100000,100000,-100000,0,0
2018-12-29,153,153,149,151,164537,12,164537,14,3,41737,122800,122800,-122800,0,0
2018-12-30,150,152,148,148,614049,23,614049,11,2,366235,247814,247814,-247814,0,0
2018-12-31,149,150,148,148,612406,20,612406,16,0,612406,0,0,0,0,0
2019-01-01,148,151,148,148,732975,25,732975,26,2,576855,156120,156120,-156120,0,0
2019-01-02,148,149,147,147,648987,29,648987,18,3,241233,407754,407754,-407754,0,0
2019-01-05,149,149,146,146,610016,40,610016,20,0,610016,0,0,0,0,0
2019-01-06,146,148,145,148,486824,25,414074,14,2,419384,67440,-5310,5310,1,72750
2019-01-07,146,155,146,154,2601258,34,2291258,53,2,2229432,371826,61826,-61826,1,310000
2019-01-08,156,156,156,156,2638963,20,2638963,40,2,840717,1798246,1798246,-1798246,0,0
2019-01-09,163,163,162,163,4923389,164,4823389,86,3,1985389,2938000,2838000,-2838000,1,100000
2019-01-12,168,168,162,165,1715630,81,1715630,76,0,1715630,0,0,0,0,0
2019-01-13,164,171,159,171,2214510,33,978342,112,1,2209510,5000,-1231168,1231168,1,1236168
2019-01-14,169,171,168,170,1081106,34,851106,39,0,1081106,0,-230000,230000,1,230000
2019-01-15,165,170,165,169,350084,27,350084,33,0,350084,0,0,0,0,0
2019-01-16,171,175,168,171,1407270,19,104442,73,0,1407270,0,-1302828,1302828,2,1302828
2019-01-19,170,174,170,170,413009,17,324682,32,0,413009,0,-88327,88327,1,88327
2019-01-20,170,175,169,169,735087,28,689910,49,0,735087,0,-45177,45177,3,45177
2019-01-21,165,171,164,169,494874,11,474874,29,0,494874,0,-20000,20000,1,20000
2019-01-22,170,178,166,178,1715745,19,1715745,86,1,1665745,50000,50000,-50000,0,0
2019-01-23,177,181,177,181,2691027,45,2691027,98,2,2631381,59646,59646,-59646,0,0
2019-01-26,181,181,171,177,1841252,28,1717532,28,1,1821812,19440,-104280,104280,1,123720
2019-01-27,180,181,175,175,1234111,37,1012362,40,2,1223379,10732,-211017,211017,2,221749
2019-01-28,177,177,170,171,620507,36,539482,34,2,498738,121769,40744,-40744,1,81025
2019-01-29,177,186,169,182,4779737,29,268162,84,2,2278915,2500822,-2010753,2010753,4,4511575
2019-01-30,184,184,174,176,825496,24,441992,34,1,696935,128561,-254943,254943,4,383504
2019-02-02,179,180,173,179,871332,13,411071,31,1,791332,80000,-380261,380261,2,460261
2019-02-03,180,182,173,182,2158633,9,414867,46,1,1647469,511164,-1232602,1232602,4,1743766
2019-02-04,180,186,174,186,1331763,22,164350,73,1,1303107,28656,-1138757,1138757,2,1167413
2019-02-05,178,187,178,182,477657,22,160733,41,0,477657,0,-316924,316924,3,316924
2019-02-06,181,186,178,182,498370,21,247353,20,1,398370,100000,-151017,151017,2,251017
2019-02-10,183,190,182,186,937547,7,124857,68,0,937547,0,-812690,812690,2,812690
2019-02-12,179,189,179,189,322823,17,99924,41,0,322823,0,-222899,222899,2,222899
2019-02-13,187,187,177,179,260238,16,137724,23,0,260238,0,-122514,122514,1,122514
2019-02-16,177,185,177,177,317123,16,256909,29,0,317123,0,-60214,60214,1,60214
2019-02-17,181,182,174,177,728800,31,727800,34,0,728800,0,-1000,1000,1,1000
2019-02-18,173,190,173,185,1389044,11,658440,77,1,1370044,19000,-711604,711604,2,730604
2019-02-19,187,189,181,183,841997,15,397597,39,0,841997,0,-444400,444400,1,444400
2019-02-20,183,189,183,189,1000243,9,59115,38,1,900243,100000,-841128,841128,2,941128
2019-02-23,192,193,189,192,680259,11,370259,42,0,680259,0,-310000,310000,2,310000
2019-02-24,192,195,191,192,1555234,14,311587,67,0,1555234,0,-1243647,1243647,3,1243647
2019-02-25,188,189,183,188,1066008,33,966008,9,0,1066008,0,-100000,100000,1,100000
2019-02-26,182,189,182,183,269600,7,269600,11,0,269600,0,0,0,0,0
2019-02-27,190,190,185,186,492575,9,469525,16,0,492575,0,-23050,23050,1,23050
2019-03-02,190,190,183,184,103334,12,103334,9,0,103334,0,0,0,0,0
2019-03-03,183,186,182,183,449705,24,351471,24,0,449705,0,-98234,98234,1,98234
2019-03-04,184,184,178,178,475746,36,412455,17,0,475746,0,-63291,63291,1,63291
2019-03-05,178,180,177,178,98463,16,98463,7,1,84963,13500,13500,-13500,0,0
2019-03-06,177,180,177,177,268694,28,268694,21,0,268694,0,0,0,0,0
2019-03-09,182,182,176,176,418221,50,418221,16,0,418221,0,0,0,0,0
2019-03-10,175,179,174,174,485413,30,446473,15,1,312445,172968,134028,-134028,1,38940
2019-03-11,175,184,173,179,1077166,42,552726,40,2,576166,501000,-23440,23440,1,524440
2019-03-12,175,183,174,177,207586,18,207586,19,1,201148,6438,6438,-6438,0,0
2019-03-13,175,179,175,177,329926,16,274926,24,0,329926,0,-55000,55000,1,55000
2019-03-16,180,186,180,186,1353203,7,71766,57,1,1148418,204785,-1076652,1076652,3,1281437
2019-03-17,187,191,186,191,1737305,13,88231,54,1,1246346,490959,-1158115,1158115,2,1649074
2019-03-18,191,196,188,196,1524032,17,308510,62,2,949473,574559,-640963,640963,3,1215522
2019-03-19,196,200,193,200,965875,17,96018,55,1,805875,160000,-709857,709857,2,869857
2019-03-25,200,203,198,202,350671,10,30848,37,0,350671,0,-319823,319823,1,319823
2019-03-26,203,204,203,203,846417,15,637417,37,2,601629,244788,35788,-35788,1,209000
2019-03-27,206,206,202,203,345500,15,159961,19,1,312439,33061,-152478,152478,1,185539
2019-03-30,202,208,201,208,799287,22,294818,43,1,603287,196000,-308469,308469,2,504469
2019-03-31,209,210,207,210,4557393,36,2856985,62,4,1800483,2756910,1056502,-1056502,3,1700408
2019-04-06,218,219,210,219,2819807,33,858964,45,2,920195,1899612,-61231,61231,2,1960843
2019-04-07,218,222,217,220,2699905,33,1199905,39,4,1174644,1525261,25261,-25261,1,1500000
2019-04-08,220,225,212,224,2559767,22,527734,48,4,1110067,1449700,-582333,582333,2,2032033
2019-04-09,223,233,223,233,5282799,51,2661323,113,4,3407799,1875000,-746476,746476,4,2621476
2019-04-10,231,237,231,233,780530,50,547126,32,3,619966,160564,-72840,72840,1,233404
2019-04-13,231,236,220,230,2658608,88,1303608,78,3,2229190,429418,-925582,925582,1,1355000
2019-04-14,227,231,217,231,5724304,105,2337114,78,5,3689608,2034696,-1352494,1352494,2,3387190
2019-04-22,224,234,223,234,437148,13,322865,42,0,437148,0,-114283,114283,4,114283
2019-04-23,245,245,245,245,1510073,3,230000,41,2,340073,1170000,-110073,110073,10,1280073
2019-04-24,251,251,248,251,5073905,87,3198905,87,7,3023905,2050000,175000,-175000,15,1875000
2019-04-27,264,264,251,264,1314546,43,886416,100,1,1235110,79436,-348694,348694,1,428130
2019-04-28,270,270,262,270,2202196,60,1954341,83,0,2202196,0,-247855,247855,1,247855
2019-04-29,273,277,266,270,1240708,40,1240708,64,0,1240708,0,0,0,0,0
2019-04-30,270,270,265,269,3623230,41,1623230,79,3,2601230,1022000,-978000,978000,1,2000000
2019-05-01,262,270,258,269,1686032,58,1686032,52,1,1398032,288000,288000,-288000,0,0
2019-05-04,265,278,265,278,791898,11,791898,72,0,791898,0,0,0,0,0
2019-05-05,281,281,281,281,915674,6,915674,51,0,915674,0,0,0,0,0
2019-05-06,286,286,273,286,7879460,93,5931150,129,0,7879460,0,-1948310,1948310,2,1948310
2019-05-07,294,294,271,280,3956033,82,3296033,76,3,2968133,987900,327900,-327900,2,660000
2019-05-08,272,296,272,296,2804679,50,2067651,82,1,2754679,50000,-687028,687028,4,737028
2019-05-11,299,306,290,296,9072280,108,5259308,82,7,2653607,6418673,2605701,-2605701,6,3812972
2019-05-12,298,298,290,290,383696,23,383696,7,2,231969,151727,151727,-151727,0,0
2019-05-13,288,302,288,288,3810499,101,2210499,62,2,3291523,518976,-1081024,1081024,3,1600000
2019-05-14,281,298,276,290,4199870,145,3131848,110,4,3575288,624582,-443440,443440,3,1068022
2019-05-15,290,298,279,291,1645912,50,974412,71,1,1345912,300000,-371500,371500,2,671500
2019-05-18,290,301,289,299,2813347,46,812347,107,3,2413347,400000,-1601000,1601000,2,2001000
2019-05-19,290,306,290,306,3264438,23,553438,63,3,624022,2640416,-70584,70584,2,2711000
2019-05-20,298,302,289,302,1305102,44,461335,49,2,976356,328746,-515021,515021,2,843767
2019-05-21,298,305,287,292,965355,36,545355,56,3,600673,364682,-55318,55318,2,420000
2019-05-22,286,306,286,290,2706325,151,1286325,50,5,1138781,1567544,147544,-147544,3,1420000
2019-05-25,290,301,282,286,1923566,121,1923566,36,3,1304865,618701,618701,-618701,0,0
2019-05-26,294,294,283,290,2098718,78,1348718,51,4,1440660,658058,-91942,91942,2,750000
2019-05-28,282,294,280,283,2559714,166,2509714,57,5,1204716,1354998,1304998,-1304998,1,50000
2019-05-29,289,301,282,301,6856641,77,2529882,137,5,4685264,2171377,-2155382,2155382,3,4326759
2019-06-01,305,307,301,307,2236640,45,1299896,85,2,836640,1400000,463256,-463256,2,936744
2019-06-02,308,319,308,319,631305,12,631305,56,0,631305,0,0,0,0,0
2019-06-03,323,323,323,323,311452,3,211452,32,1,211452,100000,0,0,1,100000
2019-06-08,325,325,325,325,279086,3,279086,23,1,275868,3218,3218,-3218,0,0
2019-06-09,326,326,326,326,460908,4,360908,30,1,260908,200000,100000,-100000,1,100000
2019-06-10,329,329,329,329,105989,2,105989,16,0,105989,0,0,0,0,0
2019-06-11,330,330,330,330,235238,3,235238,17,1,135238,100000,100000,-100000,0,0
2019-06-12,331,331,331,331,1277235,14,1177235,14,2,177235,1100000,1000000,-1000000,1,100000
2019-06-15,339,339,339,339,334827,4,334827,21,2,134827,200000,200000,-200000,0,0
2019-06-16,341,341,341,341,256127,2,150000,14,1,156127,100000,-6127,6127,2,106127
2019-06-17,343,343,343,343,233515,3,233515,32,0,233515,0,0,0,0,0
2019-06-18,345,345,345,345,486419,6,386419,26,1,386419,100000,0,0,1,100000
2019-06-19,360,377,351,364,33189353,533,28686157,220,5,12540803,20648550,16145354,-16145354,8,4503196
2019-06-22,356,356,343,343,7898894,214,7098894,172,1,7798894,100000,-700000,700000,3,800000
2019-06-23,346,363,329,363,7109463,53,5109463,114,3,2198249,4911214,2911214,-2911214,3,2000000
2019-06-24,367,380,352,375,26606281,283,23286517,189,4,16299707,10306574,6986810,-6986810,3,3319764
2019-06-25,381,394,365,394,19149755,244,15784465,244,4,8153538,10996217,7630927,-7630927,6,3365290
2019-06-26,397,405,386,405,59299378,394,47205549,194,6,10344843,48954535,36860706,-36860706,13,12093829
2019-06-30,411,412,405,412,1780823,68,1680823,72,0,1780823,0,-100000,100000,1,100000
2019-07-01,429,429,429,429,1314512,11,1214512,35,1,314512,1000000,900000,-900000,1,100000
2019-07-02,442,442,442,442,2202921,18,2058000,43,2,902921,1300000,1155079,-1155079,2,144921
2019-07-03,464,464,464,464,881517,8,681517,30,2,349896,531621,331621,-331621,2,200000
2019-07-06,474,474,474,474,4209818,37,4009818,55,1,4059818,150000,-50000,50000,1,200000
2019-07-07,497,497,497,497,2520610,13,1220610,55,0,2520610,0,-1300000,1300000,2,1300000
2019-07-08,522,522,497,497,26171655,715,20058894,402,8,23318693,2852962,-3259799,3259799,7,6112761
2019-07-09,497,533,485,532,18558116,522,16331087,525,3,17931087,627029,-1600000,1600000,5,2227029
2019-07-10,531,531,510,531,7839543,357,7239543,212,3,6139543,1700000,1100000,-1100000,2,600000
2019-07-13,534,535,504,513,6552757,257,6301257,266,1,5338899,1213858,962358,-962358,3,251500
2019-07-14,514,521,488,488,6741488,389,5580488,175,1,6255346,486142,-674858,674858,4,1161000
2019-07-15,473,480,467,467,1276840,173,1276840,56,1,1145840,131000,131000,-131000,0,0
2019-07-16,450,450,450,450,1541998,30,41998,8,0,1541998,0,-1500000,1500000,2,1500000
2019-07-17,428,447,428,428,25458238,484,19794723,247,11,16419200,9039038,3375523,-3375523,6,5663515
2019-07-20,416,446,415,425,4234462,223,3315112,174,2,2931243,1303219,383869,-383869,2,919350
2019-07-21,411,445,404,444,16632411,374,9571189,326,1,11974334,4658077,-2403145,2403145,8,7061222
2019-07-22,440,440,440,440,4896774,204,4796774,61,3,3496774,1400000,1300000,-1300000,1,100000
2019-07-23,455,455,422,431,3239464,205,2589464,156,2,2962725,276739,-373261,373261,2,650000
2019-07-24,426,439,417,417,13670953,526,10640953,135,2,13534977,135976,-2894024,2894024,4,3030000
2019-07-27,426,439,408,439,6496591,182,4286991,275,5,5901855,594736,-1614864,1614864,3,2209600
2019-07-28,439,452,430,447,5399416,189,3399416,191,0,5399416,0,-2000000,2000000,1,2000000
2019-07-29,453,459,443,454,2432445,135,2432445,118,0,2432445,0,0,0,0,0
2019-07-30,441,446,426,426,9810784,444,8210784,119,2,9561184,249600,-1350400,1350400,3,1600000
2019-07-31,429,429,406,407,14099228,536,13579637,151,1,12486467,1612761,1093170,-1093170,5,519591
2019-08-03,406,410,390,401,6683453,412,4344801,180,0,6683453,0,-2338652,2338652,3,2338652
2019-08-04,398,416,398,416,2419595,37,1603347,138,2,2005004,414591,-401657,401657,1,816248
2019-08-05,427,427,395,400,10754971,571,9904971,143,3,10285198,469773,-380227,380227,3,850000
2019-08-06,403,414,382,395,7550144,341,6281160,217,1,7549244,900,-1268084,1268084,3,1268984
2019-08-07,393,405,387,396,2984353,227,2718970,148,3,2977073,7280,-258103,258103,5,265383
2019-08-10,404,405,395,397,4921639,268,2834921,168,6,3780754,1140885,-945833,945833,4,2086718
2019-08-11,405,405,396,404,2483878,345,2207580,138,2,2383565,100313,-175985,175985,1,276298
2019-08-13,410,420,405,420,6027531,528,5959222,265,4,5265888,761643,693334,-693334,1,68309
2019-08-14,429,435,418,424,5469284,425,4811846,287,4,3840081,1629203,971765,-971765,4,657438
2019-08-17,424,430,424,426,2875049,205,2613741,214,0,2875049,0,-261308,261308,3,261308
2019-08-18,422,424,416,416,2759294,189,2719294,172,3,2326619,432675,392675,-392675,2,40000
2019-08-19,415,421,408,416,5068214,279,3068214,178,3,2789387,2278827,278827,-278827,3,2000000
2019-08-21,416,428,410,425,3478793,341,3473793,189,3,2306398,1172395,1167395,-1167395,2,5000
2019-08-24,429,441,429,441,9326278,191,9326278,219,7,1914158,7412120,7412120,-7412120,0,0
2019-08-25,462,462,446,462,13541452,489,11837452,471,1,13091452,450000,-1254000,1254000,6,1704000
2019-08-26,482,482,482,482,1125225,9,1125225,103,1,823134,302091,302091,-302091,0,0
2019-08-27,496,496,482,496,23993608,383,14806558,587,7,20028608,3965000,-5222050,5222050,11,9187050
2019-08-28,496,520,472,520,8107704,318,7790045,539,2,6807704,1300000,982341,-982341,4,317659
2019-08-31,535,535,497,512,12546048,515,11829548,552,6,11241048,1305000,588500,-588500,4,716500
2019-09-01,512,512,498,502,8069706,413,4582185,445,7,7147848,921858,-2565663,2565663,7,3487521
2019-09-02,497,500,477,477,10888711,416,5748656,299,5,9226660,1662051,-3478004,3478004,9,5140055
2019-09-03,464,503,457,497,8245046,297,5250727,351,3,7810143,434903,-2559416,2559416,5,2994319
2019-09-04,502,502,484,502,4033674,136,3181565,223,0,4033674,0,-852109,852109,6,852109
2019-09-07,513,513,488,501,4692498,363,3850248,164,3,3128798,1563700,721450,-721450,4,842250
2019-09-08,506,506,488,503,3592875,201,3092875,168,0,3592875,0,-500000,500000,1,500000
2019-09-11,508,508,485,487,4586953,393,4386953,199,0,4586953,0,-200000,200000,2,200000
2019-09-14,490,500,468,494,7245206,355,6290297,325,2,5745206,1500000,545091,-545091,1,954909
2019-09-15,488,506,481,506,5388551,146,5246797,310,2,5088551,300000,158246,-158246,2,141754
2019-09-16,521,525,509,523,11315103,408,9053043,400,4,9192567,2122536,-139524,139524,4,2262060
2019-09-17,509,546,509,538,8621877,562,6822695,340,3,5412936,3208941,1409759,-1409759,7,1799182
2019-09-18,539,548,506,531,6842401,570,5663725,347,3,6552127,290274,-888402,888402,5,1178676
2019-09-21,534,545,513,526,3622193,427,3522193,168,0,3622193,0,-100000,100000,1,100000
2019-09-22,517,552,517,534,5148633,331,3041259,350,4,4803995,344638,-1762736,1762736,3,2107374
2019-09-23,551,564,533,555,7993540,287,3821794,386,1,7796290,197250,-3974496,3974496,5,4171746
2019-09-24,563,572,560,572,8469620,477,6979224,489,4,7948720,496900,-969496,969496,3,1466396
2019-09-25,596,597,580,597,3532781,232,2357781,328,1,3032781,500000,-675000,675000,2,1175000
2019-09-28,624,624,598,618,4078225,454,3797250,253,3,3527226,550999,270024,-270024,3,280975
2019-09-29,623,623,588,591,7323491,583,5800491,350,5,5803424,1520067,-2933,2933,4,1523000
2019-09-30,583,608,583,587,3876866,335,2904401,280,3,3165127,704239,-260726,260726,5,964965
2019-10-01,582,592,562,569,10094814,418,5064814,354,3,7174814,2920000,-2110000,2110000,5,5030000
2019-10-02,563,592,563,583,3556022,188,1462613,203,2,3056022,500000,-1593409,1593409,4,2093409
2019-10-05,586,599,579,579,3480413,193,1280413,206,2,3003746,476667,-1723333,1723333,2,2200000
2019-10-06,586,586,563,573,3190335,143,1470334,191,5,2021835,1168500,-551501,551501,3,1720001
2019-10-07,565,578,546,551,3165106,205,2012177,231,0,3165106,0,-1152929,1152929,2,1152929
2019-10-08,531,553,526,528,8167506,204,4390037,189,1,8132669,34837,-3742632,3742632,3,3777469
2019-10-09,504,537,504,536,2164380,102,1134380,207,2,1586458,577922,-452078,452078,3,1030000
2019-10-12,541,543,526,541,2255937,144,1465937,139,3,1164431,1091506,301506,-301506,5,790000
2019-10-13,527,546,507,507,2943381,170,2443381,134,5,812365,2131016,1631016,-1631016,1,500000
2019-10-14,502,521,490,492,1593957,139,1091594,102,2,1200784,393173,-109190,109190,4,502363
2019-10-15,480,497,473,473,3450295,119,920295,151,1,3449495,800,-2529200,2529200,3,2530000
2019-10-16,455,495,455,472,1341310,121,909610,136,1,1241310,100000,-331700,331700,4,431700
2019-10-20,477,504,460,460,2280293,93,1032832,168,1,2202516,77777,-1169684,1169684,3,1247461
2019-10-21,488,492,456,492,1894843,167,1894843,160,0,1894843,0,0,0,0,0
2019-10-22,497,504,484,497,1504671,201,1504671,107,1,1194671,310000,310000,-310000,0,0
2019-10-23,513,513,492,498,685487,98,685487,94,1,655487,30000,30000,-30000,0,0
2019-10-26,509,509,473,488,605613,134,605613,74,0,605613,0,0,0,0,0
2019-10-28,494,513,477,512,901467,117,791467,108,0,901467,0,-110000,110000,2,110000
2019-10-30,517,521,509,520,690100,119,685100,109,1,682330,7770,2770,-2770,1,5000
2019-11-02,521,521,500,511,475622,133,405622,91,0,475622,0,-70000,70000,2,70000
2019-11-03,501,512,484,498,657731,129,637731,91,0,657731,0,-20000,20000,1,20000
2019-11-04,509,517,486,496,432431,82,432431,67,0,432431,0,0,0,0,0
2019-11-05,509,509,480,492,567577,72,557577,75,2,497327,70250,60250,-60250,1,10000
2019-11-09,493,511,486,498,847268,74,721106,110,0,847268,0,-126162,126162,1,126162
2019-11-10,498,504,485,488,1371694,89,817975,81,1,1321694,50000,-503719,503719,1,553719
2019-11-11,476,513,476,491,1068323,86,315806,115,0,1068323,0,-752517,752517,3,752517
2019-11-12,495,510,488,509,1398801,60,152520,120,1,1398781,20,-1246261,1246261,1,1246281
2019-11-13,508,509,492,492,429247,80,301764,52,0,429247,0,-127483,127483,2,127483
2019-11-16,482,501,482,488,463150,91,435150,76,0,463150,0,-28000,28000,1,28000
2019-11-17,483,499,475,478,1336171,80,814171,84,0,1336171,0,-522000,522000,2,522000
2019-11-18,472,497,469,478,734843,58,734843,58,2,555051,179792,179792,-179792,0,0
2019-11-19,488,490,478,490,1001343,104,710742,70,6,621897,379446,88845,-88845,2,290601
2019-11-20,492,495,472,478,1946203,139,1556055,54,8,748945,1197258,807110,-807110,3,390148
2019-11-23,476,492,476,489,2059814,104,778423,109,2,1059814,1000000,-281391,281391,5,1281391
2019-11-24,491,498,484,491,1027928,87,552297,93,0,1027928,0,-475631,475631,2,475631
2019-11-25,488,512,487,512,8961621,305,8157045,226,5,4929380,4032241,3227665,-3227665,3,804576
2019-11-26,521,525,516,525,4229295,247,3371364,268,2,3804295,425000,-432931,432931,3,857931
2019-11-27,530,548,524,538,5643658,331,3890270,326,3,3771670,1871988,118600,-118600,6,1753388
2019-11-30,545,554,522,546,1579819,187,1262919,253,2,1547059,32760,-284140,284140,3,316900
2019-12-01,546,546,516,538,2493317,182,1684742,221,1,2443317,50000,-758575,758575,5,808575
2019-12-02,545,545,521,530,2241742,144,1459359,148,1,2101742,140000,-642383,642383,3,782383
2019-12-03,536,547,526,534,2131979,147,1552829,193,1,1921108,210871,-368279,368279,3,579150
2019-12-04,538,550,530,549,1792134,168,1593277,205,1,1742134,50000,-148857,148857,3,198857
2019-12-07,550,563,538,563,2125616,189,2003176,229,0,2125616,0,-122440,122440,1,122440
2019-12-08,548,578,548,573,1778063,139,1035138,189,0,1778063,0,-742925,742925,2,742925
2019-12-09,579,584,563,570,1264632,169,1216841,167,0,1264632,0,-47791,47791,2,47791
2019-12-10,573,585,563,569,2072176,125,2007015,209,1,2042176,30000,-35161,35161,1,65161
2019-12-11,563,607,555,607,2529965,105,2295013,291,2,2423088,106877,-128075,128075,3,234952
2019-12-14,618,618,618,618,386748,8,386748,115,0,386748,0,0,0,0,0
2019-12-15,627,627,627,627,1223400,17,1223400,111,2,992345,231055,231055,-231055,0,0
2019-12-16,654,654,650,654,49873898,918,41196135,496,4,35815009,14058889,5381126,-5381126,11,8677763
2019-12-17,654,672,636,657,7399325,555,4981325,467,0,7399325,0,-2418000,2418000,9,2418000
2019-12-18,643,675,636,662,6138120,276,4574245,374,1,6113120,25000,-1538875,1538875,6,1563875
2019-12-21,649,662,629,645,6810568,262,2191427,223,3,5689411,1121157,-3497984,3497984,7,4619141
2019-12-22,645,678,623,669,9289945,343,7729945,458,3,7124572,2165373,605373,-605373,3,1560000
2019-12-23,671,679,639,644,6786797,266,3341958,228,2,5359486,1427311,-2017528,2017528,6,3444839
2019-12-24,644,658,631,637,3053321,223,2321039,154,1,2269208,784113,51831,-51831,1,732282
2019-12-25,654,674,635,670,3813473,365,3719156,281,0,3813473,0,-94317,94317,2,94317
2019-12-28,662,686,662,685,3410959,319,3186676,270,0,3410959,0,-224283,224283,2,224283
2019-12-29,691,693,672,672,4097822,245,2955385,197,1,3639564,458258,-684179,684179,4,1142437
2019-12-30,672,704,672,704,4619844,263,2981668,313,2,4420049,191742,-1438381,1438381,4,1630123
2019-12-31,704,704,675,691,5003707,178,3008392,224,2,4913570,90137,-1905178,1905178,6,1995315
2020-01-01,695,695,681,687,3528692,181,1961065,191,2,3005327,523365,-1044262,1044262,4,1567627
2020-01-04,653,653,653,653,3313589,60,283589,15,0,3313589,0,-3030000,3030000,3,3030000
2020-01-05,620,649,620,621,10100161,246,4676344,304,4,9633990,466171,-4957646,4957646,6,5423817
2020-01-07,612,621,591,591,12498898,135,1854898,111,5,11400898,1098000,-9546000,9546000,4,10644000
2020-01-08,580,580,580,580,1667408,39,617408,20,0,1667408,0,-1050000,1050000,2,1050000
2020-01-11,592,592,592,592,418126,2,418126,27,3,202603,215523,215523,-215523,0,0
2020-01-14,613,613,613,613,730524,3,730524,27,1,130504,600020,600020,-600020,0,0
2020-01-15,644,644,644,644,776198,10,776198,41,2,222729,553469,553469,-553469,0,0
2020-01-18,662,662,662,662,1312508,16,1212508,47,4,404683,907825,807825,-807825,1,100000
2020-01-19,695,695,695,695,1373490,14,1273490,66,5,585634,787856,687856,-687856,1,100000
2020-01-20,730,730,730,730,1460257,17,1460257,82,4,478829,981428,981428,-981428,0,0
2020-01-21,766,766,732,764,23632245,783,17811886,519,8,18875105,4757140,-1063219,1063219,11,5820359
2020-01-22,745,800,737,800,17648436,410,12754017,476,5,8112160,9536276,4641857,-4641857,8,4894419
2020-01-25,824,827,802,827,3329659,192,2337295,221,5,3231936,97723,-894641,894641,2,992364
2020-01-26,861,865,825,864,12761070,601,5516239,432,8,10952023,1809047,-5435784,5435784,4,7244831
2020-01-27,869,898,828,881,5070040,342,3600040,308,4,4031955,1038085,-431915,431915,2,1470000
2020-01-28,910,931,845,901,3793168,390,2133168,329,3,3281252,511916,-1148084,1148084,2,1660000
2020-02-01,874,926,863,863,7381424,401,2600644,371,2,7081424,300000,-4480780,4480780,2,4780780
2020-02-02,831,894,831,836,5704868,277,1985649,334,2,5304868,400000,-3319219,3319219,3,3719219
2020-02-03,840,914,840,914,10535761,266,7385761,442,4,6013866,4521895,1371895,-1371895,3,3150000
2020-02-04,949,949,949,949,511362,2,511362,35,0,511362,0,0,0,0,0
2020-02-08,976,1024,927,935,7807290,341,5909260,304,3,4099408,3707882,1809852,-1809852,5,1898030
2020-02-09,915,997,915,996,7310079,225,2826030,413,6,4594477,2715602,-1768447,1768447,4,4484049
2020-02-10,1018,1026,978,1014,10929850,284,1403311,379,3,7029850,3900000,-5626539,5626539,2,9526539
2020-02-12,993,1026,978,1026,3954218,243,1403445,287,3,2646410,1307808,-1242965,1242965,3,2550773
2020-02-15,962,1026,962,988,3548085,213,1879448,251,4,2605850,942235,-726402,726402,2,1668637
2020-02-16,952,1030,944,1028,6799911,219,2164758,382,3,6053351,746560,-3888593,3888593,4,4635153
2020-02-17,1037,1037,981,993,4414557,366,3814557,280,4,2984455,1430102,830102,-830102,2,600000
2020-02-18,1025,1035,974,990,9559549,242,2026629,216,4,2779319,6780230,-752690,752690,2,7532920
2020-02-19,1018,1026,967,983,13846158,385,3964386,295,6,3431327,10414831,533059,-533059,3,9881772
2020-02-22,956,1039,956,1025,4935338,205,992910,327,5,2965406,1969932,-1972496,1972496,5,3942428
2020-02-23,1043,1061,1025,1061,6280782,310,4180782,289,6,2509350,3771432,1671432,-1671432,2,2100000
2020-02-24,1071,1076,1002,1026,2192910,465,2116309,193,0,2192910,0,-76601,76601,1,76601
2020-02-25,1035,1066,1018,1042,5384981,403,3364981,215,6,2715900,2669081,649081,-649081,1,2020000
2020-02-26,1068,1068,993,1001,3238471,440,3168471,201,1,3121979,116492,46492,-46492,1,70000
2020-02-29,963,993,963,964,1570832,258,1540832,221,0,1570832,0,-30000,30000,1,30000
2020-03-01,931,1021,931,988,1939632,226,1939632,192,1,1639632,300000,300000,-300000,0,0
2020-03-02,993,1014,974,1004,2065471,270,2050471,229,1,2039696,25775,10775,-10775,1,15000
2020-03-03,1018,1041,1018,1041,7092303,222,6691223,350,1,5104294,1988009,1586929,-1586929,1,401080
2020-03-04,1083,1083,1043,1068,1854816,236,1783323,281,2,1649816,205000,133507,-133507,1,71493
2020-03-07,1076,1076,997,1001,2602212,238,2600212,253,2,2589711,12501,10501,-10501,1,2000
2020-03-09,985,993,973,973,788551,145,469051,22,1,308551,480000,160500,-160500,1,319500
2020-03-10,963,1010,963,963,2333140,195,2250669,162,2,2209191,123949,41478,-41478,2,82471
2020-03-11,963,998,939,959,1470248,225,1383314,174,2,1247949,222299,135365,-135365,2,86934
2020-03-14,931,993,928,928,1987991,132,987991,32,0,1987991,0,-1000000,1000000,1,1000000
2020-03-15,907,944,907,907,12156596,186,3745146,122,4,5294779,6861817,-1549633,1549633,4,8411450
2020-03-17,943,943,868,899,1694702,271,1694702,143,4,965740,728962,728962,-728962,0,0
2020-03-18,875,943,875,902,8566607,449,5016507,134,3,1098689,7467918,3917818,-3917818,3,3550100
2020-03-24,876,939,876,902,2695758,307,2695758,100,3,707939,1987819,1987819,-1987819,0,0
2020-03-25,923,948,902,948,9094236,303,4066152,194,4,1220185,7874671,2845967,-2845967,1,5028704
2020-03-28,994,994,994,994,2076560,162,2076560,56,2,366021,1710539,1710539,-1710539,0,0
2020-03-29,1017,1017,1017,1017,1136372,105,890796,145,2,1044372,92000,-153576,153576,1,245576
2020-03-30,1030,1030,1030,1030,587931,3,187931,133,1,537931,50000,-350000,350000,1,400000
2020-04-04,1037,1037,1037,1037,403064,7,249536,60,1,194683,208381,54853,-54853,1,153528
2020-04-05,1042,1042,1042,1042,663877,18,663877,96,1,263877,400000,400000,-400000,0,0
2020-04-06,1050,1050,1050,1050,514575,18,514575,83,0,514575,0,0,0,0,0
2020-04-07,1057,1057,1057,1057,766564,14,666564,119,0,766564,0,-100000,100000,1,100000
2020-04-08,1067,1067,1067,1067,1331633,24,1231633,86,1,352983,978650,878650,-878650,1,100000
2020-04-11,1084,1084,1084,1084,1042642,16,942642,80,2,194974,847668,747668,-747668,1,100000
2020-04-12,1098,1098,1098,1098,141989,2,141989,61,1,134219,7770,7770,-7770,0,0
2020-04-13,1099,1099,1099,1099,390534,7,370235,79,0,390534,0,-20299,20299,1,20299
2020-04-14,1105,1105,1105,1105,377555,8,362555,205,0,362555,0,0,0,0,0
2020-04-15,1110,1110,1110,1110,675052,15,575052,165,0,675052,0,-100000,100000,1,100000
2020-04-22,1625,1625,1119,1119,558031,88,373778,110,2,273728,100050,100050,-100050,0,0
2020-04-25,1175,1175,1175,1175,1286515,15,1286515,79,1,286515,1000000,1000000,-1000000,0,0
2020-04-26,1195,1195,1195,1195,2633228,44,2633228,68,4,518587,2114641,2114641,-2114641,0,0
2020-04-27,1236,1236,1236,1236,2313598,23,1393598,61,3,263598,2050000,1130000,-1130000,9,920000
2020-04-28,1274,1274,1274,1274,1955948,25,1681494,49,2,155948,1800000,1525546,-1525546,3,274454
2020-04-29,1306,1306,1306,1306,2101273,19,1601273,53,2,301273,1800000,1300000,-1300000,5,500000
2020-05-02,1342,1342,1342,1342,1741649,26,1141649,46,3,91649,1650000,1050000,-1050000,6,600000
2020-05-03,1377,1377,1377,1377,2019415,25,1619415,70,2,219415,1800000,1400000,-1400000,4,400000
2020-05-04,1419,1419,1419,1419,2953128,45,2453128,61,3,153128,2800000,2300000,-2300000,5,500000
2020-05-05,1482,1482,1482,1482,1856002,25,1556002,81,3,706002,1150000,850000,-850000,3,300000
2020-05-06,1523,1523,1523,1523,1378510,22,1278510,74,3,427307,951203,851203,-851203,1,100000
2020-05-09,1554,1554,1554,1554,714590,11,671559,50,1,664590,50000,6969,-6969,1,43031
2020-05-10,1574,1574,1574,1574,1016075,12,716075,55,2,766075,250000,-50000,50000,3,300000
2020-05-11,1601,1601,1601,1601,394076,5,94076,67,1,364076,30000,-270000,270000,3,300000
2020-05-12,1612,1612,1612,1612,1002472,14,769184,127,0,1002472,0,-233288,233288,3,233288
2020-05-13,1640,1640,1640,1640,670986,7,575430,81,1,640986,30000,-65556,65556,1,95556
2020-05-16,1659,1659,1659,1659,1132753,18,1032753,97,2,897247,235506,135506,-135506,1,100000
2020-05-17,1693,1693,1693,1693,955929,19,955929,90,0,955929,0,0,0,0,0
2020-05-18,1722,1722,1722,1722,1301183,25,1193201,53,3,225489,1067712,967712,-967712,1,100000
2020-05-19,1762,1762,1762,1762,285707,2,285707,70,0,285707,0,0,0,0,0
2020-05-20,1771,1771,1771,1771,641293,16,641293,84,0,641293,0,0,0,0,0
2020-05-23,1791,1791,1791,1791,1082646,17,982646,68,0,1082646,0,-100000,100000,1,100000
2020-05-26,1826,1826,1826,1826,2147358,29,1447358,139,2,1847358,300000,-400000,400000,7,700000
2020-05-27,1896,1896,1896,1896,693130,9,562786,112,0,693130,0,-130344,130344,2,130344
2020-05-30,1919,1919,1919,1919,301167,4,301167,53,0,301167,0,0,0,0,0
2020-05-31,1929,1929,1929,1929,417233,8,317233,61,0,417233,0,-100000,100000,1,100000
2020-06-01,1944,1944,1944,1944,357036,11,357036,52,1,355036,2000,2000,-2000,0,0
2020-06-02,1956,1956,1956,1956,596658,8,468401,66,2,296658,300000,171743,-171743,2,128257
2020-06-06,1977,1977,1977,1977,868196,12,668196,55,2,458536,409660,209660,-209660,2,200000
2020-06-07,2007,2007,2007,2007,557249,14,401035,52,0,557249,0,-156214,156214,2,156214
2020-06-08,2025,2027,2025,2027,235886,8,235886,57,0,235886,0,0,0,0,0
2020-06-09,2036,2036,2036,2036,398249,11,398249,52,0,398249,0,0,0,0,0
2020-06-10,2050,2050,2050,2050,364153,7,364153,67,0,364153,0,0,0,0,0
2020-06-13,2063,2063,2063,2063,649643,10,449943,65,1,549643,100000,-99700,99700,2,199700
2020-06-14,2087,2087,2087,2087,657071,13,657071,66,1,557071,100000,100000,-100000,0,0
2020-06-15,2111,2111,2111,2111,540988,8,540988,54,2,441243,99745,99745,-99745,0,0
2020-06-16,2132,2132,2132,2132,369036,7,369036,67,0,369036,0,0,0,0,0
2020-06-20,2146,2146,2146,2146,711912,15,711912,71,0,711912,0,0,0,0,0
2020-06-21,2173,2173,2173,2173,525517,9,525517,72,0,525517,0,0,0,0,0
2020-06-22,2194,2194,2194,2194,485393,9,485393,55,0,485393,0,0,0,0,0
2020-06-23,2212,2212,2212,2212,1086902,21,1086902,53,0,1086902,0,0,0,0,0
2020-06-24,2255,2255,2255,2255,525841,11,424841,60,0,525841,0,-101000,101000,2,101000
2020-06-27,2276,2276,2276,2276,631765,10,552713,46,0,631765,0,-79052,79052,1,79052
2020-06-28,2302,2302,2302,2302,193368,3,193368,52,0,193368,0,0,0,0,0
2020-06-29,2310,2310,2310,2310,155188,5,155188,34,0,155188,0,0,0,0,0
2020-06-30,2316,2316,2316,2316,316575,4,316575,72,0,316575,0,0,0,0,0
2020-07-01,2330,2330,2330,2330,1868268,32,1768268,79,1,468268,1400000,1300000,-1300000,1,100000
2020-07-04,2408,2408,2408,2408,1365158,28,1365158,73,3,725158,640000,640000,-640000,0,0
2020-07-05,2466,2466,2466,2466,1926401,43,1826401,38,2,111009,1815392,1715392,-1715392,1,100000
2020-07-06,2550,2550,2550,2550,2250336,55,2250336,55,2,250336,2000000,2000000,-2000000,0,0
2020-07-07,2652,2652,2652,2652,1978217,46,1978217,45,2,278217,1700000,1700000,-1700000,0,0
2020-07-08,2746,2746,2746,2746,313868,9,313868,63,0,313868,0,0,0,0,0
2020-07-11,2762,2762,2762,2762,426783,8,426783,57,0,426783,0,0,0,0,0
2020-07-12,2782,2782,2782,2782,363664,8,363664,52,0,363664,0,0,0,0,0
2020-07-13,2800,2800,2800,2800,375840,11,375840,64,0,375840,0,0,0,0,0
2020-07-14,2819,2819,2819,2819,436700,14,436700,51,0,436700,0,0,0,0,0
2020-07-15,2840,2840,2840,2840,167116,3,167116,49,0,167116,0,0,0,0,0
2020-07-18,2848,2848,2848,2848,745410,17,745410,89,0,745410,0,0,0,0,0
2020-07-19,2886,2886,2886,2886,659317,20,659317,67,0,659317,0,0,0,0,0
2020-07-20,2920,2920,2920,2920,341746,6,241746,55,1,246190,95556,-4444,4444,1,100000
2020-07-21,2938,2938,2938,2938,371393,11,371393,71,0,371393,0,0,0,0,0
2020-07-22,2958,2958,2958,2958,217608,3,217608,65,0,217608,0,0,0,0,0
2020-07-25,2969,2969,2969,2969,51122724,568,46621924,49,3,415662,50707062,46206262,-46206262,28,4500800
2020-07-26,3117,3117,3117,3117,187385,5,187385,41,1,186385,1000,1000,-1000,0,0
2020-07-27,3127,3127,3127,3127,387765,9,384499,55,1,218624,165875,165875,-165875,0,0
2020-07-28,3149,3149,3149,3149,152551,6,152551,67,0,152551,0,0,0,0,0
2020-07-29,3158,3158,3158,3158,225457,4,225457,70,0,225457,0,0,0,0,0
2020-08-01,3171,3171,3171,3171,358908,6,333908,81,1,358809,99,-24901,24901,1,25000
2020-08-02,3191,3191,3191,3191,727655,13,727655,69,0,727655,0,0,0,0,0
2020-08-03,3232,3232,3232,3232,215694,5,215694,55,0,215694,0,0,0,0,0
2020-08-04,3245,3245,3245,3245,306970,7,306970,66,0,306970,0,0,0,0,0
2020-08-05,3263,3263,3263,3263,523811,2,283317,75,0,383317,0,-100000,100000,1,100000
2020-08-09,3285,3285,3285,3285,465616,15,465616,73,0,465616,0,0,0,0,0
2020-08-10,3313,3313,3313,3313,397549,10,297549,69,0,397549,0,-100000,100000,1,100000
2020-08-11,3337,3337,3337,3337,530042,11,430042,65,0,530042,0,-100000,100000,1,100000
2020-08-12,3370,3370,3370,3370,299126,4,299126,80,0,299126,0,0,0,0,0
2020-08-15,3388,3388,3388,3388,687672,10,594716,79,1,587672,100000,7044,-7044,1,92956
2020-08-16,3432,3432,3432,3432,578569,12,578569,93,1,478569,100000,100000,-100000,0,0
2020-08-17,3469,3469,3469,3469,785711,16,785711,88,1,585711,200000,200000,-200000,0,0
2020-08-18,3521,3521,3521,3521,1469984,31,1369984,81,0,1469984,0,-100000,100000,1,100000
2020-08-19,3619,3619,3619,3619,3051274,60,2951274,104,1,2751274,300000,200000,-200000,1,100000
2020-08-22,3799,3799,3799,3799,2009932,45,2009932,133,0,2009932,0,0,0,0,0
2020-08-23,3961,3961,3584,3613,193726837,14555,140923908,4166,37,177264997,16059904,-36341089,36341089,52,52400993
2020-08-24,3753,3838,3532,3532,28542058,3956,21958043,1487,4,28300845,241213,-6342802,6342802,11,6584015
2020-08-25,3666,3792,3540,3792,26283436,2371,21412890,1325,10,20608225,5675211,804665,-804665,8,4870546
2020-08-26,3944,3944,3944,3944,2696469,50,2496469,225,6,1546469,1150000,950000,-950000,2,200000
2020-08-31,4141,4141,3754,4141,51822915,7834,44708325,2631,17,48067519,3755396,-3359194,3359194,19,7114590
2020-09-01,4170,4179,3891,3923,18536986,5426,14372574,2142,5,17801038,735948,-3428464,3428464,12,4164412
2020-09-02,3846,3966,3766,3766,12183807,1721,5712571,1389,1,11463448,720359,-5750877,5750877,7,6471236
2020-09-05,3963,3969,3710,3969,11452974,2999,10286689,1806,10,9484106,1968868,802583,-802583,9,1166285
2020-09-06,4113,4113,3795,3880,21184503,5401,20084900,2088,7,18756246,2428257,1328654,-1328654,8,1099603
2020-09-07,3823,3838,3821,3821,2579136,637,1779136,139,0,2579136,0,-800000,800000,4,800000
2020-09-08,3631,3631,3631,3631,170832,165,170832,6,1,70832,100000,100000,-100000,0,0
2020-09-09,3617,3744,3617,3617,17531048,2375,15030919,1762,6,15720095,1810953,-689176,689176,4,2500129
2020-09-12,3813,3813,3451,3565,17594352,3524,14872668,2743,3,16832438,761914,-1959770,1959770,12,2721684
2020-09-13,3475,3497,3424,3437,16476591,1206,6191871,2282,5,14707383,1769208,-8515512,8515512,17,10284720
2020-09-14,3266,3427,3257,3309,13120754,2312,9596754,2603,7,12804883,315871,-3208129,3208129,12,3524000
2020-09-15,3480,3480,3480,3480,5284770,858,5279770,658,3,3084770,2200000,2195000,-2195000,1,5000
2020-09-16,3654,3654,3497,3581,10539288,2524,9044760,1454,10,7611513,2927775,1433247,-1433247,4,1494528
2020-09-19,3582,3582,3445,3445,5024795,1086,3164795,1161,1,4991507,33288,-1826712,1826712,9,1860000
2020-09-20,3299,3326,3299,3299,1596445,395,996445,484,0,1596445,0,-600000,600000,2,600000
2020-09-21,3188,3188,3188,3188,488814,173,288814,48,0,488814,0,-200000,200000,2,200000
2020-09-22,3155,3239,3155,3232,13075161,779,6143418,1507,1,10804844,2270317,-4661426,4661426,8,6931743
2020-09-23,3097,3231,2999,3069,7748569,1238,4277088,1387,1,7745399,3170,-3468311,3468311,6,3471481
2020-09-26,2943,3028,2917,2917,4638417,633,2240418,604,2,3438417,1200000,-1197999,1197999,8,2397999
2020-09-27,2792,2792,2792,2792,1310116,156,1288116,185,0,1310116,0,-22000,22000,1,22000
2020-09-28,2727,2727,2727,2727,1196635,57,196635,16,1,844171,352464,-647536,647536,1,1000000
2020-09-29,2669,2669,2669,2669,1025775,171,425775,25,1,925775,100000,-500000,500000,2,600000
2020-09-30,2619,2814,2619,2759,12068607,816,7408727,1685,11,9621017,2447590,-2212290,2212290,10,4659880
2020-10-03,2686,2769,2643,2769,2651066,410,2499010,503,3,2253644,397422,245366,-245366,6,152056
2020-10-04,2876,2876,2610,2657,7972750,1151,6121183,611,2,6682750,1290000,-561567,561567,9,1851567
2020-10-05,2644,2750,2612,2675,2958140,433,1615390,739,2,2708140,250000,-1092750,1092750,3,1342750
2020-10-06,2727,2802,2679,2802,4397939,398,3749418,460,3,3587939,810000,161479,-161479,1,648521
2020-10-07,2883,2938,2814,2938,8243106,1207,6276155,501,4,7538106,705000,-1261951,1261951,2,1966951
2020-10-10,2984,3071,2951,3071,6915691,1100,4141602,500,6,4751645,2164046,-610043,610043,2,2774089
2020-10-11,3156,3194,3070,3071,5950176,2027,4901007,729,4,5762828,187348,-861821,861821,5,1049169
2020-10-12,3051,3215,3051,3079,4424399,728,1967980,1081,1,4396899,27500,-2428919,2428919,4,2456419
2020-10-13,3011,3121,2938,3030,3915751,632,1243327,864,2,3884705,31046,-2641378,2641378,7,2672424
2020-10-14,2996,3077,2847,3022,3641876,846,1658896,757,4,2503034,1138842,-844138,844138,4,1982980
2020-10-18,3028,3028,2843,2843,2110156,458,1244477,272,1,2035156,75000,-790679,790679,4,865679
2020-10-19,2761,2840,2761,2761,2619039,274,700932,557,3,2551089,67950,-1850157,1850157,4,1918107
2020-10-20,2634,2738,2634,2738,1219728,332,1089923,283,2,1189320,30408,-99397,99397,1,129805
2020-10-21,2713,2853,2582,2584,3796754,789,3572320,534,3,2867264,929490,705056,-705056,3,224434
2020-10-24,2547,2631,2501,2501,1144195,403,788590,217,1,1139757,4438,-351167,351167,4,355605
2020-10-26,2452,2626,2452,2549,4806598,1129,3771198,722,2,4696602,109996,-925404,925404,4,1035400
2020-11-15,2497,2620,2497,2620,12093905,553,12093905,457,4,6377250,5716655,5716655,-5716655,0,0
2020-11-16,2622,2712,2497,2712,7496677,595,7329997,329,2,4646677,2850000,2683320,-2683320,1,166680
2020-11-17,2825,2825,2825,2825,3509548,370,3509548,152,3,899548,2610000,2610000,-2610000,0,0
2020-11-18,2895,2895,2895,2895,3970052,493,3970052,158,3,1263665,2706387,2706387,-2706387,0,0
2020-11-21,2976,2976,2895,2976,13534944,1567,13092069,767,4,11094714,2440230,1997355,-1997355,1,442875
2020-11-22,3070,3113,2819,3113,9303259,1265,9224403,773,4,5471534,3831725,3752869,-3752869,2,78856
2020-11-23,3213,3213,3158,3213,7781234,1074,7481234,356,6,4169575,3611659,3311659,-3311659,1,300000
2020-11-30,3373,3373,3373,3373,2332222,43,2232222,98,1,382136,1950086,1850086,-1850086,1,100000
2020-12-01,3431,3431,3431,3431,3036922,55,2836922,179,3,573820,2463102,2263102,-2263102,2,200000
2020-12-02,3509,3509,3509,3509,1322085,32,1322085,236,1,822085,500000,500000,-500000,0,0
2020-12-05,3546,3546,3546,3546,2238991,59,2238991,156,2,538991,1700000,1700000,-1700000,0,0
2020-12-06,3608,3608,3608,3608,2566275,51,2366275,158,2,566275,2000000,1800000,-1800000,2,200000
2020-12-07,3682,3682,3682,3682,5348620,122,5348620,278,5,1738837,3609783,3609783,-3609783,0,0
2020-12-08,3836,3836,3710,3836,28673419,1940,28223419,543,9,8992419,19681000,19231000,-19231000,4,450000
2020-12-09,4021,4021,4008,4021,38142144,3487,37232144,1255,16,21132144,17010000,16100000,-16100000,5,910000
2020-12-12,4222,4222,4121,4222,11717160,1863,11617160,709,2,10217160,1500000,1400000,-1400000,1,100000
2020-12-13,4428,4428,4428,4428,4559115,576,4559115,399,3,2959115,1600000,1600000,-1600000,0,0
2020-12-14,4618,4618,4618,4618,6406280,138,6106280,454,4,4806280,1600000,1300000,-1300000,2,300000
2020-12-15,4848,4848,4388,4437,78354247,6452,71486284,4265,14,66268695,12085552,5217589,-5217589,9,6867963
2020-12-16,4388,4748,4388,4748,84768024,6798,79848398,2334,16,31265365,53502659,48583033,-48583033,10,4919626
2020-12-19,4880,4880,4499,4499,70389980,8418,64425996,4832,17,65251697,5138283,-825701,825701,15,5963984
2020-12-20,4520,4691,4373,4373,18201686,2655,15387246,1376,4,17834998,366688,-2447752,2447752,8,2814440
2020-12-21,4194,4633,4194,4633,59785026,5026,56458128,4534,10,50106229,9678797,6351899,-6351899,5,3326898
2020-12-22,4659,4659,4541,4659,52866373,7303,52499898,2668,11,30886373,21980000,21613525,-21613525,7,366475
2020-12-23,4691,4840,4422,4588,43101501,6460,40621163,4574,4,41899932,1201569,-1278769,1278769,7,2480338
2020-12-26,4605,4625,4332,4332,19902331,3224,17699083,1895,3,16603331,3299000,1095752,-1095752,5,2203248
2020-12-27,4155,4328,4149,4149,23230625,2899,20897892,2231,1,23224110,6515,-2326218,2326218,5,2332733
2020-12-28,4053,4243,3966,3966,38418544,4396,33264144,3007,5,37299462,1119082,-4035318,4035318,11,5154400
2020-12-29,3964,3964,3789,3789,17204221,2016,13764221,1820,1,17200619,3602,-3436398,3436398,4,3440000
2020-12-30,3710,4000,3620,4000,49713965,4953,48780698,3841,11,44103951,5610014,4676747,-4676747,4,933267
2021-01-02,4051,4094,3759,3857,29122353,4002,27108364,2871,2,28639425,482928,-1531061,1531061,4,2013989
2021-01-03,3908,4045,3714,3748,24475272,3042,19882441,2461,3,24257324,217948,-4374883,4374883,7,4592831
2021-01-04,3753,3859,3601,3627,22161824,2680,19799961,2530,0,22161824,0,-2361863,2361863,6,2361863
2021-01-05,3774,3774,3497,3497,15519179,1979,12700566,1721,0,15519179,0,-2818613,2818613,4,2818613
2021-01-06,3354,3520,3345,3345,10155229,1026,6051629,931,1,9955229,200000,-3903600,3903600,5,4103600
2021-01-09,3198,3411,3192,3192,9467516,1074,7032516,841,0,9467516,0,-2435000,2435000,4,2435000
2021-01-10,3145,3388,3145,3388,25708252,2486,24801219,1996,4,18473252,7235000,6327967,-6327967,7,907033
2021-01-11,3454,3495,3192,3196,27561519,2498,20010442,1956,2,27398519,163000,-7388077,7388077,6,7551077
2021-01-12,3147,3147,3096,3096,6912680,617,2731570,654,1,6839316,73364,-4107746,4107746,5,4181110
2021-01-13,2944,3011,2944,2944,23175405,1252,12147802,1402,7,22638709,536696,-10490907,10490907,6,11027603
2021-01-16,2804,2857,2799,2799,10425771,592,3805771,845,1,10394896,30875,-6589125,6589125,5,6620000
2021-01-18,2663,2663,2663,2663,3005315,130,305315,105,1,2936190,69125,-2630875,2630875,2,2700000
2021-01-19,2605,2836,2605,2682,32640096,2216,24451308,2336,8,29934871,2705225,-5483563,5483563,8,8188788
2021-01-20,2744,2787,2684,2787,12472418,1027,12470018,823,7,8697418,3775000,3772600,-3772600,1,2400
2021-01-23,2919,2919,2868,2919,7263069,635,7143069,414,3,3994514,3268555,3148555,-3148555,1,120000
2021-01-24,3064,3064,2774,2791,33749811,2583,29484936,1996,6,29770971,3978840,-286035,286035,3,4264875
2021-01-25,2763,2906,2761,2761,18219757,1455,16652717,1464,2,18019757,200000,-1367040,1367040,5,1567040
2021-01-26,2686,2789,2648,2648,7735427,796,6040909,754,0,7735427,0,-1694518,1694518,2,1694518
2021-01-27,2559,2644,2537,2537,19225794,1678,13965148,1165,4,18569749,656045,-4604601,4604601,8,5260646
2021-01-30,2644,2674,2565,2674,13920663,1526,13505666,1160,6,13020398,900265,485268,-485268,2,414997
2021-01-31,2774,2774,2516,2516,15466227,1542,12886227,1305,2,15458095,8132,-2571868,2571868,5,2580000
2021-02-01,2563,2563,2465,2465,7339736,808,5987736,605,1,7307236,32500,-1319500,1319500,1,1352000
2021-02-02,2367,2441,2354,2354,14551236,1209,11733236,1058,1,14546744,4492,-2813508,2813508,4,2818000
2021-02-03,2375,2448,2241,2241,15181500,1464,10122772,1208,5,14388705,792795,-4265933,4265933,4,5058728
2021-02-06,2260,2260,2160,2160,9625876,421,3074977,722,2,9225876,400000,-6150899,6150899,4,6550899
2021-02-07,2164,2269,2164,2269,6520855,195,6420855,541,1,6480855,40000,-60000,60000,1,100000
2021-02-08,2369,2369,2153,2239,11524487,1117,10446898,1082,4,11191860,332627,-744962,744962,2,1077589
2021-02-09,2239,2392,2196,2392,16116496,682,11856496,1153,8,12521947,3594549,-665451,665451,4,4260000
2021-02-13,2495,2495,2473,2495,8818033,596,7715457,391,5,3758033,5060000,3957424,-3957424,3,1102576
2021-02-14,2644,2644,2448,2488,11179584,1175,10164258,1014,6,10706898,472686,-542640,542640,5,1015326
2021-02-15,2495,2507,2480,2480,5961794,520,5511794,448,0,5961794,0,-450000,450000,2,450000
2021-02-16,2439,2439,2439,2439,1258897,145,458897,53,1,1242789,16108,-783892,783892,1,800000
2021-02-17,2431,2431,2431,2431,919600,144,919600,98,1,895438,24162,24162,-24162,0,0
2021-02-20,2424,2424,2424,2424,254624,90,254624,2,1,53250,201374,201374,-201374,0,0
2021-02-21,2422,2422,2422,2422,99673,47,99673,7,1,86239,13434,13434,-13434,0,0
2021-02-22,2422,2422,2422,2422,49922,28,49922,5,0,49922,0,0,0,0,0
2021-02-23,2422,2422,2422,2422,492006,87,492006,17,0,492006,0,0,0,0,0
2021-02-24,2418,2418,2418,2418,369948,66,369948,5,2,230704,139244,139244,-139244,0,0
2021-02-27,2416,2416,2416,2416,983905,43,83905,14,0,983905,0,-900000,900000,1,900000
2021-02-28,2409,2409,2409,2409,14122,19,14122,1,0,14122,0,0,0,0,0
2021-03-01,2409,2409,2409,2409,164671,29,154671,3,0,164671,0,-10000,10000,1,10000
2021-03-02,2407,2407,2407,2407,719057,69,219057,14,3,512607,206450,-293550,293550,1,500000
2021-03-03,2403,2403,2403,2403,556314,30,56314,12,2,306628,249686,-250314,250314,1,500000
2021-03-06,2401,2401,2401,2401,133072,31,133072,3,0,133072,0,0,0,0,0
2021-03-07,2401,2401,2401,2401,1135788,56,135788,5,1,658133,477655,-522345,522345,1,1000000
2021-03-08,2392,2473,2392,2407,21953518,1232,21053518,1202,4,14117491,7836027,6936027,-6936027,1,900000
2021-03-09,2377,2441,2354,2354,17967781,1643,13667781,1193,4,12974619,4993162,693162,-693162,5,4300000
2021-03-10,2347,2347,2347,2347,213860,96,213860,4,1,113860,100000,100000,-100000,0,0
2021-03-13,2345,2467,2345,2388,21235960,1622,20567896,1845,9,19059385,2176575,1508511,-1508511,2,668064
2021-03-14,2396,2452,2347,2347,9464227,1087,9260227,895,1,9264227,200000,-4000,4000,3,204000
2021-03-15,2318,2324,2318,2318,3660832,386,2560832,295,0,3660832,0,-1100000,1100000,2,1100000
2021-03-16,2296,2403,2296,2347,15088358,1143,13000197,1191,4,11642287,3446071,1357910,-1357910,5,2088161
2021-03-17,2394,2422,2347,2362,7399405,646,6119551,596,7,6523598,875807,-404047,404047,2,1279854
2021-03-27,2350,2431,2345,2392,5658585,639,4179774,559,1,5377135,281450,-1197361,1197361,3,1478811
2021-03-28,2369,2450,2367,2373,4376488,552,3932192,489,5,3813634,562854,118558,-118558,2,444296
2021-03-30,2360,2386,2339,2360,3969949,471,3469949,273,0,3969949,0,-500000,500000,2,500000
2021-03-31,2318,2333,2318,2318,1829233,377,1547233,166,0,1829233,0,-282000,282000,1,282000
2021-04-03,2305,2318,2305,2305,1419662,155,919662,82,0,1419662,0,-500000,500000,1,500000
2021-04-04,2298,2298,2298,2298,155013,44,154013,3,0,155013,0,-1000,1000,1,1000
2021-04-05,2298,2298,2298,2298,186977,48,186977,5,0,186977,0,0,0,0,0
2021-04-06,2296,2296,2296,2296,3229282,97,229282,15,0,3229282,0,-3000000,3000000,1,3000000
2021-04-07,2275,2275,2275,2275,672268,57,172268,11,0,672268,0,-500000,500000,1,500000
2021-04-10,2271,2271,2271,2271,44234,36,44234,2,0,44234,0,0,0,0,0
2021-04-11,2271,2271,2271,2271,89067,37,89067,1,0,89067,0,0,0,0,0
2021-04-12,2271,2271,2271,2271,9052560,101,552560,432,3,7692257,1360303,-7139697,7139697,3,8500000
2021-04-19,1974,2090,1974,2057,11072219,698,7134403,708,2,11016219,56000,-3881816,3881816,6,3937816
2021-04-20,2009,2068,1996,1996,6995047,523,6340047,461,1,6712774,282273,-372727,372727,3,655000
2021-04-21,1948,2018,1948,1948,5797716,320,2942951,399,0,5797716,0,-2854765,2854765,3,2854765
2021-04-24,1904,1904,1904,1904,1675100,119,1345100,122,0,1675100,0,-330000,330000,2,330000
2021-04-25,1890,1890,1890,1890,692155,44,92155,35,0,692155,0,-600000,600000,1,600000
2021-04-26,1884,1884,1884,1884,669714,67,269714,10,0,669714,0,-400000,400000,1,400000
2021-04-27,1879,1939,1879,1884,10763431,560,7708904,715,2,10699939,63492,-2991035,2991035,5,3054527
2021-04-28,1844,1928,1833,1875,5247230,375,4045671,435,2,5081380,165850,-1035709,1035709,2,1201559
2021-05-01,1868,1868,1813,1813,3781012,230,2061102,316,3,3645831,135181,-1584729,1584729,3,1719910
2021-05-02,1785,1811,1785,1785,902401,109,902401,97,1,862131,40270,40270,-40270,0,0
2021-05-03,1778,1778,1778,1778,517342,56,116342,37,1,427212,90130,-310870,310870,2,401000
2021-05-05,1776,1789,1776,1776,5045979,180,2945979,230,1,4445979,600000,-1500000,1500000,3,2100000
2021-05-08,1741,1776,1739,1739,4881267,135,1876267,287,0,4881267,0,-3005000,3005000,2,3005000
2021-05-09,1706,1706,1706,1706,547559,48,547559,43,0,547559,0,0,0,0,0
2021-05-10,1701,1759,1701,1737,5787222,285,5497222,541,0,5787222,0,-290000,290000,2,290000
2021-05-11,1719,1776,1715,1754,3328849,326,3328849,363,6,2996426,332423,332423,-332423,0,0
2021-05-12,1785,1785,1682,1704,5619968,228,5316968,349,2,5482184,137784,-165216,165216,3,303000
2021-05-15,1682,1737,1631,1710,4122712,188,2398256,298,1,4120078,2634,-1721822,1721822,6,1724456
2021-05-16,1640,1787,1640,1787,15456946,587,10657838,488,5,8761974,6694972,1895864,-1895864,6,4799108
2021-05-17,1802,1862,1796,1862,25178798,1046,23832968,883,5,17853131,7325667,5979837,-5979837,3,1345830
2021-05-18,1899,1948,1860,1948,32687909,1264,28955652,1118,2,22487909,10200000,6467743,-6467743,7,3732257
2021-05-19,1956,1967,1842,1842,3732133,380,3732133,185,0,3732133,0,0,0,0,0
2021-05-22,1809,1809,1809,1809,295592,35,295592,8,0,295592,0,0,0,0,0
2021-05-23,1805,1805,1805,1805,80445,32,80445,6,0,80445,0,0,0,0,0
2021-05-24,1805,1805,1805,1805,286803,26,286803,5,0,286803,0,0,0,0,0
2021-05-25,1800,1800,1800,1800,695772,81,544272,9,0,695772,0,-151500,151500,2,151500
2021-05-26,1794,1866,1794,1798,20698423,758,17845695,1280,4,20093322,605101,-2247627,2247627,8,2852728
2021-05-29,1813,1897,1813,1893,12254068,676,9514166,581,6,10280834,1973234,-766668,766668,8,2739902
2021-05-30,1904,1934,1763,1763,9055613,628,7900613,580,5,8776102,279511,-875489,875489,2,1155000
2021-05-31,1798,1798,1719,1719,3768230,318,2883230,259,1,3700559,67671,-817329,817329,2,885000
2021-06-01,1693,1759,1693,1715,2041563,162,1702967,230,1,1636193,405370,66774,-66774,3,338596
2021-06-02,1695,1787,1695,1759,6406573,344,5354573,306,2,4357699,2048874,996874,-996874,3,1052000
2021-06-07,1706,1824,1706,1781,5164705,312,4914705,351,1,4897440,267265,17265,-17265,2,250000
2021-06-08,1802,1838,1748,1781,7419958,325,4142584,323,6,6974462,419953,-2831878,2831878,3,3251831
2021-06-09,1759,1791,1719,1750,1885701,179,1242956,183,0,1885701,0,-642745,642745,5,642745
2021-06-12,1737,1791,1704,1730,4524719,207,3957719,203,2,4493704,31015,-535985,535985,4,567000
2021-06-13,1715,1770,1715,1759,4064478,196,4064478,258,2,3611478,453000,453000,-453000,0,0
2021-06-14,1789,1798,1759,1781,4464123,191,3864123,282,5,3347545,1116578,516578,-516578,2,600000
2021-06-15,1765,1807,1759,1783,7613741,218,6512901,335,3,4938741,2675000,1574160,-1574160,2,1100840
2021-06-16,1772,1798,1737,1759,2819056,190,2554056,246,2,2321666,497390,232390,-232390,3,265000
2021-06-19,1791,1857,1737,1857,12515941,308,12480941,464,4,11071954,1443987,1408987,-1408987,2,35000
2021-06-20,1888,1888,1824,1831,11093263,370,9202963,417,5,9618791,1474472,-415828,415828,5,1890300
2021-06-21,1846,1879,1781,1849,6809097,239,5904197,346,2,6509097,300000,-604900,604900,2,904900
2021-06-22,1802,1943,1802,1943,18555179,271,11391253,468,3,11320683,7234496,70570,-70570,4,7163926
2021-06-23,1987,1996,1948,1996,21428103,575,19748053,468,3,12967313,8460790,6780740,-6780740,4,1680050
2021-06-26,2035,2093,2014,2035,24293390,982,19909898,653,7,20389390,3904000,-479492,479492,3,4383492
2021-06-27,2062,2154,1976,2027,9091778,415,7638778,581,2,9056778,35000,-1418000,1418000,5,1453000
2021-06-28,2029,2040,1954,1967,11490115,625,9024759,537,1,10917507,572608,-1892748,1892748,4,2465356
2021-06-29,1904,2000,1890,1932,6724737,333,5974737,279,3,6215336,509401,-240599,240599,2,750000
2021-06-30,1917,2042,1917,2042,15223494,312,13183194,534,5,10651678,4571816,2531516,-2531516,4,2040300
2021-07-03,2112,2112,2112,2112,39348393,487,38648393,679,3,20348393,19000000,18300000,-18300000,2,700000
2021-07-04,2154,2218,2095,2218,38360513,1446,35384630,1046,5,33991217,4369296,1393413,-1393413,3,2975883
2021-07-05,2203,2286,2090,2165,16461063,968,15005583,653,0,16461063,0,-1455480,1455480,2,1455480
2021-07-06,2181,2262,2132,2170,12181409,609,9751808,532,1,12131409,50000,-2379601,2379601,2,2429601
2021-07-07,2218,2218,2128,2150,8013653,486,6862517,396,1,7813653,200000,-951136,951136,2,1151136
2021-07-10,2134,2183,2071,2110,5806581,385,4464908,370,1,5656581,150000,-1191673,1191673,2,1341673
2021-07-11,2090,2176,2057,2154,6556784,320,5084310,361,4,5481784,1075000,-397474,397474,5,1472474
2021-07-12,2218,2218,2110,2143,5366577,345,3777578,307,0,5366577,0,-1588999,1588999,4,1588999
2021-07-13,2154,2165,2090,2130,7916220,288,3996154,450,0,7916220,0,-3920066,3920066,4,3920066
2021-07-14,2093,2216,2088,2187,8745394,355,7523374,496,2,7875394,870000,-352020,352020,4,1222020
2021-07-17,2187,2198,2090,2110,8956485,436,7096682,407,1,8940685,15800,-1844003,1844003,4,1859803
2021-07-18,2090,2128,2046,2088,4864933,247,2194609,334,0,4864933,0,-2670324,2670324,2,2670324
2021-07-19,2156,2156,2079,2110,3784510,216,3291675,217,1,3764508,20002,-472833,472833,1,492835
2021-07-26,2148,2148,2066,2097,4545781,239,2016795,326,0,4545781,0,-2528986,2528986,3,2528986
2021-07-27,2110,2128,2046,2053,9129146,210,2328668,349,2,5725263,3403883,-3396595,3396595,4,6800478
2021-07-28,2005,2132,2005,2088,5227574,228,2653666,357,2,4857574,370000,-2203908,2203908,5,2573908
2021-07-31,2088,2185,2040,2185,13271029,265,6037057,556,3,7621029,5650000,-1583972,1583972,5,7233972
2021-08-01,2214,2264,2187,2198,10763787,779,9776687,563,3,10152797,610990,-376110,376110,3,987100
2021-08-02,2185,2233,2128,2233,9637903,323,4570139,579,2,8854669,783234,-4284530,4284530,9,5067764
2021-08-03,2198,2286,2172,2222,8402337,565,7428070,551,8,7306501,1095836,121569,-121569,3,974267
2021-08-04,2255,2326,2220,2308,11753574,526,6726019,484,4,10216332,1537242,-3490313,3490313,7,5027555
2021-08-07,2308,2330,2209,2242,11272847,360,4255718,448,4,10317847,955000,-6062129,6062129,6,7017129
2021-08-08,2227,2271,2178,2227,7070286,366,3295996,396,3,6970286,100000,-3674290,3674290,3,3774290
2021-08-09,2209,2337,2178,2337,20311694,340,16118484,655,3,8920047,11391647,7198437,-7198437,5,4193210
2021-08-10,2429,2429,2374,2429,31030533,785,24051189,692,6,20715101,10315432,3336088,-3336088,7,6979344
2021-08-11,2464,2545,2444,2477,13513216,879,11561884,660,4,12357201,1156015,-795317,795317,6,1951332
2021-08-14,2491,2611,2420,2585,15811257,764,11545183,830,9,12097676,3713581,-552493,552493,10,4266074
2021-08-15,2596,2658,2508,2655,7200903,532,4989011,633,2,6966346,234557,-1977335,1977335,7,2211892
2021-08-22,2666,2734,2655,2734,13944622,503,9841596,623,8,6142462,7802160,3699134,-3699134,6,4103026
2021-08-23,2836,2864,2728,2864,11776141,781,9710302,762,5,7923393,3852748,1786909,-1786909,8,2065839
2021-08-24,2981,2985,2847,2886,14431204,1271,10934050,856,6,12661204,1770000,-1727154,1727154,6,3497154
2021-08-25,2935,2946,2787,2792,33460794,2285,25475503,1261,6,31857763,1603031,-6382260,6382260,9,7985291
2021-08-28,2787,2877,2748,2778,16624938,1429,14153795,1030,5,14633257,1991681,-479462,479462,7,2471143
2021-08-29,2811,2836,2673,2673,14614796,1085,12339796,925,5,13974796,640000,-1635000,1635000,5,2275000
2021-08-30,2609,2686,2603,2603,9248108,451,5048108,482,3,8162765,1085343,-3114657,3114657,3,4200000
2021-08-31,2488,2589,2480,2528,12692937,711,11479479,813,2,11249415,1443522,230064,-230064,6,1213458
2021-09-01,2530,2605,2526,2605,6588826,627,5384332,381,4,4242888,2345938,1141444,-1141444,4,1204494
2021-09-04,2640,2640,2515,2550,5627797,562,4832005,393,2,4771172,856625,60833,-60833,4,795792
2021-09-05,2550,2603,2480,2523,8072831,682,7195908,474,3,7565694,507137,-369786,369786,4,876923
2021-09-06,2576,2596,2486,2495,6461007,549,5831872,647,4,5382885,1078122,448987,-448987,4,629135
2021-09-07,2515,2539,2444,2469,15071335,438,3315887,634,6,4280374,10790961,-964487,964487,6,11755448
2021-09-08,2473,2521,2444,2475,4726635,391,4055361,856,4,4012332,714303,43029,-43029,4,671274
2021-09-11,2512,2512,2396,2418,3034724,337,2731860,294,4,2839908,194816,-108048,108048,2,302864
2021-09-12,2460,2491,2339,2348,7685021,746,5220021,459,1,7309522,375499,-2089501,2089501,6,2465000
2021-09-13,2374,2418,2244,2350,6643738,364,3882912,460,2,4683455,1960283,-800543,800543,4,2760826
2021-09-14,2321,2416,2321,2416,15572044,514,9345774,570,7,9586586,5985458,-240812,240812,5,6226270
2021-09-15,2451,2451,2363,2394,5190315,556,4554161,723,3,4541292,649023,12869,-12869,1,636154
2021-09-18,2394,2394,2293,2310,5953953,431,4943818,410,0,5953953,0,-1010135,1010135,5,1010135
2021-09-19,2209,2295,2209,2251,3319408,258,2656408,270,0,3319408,0,-663000,663000,3,663000
2021-09-20,2238,2343,2220,2242,4931094,398,4121412,340,2,4449620,481474,-328208,328208,5,809682
2021-09-21,2233,2328,2176,2185,4889732,295,2622023,426,0,4889732,0,-2267709,2267709,4,2267709
2021-09-22,2163,2328,2128,2308,7720416,371,3456584,562,1,7592002,128414,-4135418,4135418,5,4263832
2021-09-25,2330,2350,2290,2350,29270366,434,7805366,338,8,2989758,26280608,4815608,-4815608,3,21465000
2021-09-26,2427,2427,2308,2339,4195549,575,3834928,343,3,4177009,18540,-342081,342081,3,360621
2021-09-28,2396,2396,2271,2295,3250555,342,3234047,333,1,3182337,68218,51710,-51710,2,16508
2021-09-29,2339,2370,2271,2317,3469907,348,3083870,351,3,3222125,247782,-138255,138255,3,386037
2021-10-02,2330,2433,2308,2433,9021842,368,7841626,623,5,7646476,1375366,195150,-195150,4,1180216
2021-10-03,2440,2451,2299,2396,6518922,377,3993487,371,5,6200595,318327,-2207108,2207108,3,2525435
2021-10-04,2352,2484,2352,2484,21007692,389,20067991,570,7,8247419,12760273,11820572,-11820572,5,939701
2021-10-06,2497,2515,2429,2440,9912768,605,5634555,473,3,9847676,65092,-4213121,4213121,4,4278213
2021-10-09,2495,2495,2367,2378,9316742,346,3224998,429,0,9316742,0,-6091744,6091744,5,6091744
2021-10-10,2378,2405,2301,2345,5072325,242,3621059,324,1,4693236,379089,-1072177,1072177,4,1451266
2021-10-11,2339,2420,2301,2385,5994209,252,1818336,300,1,5591905,402304,-3773569,3773569,4,4175873
2021-10-12,2301,2372,2247,2306,7389685,312,3381184,350,2,7331078,58607,-3949894,3949894,4,4008501
2021-10-13,2242,2262,2141,2227,4431565,266,2347478,293,3,4229910,201655,-1882432,1882432,3,2084087
2021-10-16,2297,2304,2233,2286,5104084,242,3845949,226,4,3033382,2070702,812567,-812567,3,1258135
2021-10-17,2352,2352,2220,2304,8239633,255,5441867,400,3,5116600,3123033,325267,-325267,2,2797766
2021-10-18,2244,2372,2242,2370,7503655,271,4733923,423,3,4552098,2951557,181825,-181825,2,2769732
2021-10-19,2418,2458,2418,2458,7989795,104,7989795,408,3,5259795,2730000,2730000,-2730000,0,0
2021-10-20,2484,2554,2374,2534,30203738,771,13967406,866,6,24955146,5248592,-10987740,10987740,7,16236332
2021-10-23,2385,2471,2385,2385,4045120,222,2869140,171,2,4037720,7400,-1168580,1168580,2,1175980
2021-10-25,2326,2385,2319,2319,3750050,235,3184609,203,0,3750050,0,-565441,565441,3,565441
2021-10-26,2262,2319,2260,2260,8649222,480,5153603,352,2,7994390,654832,-2840787,2840787,5,3495619
2021-10-27,2198,2295,2198,2233,3300141,279,2949692,266,1,3237321,62820,-287629,287629,2,350449
2021-10-30,2231,2293,2189,2247,4383852,252,3986923,435,2,3967442,416410,19481,-19481,1,396929
2021-10-31,2251,2251,2130,2130,6457676,265,3040603,279,1,5650929,806747,-2610326,2610326,4,3417073
2021-11-01,2222,2240,2132,2198,7083168,208,4823383,249,4,4183387,2899781,639996,-639996,4,2259785
2021-11-02,2200,2273,2198,2220,3339386,203,3113564,204,3,2361806,977580,751758,-751758,3,225822
2021-11-03,2220,2328,2123,2295,5178170,219,4966121,319,2,5165970,12200,-199849,199849,1,212049
2021-11-06,2328,2374,2312,2374,4654199,85,4654199,259,1,3654199,1000000,1000000,-1000000,0,0
2021-11-07,2416,2416,2225,2242,3815310,268,3769860,236,1,3726325,88985,43535,-43535,1,45450
2021-11-08,2258,2352,2209,2253,4933751,293,4113315,226,2,4748855,184896,-635540,635540,3,820436
2021-11-09,2264,2372,2247,2319,5284547,188,3389285,298,1,4181646,1102901,-792361,792361,3,1895262
2021-11-10,2312,2418,2312,2374,5325028,261,4672547,298,4,3339985,1985043,1332562,-1332562,3,652481
2021-11-13,2251,2304,2249,2258,5885260,314,4392413,290,2,4882891,1002369,-490478,490478,2,1492847
2021-11-14,2227,2352,2227,2284,4521738,167,3169425,285,1,4022112,499626,-852687,852687,1,1352313
2021-11-15,2301,2301,2203,2233,2366505,158,2206213,203,0,2366505,0,-160292,160292,1,160292
2021-11-16,2264,2264,2200,2238,2400709,190,1836944,156,0,2400709,0,-563765,563765,3,563765
2021-11-17,2205,2284,2198,2238,2644238,225,1902482,218,0,2644238,0,-741756,741756,1,741756
2021-11-20,2264,2282,2174,2196,5261334,291,2976334,226,0,5261334,0,-2285000,2285000,2,2285000
2021-11-21,2198,2306,2198,2247,2511532,211,2511532,258,1,2496532,15000,15000,-15000,0,0
2021-11-22,2233,2286,2227,2229,4383570,272,2864643,222,4,2508249,1875321,356394,-356394,5,1518927
2021-11-23,2255,2255,2198,2218,1963178,158,1356655,164,1,1958178,5000,-601523,601523,2,606523
2021-11-24,2200,2260,2174,2198,2138256,180,1419898,211,1,2130492,7764,-710594,710594,5,718358
2021-11-27,2192,2209,2121,2143,2085631,207,2085631,218,0,2085631,0,0,0,0,0
2021-11-28,2174,2214,2119,2176,1577084,154,1094070,181,1,1477084,100000,-383014,383014,4,483014
2021-11-29,2194,2203,2150,2156,3208450,140,2608450,186,1,3100404,108046,-491954,491954,2,600000
2021-11-30,2156,2192,2121,2130,1664946,198,1074379,148,1,1606733,58213,-532354,532354,2,590567
2021-12-01,2132,2154,2068,2132,2575477,224,1962063,176,0,2575477,0,-613414,613414,3,613414
2021-12-04,2150,2150,2064,2088,1671882,144,1337882,188,0,1671882,0,-334000,334000,2,334000
2021-12-05,2060,2143,2060,2097,1281080,133,1131080,152,1,1231080,50000,-100000,100000,1,150000
2021-12-06,2071,2097,2066,2066,1971499,144,1601499,138,2,1831999,139500,-230500,230500,3,370000
2021-12-07,2066,2101,2007,2055,4249130,217,2693780,214,3,3414726,834404,-720946,720946,6,1555350
2021-12-08,2027,2126,2022,2086,2038712,160,1877151,174,2,1974532,64180,-97381,97381,3,161561
2021-12-11,2068,2086,2003,2016,1775367,138,1538006,124,1,1754242,21125,-216236,216236,2,237361
2021-12-12,2000,2046,1961,2038,1454484,126,965193,122,2,1394278,60206,-429085,429085,5,489291
2021-12-13,2040,2044,1943,1943,3208820,183,2451990,171,1,3108820,100000,-656830,656830,4,756830
2021-12-14,1917,2044,1917,2007,2657845,125,873110,191,1,2557845,100000,-1684735,1684735,4,1784735
2021-12-15,2020,2022,1923,1948,1571914,107,785537,119,3,1370522,201392,-584985,584985,4,786377
2021-12-18,1976,2044,1959,1972,1434587,105,1188052,123,3,1195367,239220,-7315,7315,5,246535
2021-12-19,1948,1978,1915,1923,1699527,82,954342,131,0,1699527,0,-745185,745185,4,745185
2021-12-20,1930,2016,1923,2007,3616266,72,2287605,153,1,3599416,16850,-1311811,1311811,5,1328661
2021-12-21,1978,2077,1956,2075,4344119,86,575254,175,3,2738526,1605593,-2163272,2163272,5,3768865
2021-12-22,2108,2112,2086,2112,6468178,164,4822029,220,5,4852911,1615267,-30882,30882,7,1646149
2021-12-25,2145,2145,2077,2104,2893947,183,2560709,167,2,2369545,524402,191164,-191164,3,333238
2021-12-26,2049,2117,2049,2062,1401284,105,1232865,114,2,905686,495598,327179,-327179,3,168419
2021-12-27,2066,2143,2066,2110,2985121,123,2365337,170,2,2082498,902623,282839,-282839,5,619784
2021-12-28,2088,2106,2073,2093,1098127,103,805127,94,1,1028516,69611,-223389,223389,2,293000
2021-12-29,2084,2148,2055,2079,1479886,112,704702,157,1,1478843,1043,-774141,774141,4,775184
2022-01-01,2053,2093,2033,2046,1165200,81,593939,99,1,1135158,30042,-541219,541219,5,571261
2022-01-02,2077,2095,2044,2062,1293325,79,461100,127,5,1037325,256000,-576225,576225,5,832225
2022-01-03,2044,2088,2018,2031,855795,117,533631,85,0,855795,0,-322164,322164,3,322164
2022-01-04,2003,2062,2003,2022,1601765,96,1326125,95,1,1593435,8330,-267310,267310,4,275640
2022-01-05,2022,2062,1992,2020,792052,78,535277,96,1,790505,1547,-255228,255228,5,256775
2022-01-08,2011,2057,2000,2016,1630249,83,1273565,124,0,1630249,0,-356684,356684,3,356684
2022-01-09,2022,2033,1970,2000,1638804,75,1541237,111,2,1529496,109308,11741,-11741,2,97567
2022-01-10,1956,2022,1956,1978,1695659,119,998623,105,1,1584532,111127,-585909,585909,4,697036
2022-01-11,1994,2029,1983,1989,2071618,82,1162417,103,0,2071618,0,-909201,909201,4,909201
2022-01-12,1978,2033,1950,1978,1144343,76,816132,103,1,1032575,111768,-216443,216443,2,328211
2022-01-15,2014,2014,1919,1976,1837158,102,1532440,95,2,1071311,765847,461129,-461129,3,304718
2022-01-16,1926,1956,1917,1945,2857457,96,2375721,105,1,2712457,145000,-336736,336736,4,481736
2022-01-17,1917,1983,1910,1912,1822627,107,1408552,110,2,1382945,439682,25607,-25607,4,414075
2022-01-18,1906,1934,1875,1877,2686753,70,2216796,102,2,2186753,500000,30043,-30043,2,469957
2022-01-19,1877,2027,1877,1989,7299290,86,1027930,306,4,5797704,1501586,-4769774,4769774,5,6271360
2022-01-22,2024,2077,1939,1967,2456923,110,1976923,140,3,2079191,377732,-102268,102268,1,480000
2022-01-23,1934,1978,1917,1954,656187,66,621187,99,1,581006,75181,40181,-40181,1,35000
2022-01-24,1906,1976,1906,1930,1419147,85,1312312,86,0,1419147,0,-106835,106835,1,106835
2022-01-25,1895,1934,1879,1893,4415881,124,3883772,99,2,2815881,1600000,1067891,-1067891,2,532109
2022-01-26,1908,1976,1893,1899,2657859,137,1634269,139,2,2569796,88063,-935527,935527,4,1023590
2022-01-29,1974,2005,1915,1983,2438670,123,1675537,187,1,2338670,100000,-663133,663133,4,763133
2022-01-30,1978,2016,1838,1910,2050331,149,1551912,116,0,2050331,0,-498419,498419,3,498419
2022-01-31,1921,1985,1873,1956,1964821,119,1314898,161,2,1547095,417726,-232197,232197,5,649923
2022-02-01,1941,1981,1937,1939,896335,71,334312,116,1,874837,21498,-540525,540525,4,562023
2022-02-02,1939,1948,1871,1912,597134,68,347134,83,1,520879,76255,-173745,173745,2,250000
2022-02-05,1937,1954,1897,1904,1294071,75,1053556,114,0,1294071,0,-240515,240515,2,240515
2022-02-06,1893,1897,1846,1890,1222957,94,1122957,115,0,1222957,0,-100000,100000,1,100000
2022-02-07,1842,1890,1840,1879,823454,73,763454,88,0,823454,0,-60000,60000,1,60000
2022-02-08,1842,1932,1842,1904,2245110,120,1728670,162,2,2222467,22643,-493797,493797,4,516440
2022-02-09,1851,1901,1851,1873,1850901,76,938208,186,0,1850901,0,-912693,912693,3,912693
2022-02-12,1860,1901,1831,1833,1377062,80,863522,76,1,1127062,250000,-263540,263540,2,513540
2022-02-13,1868,1868,1811,1818,890245,68,640245,67,0,890245,0,-250000,250000,2,250000
2022-02-14,1807,1866,1802,1857,1687996,63,970776,137,0,1687996,0,-717220,717220,4,717220
2022-02-16,1807,1956,1807,1906,10479869,190,2458119,200,3,3057377,7422492,-599258,599258,3,8021750
2022-02-19,1928,2033,1871,1959,9070632,182,1899213,286,6,3725614,5345018,-1826401,1826401,4,7171419
2022-02-20,1912,1981,1901,1906,2998332,152,2718332,93,2,980287,2018045,1738045,-1738045,3,280000
2022-02-21,1893,1978,1890,1899,4388351,195,2198138,140,3,2885442,1502909,-687304,687304,4,2190213
2022-02-22,1934,1934,1882,1912,1060006,108,669661,86,1,914474,145532,-244813,244813,4,390345
2022-02-23,1873,1921,1873,1908,1651163,87,837530,96,3,1195565,455598,-358035,358035,5,813633
2022-02-26,1866,1919,1857,1868,1476602,95,1301281,101,1,1469405,7197,-168124,168124,4,175321
2022-02-27,1846,1886,1813,1846,2713465,151,2216662,82,1,2585268,128197,-368606,368606,4,496803
2022-02-28,1862,1888,1829,1853,1290315,139,804628,78,2,1177302,113013,-372674,372674,4,485687
2022-03-02,1855,1888,1844,1846,791080,67,307472,110,2,708470,82610,-400998,400998,5,483608
2022-03-05,1879,1899,1855,1864,2002755,79,1391558,156,1,1889035,113720,-497477,497477,2,611197
2022-03-06,1904,1941,1853,1908,2280370,89,1167714,221,2,2146712,133658,-978998,978998,5,1112656
2022-03-07,1893,1945,1893,1917,3522955,106,2045930,187,4,1663104,1859851,382826,-382826,4,1477025
2022-03-08,1871,1943,1871,1890,533703,48,471026,81,0,533703,0,-62677,62677,1,62677
2022-03-09,1871,1941,1871,1921,1145690,77,600426,127,1,1107690,38000,-507264,507264,2,545264
2022-03-12,1849,1897,1846,1857,1194474,66,994474,96,0,1194474,0,-200000,200000,1,200000
2022-03-13,1849,1904,1849,1868,1561707,78,691723,87,0,1561707,0,-869984,869984,4,869984
2022-03-14,1853,1868,1853,1855,259339,17,257339,22,0,259339,0,-2000,2000,1,2000
2022-03-15,1901,1921,1871,1893,1610246,43,935647,114,2,1185246,425000,-249599,249599,6,674599
2022-03-16,1901,1970,1901,1939,2997439,84,2997439,142,3,2112771,884668,884668,-884668,0,0
2022-03-19,1970,1985,1932,1978,2327863,121,1995363,150,2,1524961,802902,470402,-470402,1,332500
2022-03-26,1917,1987,1917,1954,672386,90,672386,98,2,607866,64520,64520,-64520,0,0
2022-03-27,1948,1994,1904,1950,2513476,175,2363476,98,0,2513476,0,-150000,150000,3,150000
2022-03-28,1934,2027,1934,2027,4514824,143,4514824,206,6,2407337,2107487,2107487,-2107487,0,0
2022-03-29,2088,2088,2055,2077,8663610,335,6820550,300,6,6112666,2550944,707884,-707884,6,1843060
2022-03-30,2128,2128,2011,2101,2806671,174,2301270,196,2,2534400,272271,-233130,233130,4,505401
2022-04-03,2110,2185,2077,2185,8422174,158,3453915,255,4,4071894,4350280,-617979,617979,7,4968259
2022-04-04,2262,2273,2154,2203,5528315,211,3124119,244,4,5150574,377741,-2026455,2026455,7,2404196
2022-04-05,2242,2242,2090,2176,2341748,169,2222364,141,4,1609165,732583,613199,-613199,2,119384
2022-04-06,2176,2194,2128,2141,2883042,152,2596056,166,3,2444313,438729,151743,-151743,3,286986
2022-04-09,2128,2194,2075,2165,2178280,154,1847474,161,2,2155879,22401,-308405,308405,2,330806
2022-04-10,2181,2273,2165,2231,14138086,268,7509668,260,7,11052516,3085570,-3542848,3542848,5,6628418
2022-04-11,2236,2319,2183,2253,24531000,276,4776663,407,11,18840518,5690482,-14063855,14063855,4,19754337
2022-04-18,2386,2386,2312,2383,20114241,260,19985241,311,5,13833172,6281069,6152069,-6152069,2,129000
2022-04-19,2364,2483,2329,2395,4542851,232,3674976,290,4,3862663,680188,-187687,187687,4,867875
2022-04-20,2457,2457,2334,2360,4256071,219,3992899,169,4,3643511,633708,349388,-349388,5,284320
2022-04-24,2360,2360,2308,2312,3048145,187,2422166,185,3,2546499,501646,-124333,124333,2,625979
2022-04-25,2338,2353,2293,2317,5193440,261,3310790,184,4,4765954,427486,-1455164,1455164,4,1882650
2022-04-26,2291,2355,2291,2336,9069283,225,5915682,232,4,5938068,3131215,-22386,22386,2,3153601
2022-04-27,2360,2360,2312,2315,3803032,166,3383891,220,1,3801528,1504,-417637,417637,2,419141
2022-04-30,2312,2348,2279,2282,4342737,210,3178217,167,1,4223603,119134,-1045386,1045386,4,1164520
2022-05-01,2336,2336,2282,2296,1490120,121,1490120,131,1,1446596,43524,43524,-43524,0,0
2022-05-02,2296,2331,2277,2315,3423879,151,2937408,140,1,3282954,140925,-345546,345546,2,486471
2022-05-07,2324,2329,2282,2284,7310600,239,6551809,170,3,5745257,1565343,806552,-806552,4,758791
2022-05-08,2305,2386,2286,2341,12683818,337,10616447,273,5,8477064,4206754,2139383,-2139383,5,2067371
2022-05-09,2362,2383,2284,2284,10759827,232,6837277,212,6,7390513,3369314,-553236,553236,4,3922550
2022-05-10,2301,2315,2279,2284,5001857,211,4439827,145,3,3404128,1597729,1035699,-1035699,3,562030
2022-05-11,2315,2433,2282,2433,15549512,264,15439167,449,6,11547476,4002036,3891691,-3891691,2,110345
2022-05-14,2528,2542,2459,2542,53041995,1355,43020719,672,12,27883942,25158053,15136777,-15136777,16,10021276
2022-05-15,2596,2636,2473,2528,14985358,678,12498269,510,5,10194494,4790864,2303775,-2303775,4,2487089
2022-05-16,2530,2546,2464,2499,9861292,607,8069138,520,3,9329197,532095,-1260059,1260059,7,1792154
2022-05-17,2539,2554,2452,2476,10021799,305,4962515,329,2,8803015,1218784,-3840500,3840500,7,5059284
2022-05-18,2485,2485,2395,2421,12223203,304,8227939,272,2,10243203,1980000,-2015264,2015264,6,3995264
2022-05-21,2400,2457,2364,2419,12283062,401,10234282,270,1,6193552,6089510,4040730,-4040730,4,2048780
2022-05-22,2395,2445,2388,2412,10824630,303,7551085,177,2,5414903,5409727,2136182,-2136182,7,3273545
2022-05-23,2412,2412,2298,2324,9673555,280,8095321,319,3,7526055,2147500,569266,-569266,6,1578234
2022-05-24,2322,2350,2275,2345,3177310,174,1613422,228,1,3131333,45977,-1517911,1517911,5,1563888
2022-05-25,2343,2376,2322,2362,10821190,302,7520607,187,4,3699895,7121295,3820712,-3820712,6,3300583
2022-05-28,2362,2376,2275,2275,6075182,197,4499168,208,4,4757494,1317688,-258326,258326,4,1576014
2022-05-29,2272,2319,2208,2265,6586693,168,3647285,249,3,4679182,1907511,-1031897,1031897,6,2939408
2022-05-30,2260,2312,2249,2256,5094556,132,1520260,159,4,2114342,2980214,-594082,594082,5,3574296
2022-05-31,2296,2296,2223,2258,4131273,132,2102163,123,3,1481524,2649749,620639,-620639,5,2029110
2022-06-01,2249,2265,2234,2246,1894935,126,1372721,141,4,1681131,213804,-308410,308410,3,522214
2022-06-06,2230,2244,2159,2163,4339213,152,2659775,204,2,4031090,313304,-1371315,1371315,4,1684619
2022-06-06,2163,2163,2163,2163,5181,152,2659775,204,2,4031090,313304,-1371315,1371315,4,1684619
2022-06-07,2156,2213,2156,2189,4483666,96,1741679,168,4,2487114,1996552,-745435,745435,4,2741987
2022-06-08,2163,2232,2163,2199,2276978,90,1089973,120,2,1509051,767927,-419078,419078,3,1187005
2022-06-11,2168,2239,2156,2185,2574347,98,1153703,138,2,1856003,719399,-702300,702300,2,1421699
2022-06-11,2201,2201,2201,2201,1055,98,1153703,138,2,1856003,719399,-702300,702300,2,1421699
2022-06-12,2199,2211,2147,2211,3217308,164,2487476,138,6,1852246,1365062,635230,-635230,4,729832
2022-06-13,2241,2286,2180,2246,4005069,128,3354275,159,4,3646141,358928,-291866,291866,2,650794
2022-06-14,2218,2260,2201,2223,5712456,125,5490886,145,5,2507109,3205347,2983777,-2983777,3,221570
2022-06-15,2282,2282,2189,2213,1704495,87,1251301,103,0,1704495,0,-453194,453194,3,453194
2022-06-18,2213,2213,2161,2178,1345332,99,956162,107,0,1345332,0,-389170,389170,2,389170
2022-06-19,2246,2246,2168,2175,3238434,88,1473374,114,3,2985194,253240,-1511820,1511820,3,1765060
2022-06-20,2173,2211,2152,2189,4424452,137,1826868,139,5,2929999,1494453,-1103131,1103131,5,2597584
2022-06-21,2192,2192,2135,2161,1777158,98,1116808,95,1,1775212,1946,-658404,658404,3,660350
2022-06-22,2159,2163,2128,2152,1827295,111,1629562,109,1,1787203,40092,-157641,157641,4,197733
2022-06-25,2154,2194,2133,2145,1297608,86,1067608,93,0,1297608,0,-230000,230000,1,230000
2022-06-26,2187,2218,2059,2074,2797685,201,2114030,103,5,1930878,866807,183152,-183152,5,683655
2022-06-27,2074,2152,2074,2126,3354144,52,583559,131,4,2191384,1162760,-1607825,1607825,4,2770585
2022-06-28,2156,2171,2119,2159,2954917,133,1996485,129,3,1735572,1219345,260913,-260913,6,958432
2022-06-29,2187,2197,2107,2137,1113687,73,906763,88,5,887354,226333,19409,-19409,4,206924
2022-07-02,2074,2119,2066,2066,1079145,111,1023145,90,0,1079145,0,-56000,56000,1,56000
2022-07-03,2057,2171,2057,2119,2669480,74,341716,122,3,2347530,321950,-2005814,2005814,6,2327764
2022-07-04,2088,2159,2081,2104,2639307,70,888473,84,3,2615628,23679,-1727155,1727155,4,1750834
2022-07-05,2076,2128,2076,2090,2802406,102,1714790,89,4,1387322,1415084,327468,-327468,6,1087616
2022-07-06,2083,2128,2081,2100,1497127,48,725624,87,4,1118053,379074,-392429,392429,2,771503
2022-07-09,2069,2126,2069,2071,2257582,72,465876,101,1,2177582,80000,-1711706,1711706,2,1791706
2022-07-11,2104,2104,2038,2045,3503349,69,581968,122,3,2881569,621780,-2299601,2299601,3,2921381
2022-07-12,2050,2081,2010,2033,4582107,101,1705146,88,5,2953287,1628820,-1248141,1248141,6,2876961
2022-07-13,2026,2071,2010,2022,3650720,149,1915054,76,2,3602664,48056,-1687610,1687610,4,1735666
2022-07-16,2012,2055,1986,2014,2271929,108,1418344,95,3,1396422,875507,21922,-21922,3,853585
2022-07-17,2066,2066,1991,1996,1142033,52,511776,89,3,1045355,96678,-533579,533579,2,630257
2022-07-19,1993,2038,1981,2012,1595560,75,1573075,61,2,953821,641739,619254,-619254,1,22485
2022-07-20,1996,2059,1988,2057,3147027,79,2872178,119,3,2363079,783948,509099,-509099,3,274849
2022-07-23,2078,2107,2052,2071,2237097,130,2188121,144,1,2170788,66309,17333,-17333,1,48976
2022-07-24,2100,2100,1998,2026,2868910,112,2606451,90,4,1789479,1079431,816972,-816972,2,262459
2022-07-25,2010,2059,1946,1960,1792539,102,731634,92,5,788684,1003855,-57050,57050,3,1060905
2022-07-26,2003,2043,1993,2017,5899430,49,309898,123,2,5773272,126158,-5463374,5463374,3,5589532
2022-07-27,2024,2040,1996,2022,715523,58,316407,63,3,394981,320542,-78574,78574,3,399116
2022-07-30,1996,2043,1965,1988,1536398,70,1404680,85,4,1203797,332601,200883,-200883,2,131718
2022-07-31,2007,2007,1915,1953,2216432,86,1435511,94,6,1637257,579175,-201746,201746,4,780921
2022-08-01,1953,2014,1953,1984,1191173,53,372298,73,1,861173,330000,-488875,488875,3,818875
2022-08-02,1951,2031,1951,2000,1787790,36,253135,64,4,1063343,724447,-810208,810208,3,1534655
2022-08-03,1993,2024,1988,2000,1847501,64,1011704,61,2,1046751,800750,-35047,35047,3,835797
2022-08-06,2019,2055,2017,2045,2182011,76,2036924,96,3,1812935,369076,223989,-223989,2,145087
2022-08-09,2055,2090,2007,2040,3222316,282,3117777,104,2,1973815,1248501,1143962,-1143962,1,104539
2022-08-10,2033,2069,2026,2033,708707,53,686419,74,0,708707,0,-22288,22288,1,22288
2022-08-13,2078,2140,2036,2121,3840604,119,3609734,197,2,2882867,957737,726867,-726867,2,230870
2022-08-14,2123,2140,2045,2052,4557918,172,4165406,117,1,2281506,2276412,1883900,-1883900,2,392512
2022-08-15,2033,2095,2033,2085,2308990,95,2103664,110,3,1753972,555018,349692,-349692,2,205326
2022-08-16,2083,2090,2059,2064,2156020,65,1386113,97,3,1651812,504208,-265699,265699,4,769907
2022-08-17,2052,2114,2031,2090,2607250,87,2511297,152,3,2320611,286639,190686,-190686,2,95953
2022-08-20,2038,2092,2038,2085,1834177,42,906599,108,2,1699140,135037,-792541,792541,3,927578
2022-08-21,2085,2085,1951,2062,4371850,122,1647084,94,2,1220032,3151818,427052,-427052,3,2724766
2022-08-22,2092,2109,2048,2064,1745240,74,762262,88,1,1744424,816,-982162,982162,4,982978
2022-08-23,2104,2107,2055,2097,1404496,72,1304496,106,1,1362306,42190,-57810,57810,1,100000
2022-08-24,2097,2135,2088,2135,2623813,97,1877124,142,2,2337333,286480,-460209,460209,5,746689
2022-08-27,2130,2130,2078,2081,4937705,165,2639282,85,5,2914422,2023283,-275140,275140,5,2298423
2022-08-28,2100,2104,2057,2100,2471495,58,1071737,85,3,1905919,565576,-834182,834182,4,1399758
2022-08-29,2119,2119,2062,2085,2051996,111,830115,68,4,1152465,899531,-322350,322350,4,1221881
2022-08-30,2066,2097,2062,2069,1660052,83,823232,74,3,1124855,535197,-301623,301623,4,836820
2022-08-31,2088,2095,2029,2029,3937137,282,2654434,125,2,3101368,835769,-446934,446934,5,1282703
2022-09-07,2080,2085,2029,2065,961932,53,961932,71,0,961932,0,0,0,0,0
2022-09-10,2080,2080,2011,2012,1060505,96,1003999,78,2,819382,241123,184617,-184617,2,56506
2022-09-11,2012,2069,2011,2063,4175186,53,589798,96,3,3484593,690593,-2894795,2894795,5,3585388
2022-09-12,2039,2103,2035,2058,648545,31,276213,55,3,606092,42453,-329879,329879,3,372332
2022-09-13,2068,2089,2053,2055,1081266,55,1050824,45,2,1001354,79912,49470,-49470,1,30442
2022-09-14,2111,2111,1997,2061,1269411,69,1229392,44,4,866191,403220,363201,-363201,2,40019
2022-09-18,2053,2053,2012,2031,1713416,56,1552619,47,3,591590,1121826,961029,-961029,3,160797
2022-09-19,1988,2066,1988,2018,791173,49,632767,49,3,728250,62923,-95483,95483,2,158406
2022-09-20,2025,2047,1993,2012,5462706,40,678167,58,3,787348,4675358,-109181,109181,2,4784539
2022-09-21,1990,2013,1969,1980,3068163,64,853178,41,4,2457243,610920,-1604065,1604065,3,2214985
2022-09-24,1974,1983,1935,1943,1712991,76,1359261,51,4,648854,1064137,710407,-710407,3,353730
2022-09-26,1935,2034,1935,2023,2905984,59,430198,64,1,2866918,39066,-2436720,2436720,5,2475786
2022-09-28,2000,2039,2000,2025,1635690,59,1507238,45,1,1623582,12108,-116344,116344,3,128452
2022-10-01,1972,2034,1942,1962,579999,44,396035,51,2,466335,113664,-70300,70300,3,183964
2022-10-02,2002,2025,1942,2025,1961207,35,387813,74,2,1702765,258442,-1314952,1314952,3,1573394
2022-10-03,1943,2080,1943,2076,8533229,47,779325,146,6,4928700,3604529,-4149375,4149375,4,7753904
2022-10-04,1988,2096,1988,2006,1423512,74,1288743,29,3,257925,1165587,1030818,-1030818,3,134769
2022-10-08,2034,2090,2017,2029,2153892,54,779715,52,2,742911,1410981,36804,-36804,3,1374177
2022-10-09,2029,2029,1969,1979,5645311,35,397305,67,5,1297187,4348124,-899882,899882,3,5248006
2022-10-10,1977,2024,1976,2014,5243689,25,245096,53,8,409636,4834053,-164540,164540,5,4998593
2022-10-11,2020,2048,2016,2034,3678180,41,726936,38,5,396874,3281306,330062,-330062,4,2951244
2022-10-12,2029,2061,2011,2020,4785082,48,518485,69,6,1154224,3630858,-635739,635739,4,4266597
2022-10-15,2003,2059,1896,1986,7856459,159,2233887,86,3,2748030,5108429,-514143,514143,5,5622572
2022-10-16,2015,2015,1915,1942,3493394,75,1429289,60,4,866127,2627267,563162,-563162,4,2064105
2022-10-17,1968,1968,1913,1935,1940155,105,1747839,72,3,1226525,713630,521314,-521314,3,192316
2022-10-18,1953,1953,1930,1930,2338971,89,993720,76,4,889399,1449572,104321,-104321,2,1345251
2022-10-19,1932,1946,1909,1933,3220339,79,1008910,74,3,1143968,2076371,-135058,135058,4,2211429
2022-10-22,1931,1942,1900,1929,3927879,65,1059713,75,2,1259379,2668500,-199666,199666,3,2868166
2022-10-23,1923,1941,1895,1896,1796268,72,1147893,73,1,1792055,4213,-644162,644162,4,648375
2022-10-24,1897,1948,1877,1898,1410876,66,1261786,66,1,1363980,46896,-102194,102194,3,149090
2022-10-25,1877,1943,1877,1877,1310910,79,940265,103,3,1262125,48785,-321860,321860,3,370645
2022-10-26,1895,1895,1826,1849,3587573,91,2495855,92,3,3401700,185873,-905845,905845,4,1091718
2022-10-29,1950,1998,1921,1948,14646813,47,521043,223,4,11618431,3028382,-11097388,11097388,4,14125770
2022-10-30,1959,2043,1959,2043,8817439,57,1115620,117,3,2088958,6728481,-973338,973338,5,7701819
2022-10-31,2066,2071,1995,1999,7903634,79,1277775,88,4,927207,6976427,350568,-350568,4,6625859
2022-11-01,1996,2056,1996,2006,3476864,66,1035618,56,3,861380,2615484,174238,-174238,3,2441246
2022-11-02,1996,2061,1996,2011,1196948,44,549628,77,3,946862,250086,-397234,397234,4,647320
2022-11-05,2051,2123,2002,2112,4677172,92,3074825,132,3,2490757,2269637,584068,-584068,4,1685569
2022-11-06,2057,2112,2057,2062,2201619,81,1794136,120,3,1930787,270832,-136651,136651,3,407483
2022-11-07,2051,2158,2051,2139,2734278,97,2184434,132,4,1993264,741014,191170,-191170,4,549844
2022-11-08,2162,2187,2090,2117,6051834,135,5525627,175,6,3542541,2509293,1983086,-1983086,2,526207
2022-11-09,2068,2208,2067,2146,3304792,98,1488677,122,4,1572372,1732420,-83695,83695,5,1816115
2022-11-12,2095,2187,2095,2136,1586315,63,891349,83,1,1539413,46902,-648064,648064,5,694966
2022-11-13,2136,2182,2085,2094,1400634,69,1107654,74,1,1375859,24775,-268205,268205,4,292980
2022-11-14,2103,2115,2067,2071,2197142,50,1754801,70,3,1679586,517556,75215,-75215,2,442341
2022-11-15,2090,2124,2066,2121,1843630,44,1253984,78,3,1509172,334458,-255188,255188,4,589646
2022-11-16,2127,2131,2083,2125,1554279,51,1211027,62,2,1016672,537607,194355,-194355,3,343252
2022-11-19,2085,2100,2057,2077,1155836,65,433525,55,2,833836,322000,-400311,400311,4,722311
2022-11-20,2130,2171,2103,2133,1881912,50,1343386,82,1,1659242,222670,-315856,315856,2,538526
2022-11-21,2171,2171,2117,2117,1385736,50,929222,65,2,1235274,150462,-306052,306052,4,456514
2022-11-22,2095,2158,2080,2115,2044298,59,1771816,50,3,822840,1221458,948976,-948976,5,272482
2022-11-23,2098,2163,2098,2140,1126681,86,770032,39,2,842987,283694,-72955,72955,3,356649
2022-11-26,2159,2159,2110,2130,875180,58,873015,74,1,490079,385101,382936,-382936,1,2165
2022-11-27,2117,2145,2117,2140,1407621,61,1314558,76,1,1132312,275309,182246,-182246,1,93063
2022-11-28,2160,2163,2138,2142,2962979,61,2146167,76,1,2674917,288062,-528750,528750,2,816812
2022-11-29,2119,2177,2118,2176,3244585,63,1326471,99,1,3081047,163538,-1754576,1754576,3,1918114
2022-11-30,2176,2182,2159,2161,2086053,57,1070153,70,3,1786053,300000,-715900,715900,3,1015900
2022-12-03,2145,2241,2145,2230,2983275,82,1834522,153,2,2770066,213209,-935544,935544,2,1148753
2022-12-04,2242,2284,2210,2284,7313299,148,3945293,227,7,6586396,726903,-2641103,2641103,3,3368006
2022-12-05,2284,2343,2219,2265,2611064,177,2370337,149,3,2142679,468385,227658,-227658,1,240727
2022-12-06,2309,2334,2233,2265,8584645,131,3596872,116,3,7930982,653663,-4334110,4334110,3,4987773
2022-12-07,2221,2306,2221,2279,3407274,81,1717497,133,3,3250469,156805,-1532972,1532972,3,1689777
2022-12-10,2220,2284,2220,2223,3299538,79,987493,96,2,2600187,699351,-1612694,1612694,6,2312045
2022-12-11,2219,2312,2190,2293,2361185,68,1709186,108,2,1801853,559332,-92667,92667,5,651999
2022-12-12,2335,2410,2284,2410,11898116,52,3088593,286,4,4898780,6999336,-1810187,1810187,3,8809523
2022-12-13,2450,2538,2450,2538,13311769,163,12083080,280,8,5128230,8183539,6954850,-6954850,2,1228689
2022-12-14,2635,2635,2515,2580,8349931,227,5412854,315,2,8201696,148235,-2788842,2788842,3,2937077
2022-12-19,2635,2635,2487,2565,2799682,117,1815097,126,2,2738759,60923,-923662,923662,2,984585
2022-12-20,2525,2635,2510,2607,5324441,127,2865971,211,4,4948028,376413,-2082057,2082057,2,2458470
2022-12-21,2658,2704,2566,2667,10153573,127,3841193,221,3,4634488,5519085,-793295,793295,3,6312380
2022-12-24,2723,2815,2644,2815,13521634,193,5449821,321,6,5440842,8080792,8979,-8979,4,8071813
2022-12-25,2931,2982,2852,2922,4285353,219,3708781,243,3,3118053,1167300,590728,-590728,3,576572
2022-12-26,2963,2977,2866,2949,6884674,176,4726242,257,7,4157902,2726772,568340,-568340,4,2158432
2022-12-28,2963,3074,2963,3074,25238909,204,14438909,250,5,6088909,19150000,8350000,-8350000,3,10800000
2022-12-31,2871,3088,2862,2959,10409000,320,6395309,351,3,9954240,454760,-3558931,3558931,8,4013691
2023-01-01,2977,3033,2829,2931,6958538,179,3398900,259,6,5932508,1026030,-2533608,2533608,4,3559638
2023-01-02,2862,3153,2862,3153,19210211,285,11180911,428,8,10712793,8497418,468118,-468118,5,8029300
2023-01-03,3287,3305,3037,3079,5876290,270,5352167,265,3,5181831,694459,170336,-170336,2,524123
2023-01-04,3079,3121,3037,3093,3028771,99,1869985,151,2,2714205,314566,-844220,844220,3,1158786
2023-01-07,2986,3278,2986,3204,12938261,242,6445173,304,6,7352983,5585278,-907810,907810,5,6493088
2023-01-08,3162,3268,3162,3255,10568852,216,3715104,229,4,6360674,4208178,-2645570,2645570,5,6853748
2023-01-09,3241,3268,3084,3268,9078541,187,2195117,228,2,7953285,1125256,-5758168,5758168,4,6883424
2023-01-10,3176,3333,3176,3227,6917271,181,2024809,225,4,6541330,375941,-4516521,4516521,7,4892462
2023-01-11,3227,3227,3111,3185,4564088,151,2421183,209,2,4157992,406096,-1736809,1736809,5,2142905
2023-01-14,3070,3292,3051,3268,5613193,137,3986307,235,2,4981072,632121,-994765,994765,5,1626886
2023-01-16,3319,3333,3273,3315,6087415,168,2566855,269,5,4752798,1334617,-2185943,2185943,5,3520560
2023-01-17,3338,3338,3167,3282,7538655,257,4878054,252,3,6859541,679114,-1981487,1981487,5,2660601
2023-01-18,3218,3282,3171,3250,5729599,146,4599208,170,2,4628346,1101253,-29138,29138,4,1130391
2023-01-21,3190,3231,3093,3158,3873802,182,3255745,120,1,3847212,26590,-591467,591467,5,618057
2023-01-22,3097,3236,3093,3218,2887763,125,1839788,169,3,2734051,153712,-894263,894263,2,1047975
2023-01-23,3268,3268,3074,3130,2691879,142,1454243,140,1,2510876,181003,-1056633,1056633,5,1237636
2023-01-24,3121,3185,3074,3097,3449309,154,2884157,131,2,3286021,163288,-401864,401864,3,565152
2023-01-25,3074,3111,2986,3019,5873082,200,4779603,159,2,5728075,145007,-948472,948472,3,1093479
2023-01-28,3116,3139,2940,2996,4698668,176,2971472,155,2,4155343,543325,-1183871,1183871,3,1727196
2023-01-29,2940,2982,2866,2866,7152465,179,2181625,201,1,7090939,61526,-4909314,4909314,6,4970840
2023-01-30,2774,2945,2774,2945,3254559,125,2387985,174,2,3113560,140999,-725575,725575,3,866574
2023-01-31,2825,3023,2825,2945,2238956,103,2132628,124,2,2173190,65766,-40562,40562,2,106328
2023-02-01,2991,2991,2862,2912,1085647,77,662927,85,2,1020669,64978,-357742,357742,1,422720
2023-02-05,2866,2959,2829,2866,3214728,63,678549,138,3,3130057,84671,-2451508,2451508,4,2536179
2023-02-06,2866,2931,2778,2871,2258944,49,682633,101,5,1998983,259961,-1316350,1316350,5,1576311
2023-02-07,2949,2954,2889,2908,4601111,84,1682863,101,3,4362962,238149,-2680099,2680099,5,2918248
2023-02-08,2839,2922,2839,2876,2483575,69,462792,80,2,2384465,99110,-1921673,1921673,4,2020783
2023-02-12,2889,2917,2829,2894,1159073,41,350742,79,3,1062377,96696,-711635,711635,3,808331
2023-02-13,2885,2894,2857,2862,1148773,50,309478,60,3,1055257,93516,-745779,745779,4,839295
2023-02-14,2788,2899,2788,2871,2591505,31,694699,79,3,2356178,235327,-1661479,1661479,4,1896806
2023-02-15,2834,2889,2834,2862,1642419,28,257749,78,3,1459893,182526,-1202144,1202144,4,1384670
2023-02-19,2829,2889,2829,2866,1529294,50,325349,77,1,1455266,74028,-1129917,1129917,6,1203945
2023-02-20,2825,3014,2825,2982,4598136,120,3165422,132,2,4504952,93184,-1339530,1339530,4,1432714
2023-02-21,2973,3121,2973,3121,15273475,172,6208767,272,7,6042194,9231281,166573,-166573,7,9064708
2023-02-22,3125,3236,2991,3153,8532832,106,4251770,171,3,7151808,1381024,-2900038,2900038,4,4281062
2023-02-25,3310,3324,3144,3324,10107770,59,4417501,191,8,3551999,6555771,865502,-865502,3,5690269
2023-02-26,3490,3490,3389,3453,25184016,262,7701310,384,5,13477979,11706037,-5776669,5776669,10,17482706
2023-02-27,3333,3486,3333,3416,6599128,211,3892465,194,1,6103883,495245,-2211418,2211418,6,2706663
2023-02-28,3389,3458,3389,3412,3679992,143,2321203,136,1,3141667,538325,-820464,820464,8,1358789
2023-03-01,3333,3370,3301,3319,4109745,140,1648768,112,2,3897327,212418,-2248559,2248559,6,2460977
2023-03-04,3375,3375,3278,3305,4422155,94,1747735,106,4,3773650,648505,-2025915,2025915,4,2674420
2023-03-05,3292,3412,3273,3342,1717709,87,675700,102,1,1714609,3100,-1038909,1038909,4,1042009
2023-03-06,3315,3384,3264,3347,2573009,69,690528,102,3,2171698,401311,-1481170,1481170,5,1882481
2023-03-07,3255,3384,3255,3356,5496736,130,2152224,126,2,5281294,215442,-3129070,3129070,8,3344512
2023-03-11,3366,3435,3278,3389,2203377,104,1774638,159,1,2039019,164358,-264381,264381,4,428739
2023-03-12,3315,3366,3245,3273,2389580,100,1157837,127,2,2239817,149763,-1081980,1081980,2,1231743
2023-03-13,3241,3352,3241,3282,1918032,78,603938,177,2,1241945,676087,-638007,638007,5,1314094
2023-03-14,3255,3361,3255,3268,5255104,84,1420230,252,3,1338599,3916505,81631,-81631,5,3834874
2023-03-15,3282,3486,3282,3467,9559949,136,3354647,186,7,2878769,6681180,475878,-475878,5,6205302
2023-03-18,3490,3634,3463,3634,3874243,24,884504,182,3,2161041,1713202,-1276537,1276537,4,2989739
2023-03-19,3694,3703,3629,3652,3240609,117,3065509,108,3,2961905,278704,103604,-103604,1,175100
2023-03-27,3749,3754,3569,3661,3248761,143,2932991,109,2,3052724,196037,-119733,119733,2,315770
2023-03-28,3694,3694,3620,3643,2155902,156,1774352,163,2,1875951,279951,-101599,101599,1,381550
2023-03-29,3698,3745,3560,3694,5845218,164,3825191,194,3,5552005,293213,-1726814,1726814,6,2020027
2023-04-03,3689,3851,3560,3814,6559670,174,3889258,302,3,5278017,1281653,-1388759,1388759,5,2670412
2023-04-04,3842,3934,3814,3934,14676802,258,10048578,345,2,6604311,8062760,3444267,-3444267,2,4618493
2023-04-05,4077,4202,3930,4202,22963210,403,15368506,294,6,9124394,13838816,6244112,-6244112,8,7594704
2023-04-08,4323,4475,4253,4475,15417423,471,6967965,356,7,8678742,6738681,-1710777,1710777,10,8449458
2023-04-09,4609,4614,4272,4577,10448873,403,7144927,366,5,9577203,871670,-2432276,2432276,5,3303946
2023-04-10,4623,4780,4369,4494,19122025,427,7801148,418,8,10666651,8455374,-2865503,2865503,7,11320877
2023-04-11,4568,4785,4494,4729,19188758,308,2960485,362,7,11917497,7271261,-8957012,8957012,4,16228273
2023-04-15,4803,5025,4803,4988,11201478,364,6010056,298,8,3874065,7327413,2135991,-2135991,7,5191422
2023-04-16,5224,5224,4808,4988,18915671,512,10876993,351,6,8268849,10646822,2608144,-2608144,6,8038678
2023-04-17,5034,5085,4836,5085,35128538,422,6276461,528,9,20004032,15124506,-13727571,13727571,11,28852077
2023-05-01,5103,5294,5000,5054,25830710,716,24375743,326,8,10129219,15701491,14246524,-14246524,4,1454967
2023-05-02,5216,5216,4946,4995,24187086,1016,20378521,556,3,12676718,11510368,7701803,-7701803,9,3808565
2023-05-03,5069,5069,4785,5015,22454002,782,9711240,568,4,17861375,4592627,-8150135,8150135,8,12742762
2023-05-06,5186,5186,4922,4951,18954907,761,11221554,372,4,8889831,10065076,2331723,-2331723,7,7733353
2023-05-07,4937,5083,4643,4643,24839955,434,5264413,436,4,11572088,13267867,-6307675,6307675,10,19575542
2023-05-08,4359,4359,4359,4359,6580867,170,666758,163,1,6239390,341477,-5572632,5572632,3,5914109
2023-05-09,4202,4662,4197,4608,7924550,309,4731617,454,2,7638584,285966,-2906967,2906967,6,3192933
2023-05-10,4697,4697,4138,4138,11784853,366,6271518,297,3,5312323,6472530,959195,-959195,5,5513335
2023-05-13,3908,4124,3893,3893,19961215,321,4874224,259,4,4728847,15232368,145377,-145377,8,15086991
2023-05-14,3732,4070,3732,3991,18137849,468,12907470,211,3,4405930,13731919,8501540,-8501540,6,5230379
2023-05-15,4084,4099,3820,3982,11878235,464,8772206,221,6,5693989,6184246,3078217,-3078217,8,3106029
2023-05-17,3982,4099,3937,4084,5605012,243,5305066,218,2,4948106,656906,356960,-356960,3,299946
2023-05-20,4089,4138,3913,3928,4332616,211,3157735,228,4,4056667,275949,-898932,898932,5,1174881
2023-05-21,3942,4089,3928,4040,3323085,189,2984931,158,2,2726420,596665,258511,-258511,3,338154
2023-05-22,4128,4222,4021,4119,4063361,211,3950415,248,2,3745767,317594,204648,-204648,2,112946
2023-05-23,4163,4212,4050,4104,3195076,197,2782462,165,4,2286736,908340,495726,-495726,2,412614
2023-05-24,4060,4212,4060,4084,2519840,165,2273482,195,3,2320268,199572,-46786,46786,1,246358
2023-05-27,4192,4192,3991,4021,2734930,124,2215522,216,3,2528931,205999,-313409,313409,2,519408
2023-05-28,3957,3986,3830,3982,3461736,188,2966221,184,2,2239840,1221896,726381,-726381,3,495515
2023-05-29,3840,4084,3840,4016,2951024,140,1627138,144,1,2846335,104689,-1219197,1219197,5,1323886
2023-05-30,3898,4104,3898,4016,2125743,111,1767342,148,4,1451549,674194,315793,-315793,3,358401
2023-05-31,4158,4158,3908,3996,2766573,113,1177515,142,4,2186378,580195,-1008863,1008863,2,1589058
2023-06-03,3903,4055,3903,4016,2242546,84,833185,124,2,1784629,457917,-951444,951444,1,1409361
2023-06-06,4011,4060,3977,4045,3248918,113,2328408,137,2,3024239,224679,-695831,695831,4,920510
2023-06-07,4089,4192,4016,4031,2465484,98,1777886,162,1,2327372,138112,-549486,549486,3,687598
2023-06-10,3879,3928,3791,3879,3623426,129,2054674,177,3,2194773,1428653,-140099,140099,5,1568752
2023-06-11,4040,4040,3830,3937,7427067,115,1313257,207,3,2260875,5166192,-947618,947618,4,6113810
2023-06-12,3937,3952,3707,3879,2832161,148,1597755,158,2,2776077,56084,-1178322,1178322,2,1234406
2023-06-13,3879,3967,3820,3918,1468018,62,1053861,75,2,1180154,287864,-126293,126293,2,414157
2023-06-14,4021,4026,3869,3889,1309109,88,960008,84,3,1156537,152572,-196529,196529,2,349101
2023-06-17,3918,3937,3820,3884,2720563,91,2320109,145,2,2316988,403575,3121,-3121,3,400454
2023-06-18,3874,3957,3795,3840,4343814,74,2179576,112,6,2685594,1658220,-506018,506018,3,2164238
2023-06-19,3962,3962,3795,3844,2226499,111,1136931,106,3,1974305,252194,-837374,837374,3,1089568
2023-06-20,3732,3947,3732,3903,1562627,47,1500561,109,3,1037740,524887,462821,-462821,1,62066
2023-06-21,3918,3952,3791,3849,3118354,118,2928885,96,4,2849263,269091,79622,-79622,1,189469
2023-06-24,3937,3937,3791,3815,520971,102,428874,68,4,490881,30090,-62007,62007,1,92097
2023-06-25,3913,3913,3786,3869,2261006,65,527243,57,1,504974,68879,22269,-22269,2,46610
2023-06-26,3791,3933,3791,3918,2906577,55,2888825,124,3,2759766,146811,129059,-129059,1,17752
2023-06-27,3957,3957,3800,3810,1283329,118,989737,79,4,994316,289013,-4579,4579,1,293592
2023-06-28,3786,3849,3786,3835,509762,63,330460,56,2,478736,31026,-148276,148276,1,179302
2023-07-01,3835,3933,3810,3825,739283,63,429261,70,1,678391,60892,-249130,249130,2,310022
2023-07-02,3786,3918,3786,3918,3244841,140,3046725,117,1,2706028,538813,340697,-340697,3,198116
2023-07-03,3903,3918,3830,3908,1259895,98,1025557,88,2,911613,348282,113944,-113944,3,234338
2023-07-04,3835,4060,3805,3942,7349576,408,7148660,173,2,3386790,3962786,3761870,-3761870,3,200916
2023-07-05,4001,4001,3908,3928,2815137,197,2770235,105,2,2108200,706937,662035,-662035,1,44902
2023-07-08,3991,3991,3844,3874,1676941,174,1594508,109,1,1626370,50571,-31862,31862,1,82433
2023-07-09,3835,3874,3732,3815,5229477,260,3067694,76,2,1309894,3919583,1757800,-1757800,4,2161783
2023-07-10,3732,3805,3732,3761,1844287,102,815913,90,2,1401067,443220,-585154,585154,5,1028374
2023-07-11,3732,3751,3663,3678,7997308,174,1645693,114,2,7851614,145694,-6205921,6205921,6,6351615
2023-07-12,3658,3658,3575,3634,2103085,134,1172045,114,2,1761701,341384,-589656,589656,4,931040
2023-07-15,3595,3712,3585,3624,2488133,129,1487196,111,2,1935072,553061,-447876,447876,4,1000937
2023-07-16,3585,3585,3526,3541,1344811,100,833276,108,2,1222098,122713,-388822,388822,5,511535
2023-07-17,3516,3541,3443,3526,5485152,138,1637781,129,4,5098342,386810,-3460561,3460561,6,3847371
2023-07-18,3585,3663,3462,3536,3938498,223,3328536,94,1,3683236,255262,-354700,354700,3,609962
2023-07-19,3521,3619,3507,3511,5657816,245,4619074,210,4,4856911,800905,-237837,237837,2,1038742
2023-07-22,3467,3467,3340,3394,2313537,131,1371563,58,3,933196,1380341,438367,-438367,4,941974
2023-07-23,3418,3477,3330,3443,909046,102,883493,78,2,789046,120000,94447,-94447,1,25553
2023-07-24,3384,3541,3384,3418,2499047,134,1995288,83,2,2264214,234833,-268926,268926,3,503759
2023-07-25,3404,3516,3379,3487,3874532,156,3485076,113,4,3196106,678426,288970,-288970,3,389456
2023-07-26,3477,3492,3438,3467,1103591,68,979264,62,2,727579,376012,251685,-251685,2,124327
2023-07-29,3467,3482,3413,3443,1715003,54,1664862,64,2,1412760,302243,252102,-252102,2,50141
2023-07-30,3472,3472,3379,3399,1547473,63,1415753,73,1,1525435,22038,-109682,109682,2,131720
2023-07-31,3477,3477,3394,3418,1478861,66,1332083,64,2,895712,583149,436371,-436371,2,146778
2023-08-01,3477,3477,3399,3443,3657360,125,3041771,60,2,1728339,1929021,1313432,-1313432,3,615589
2023-08-05,3428,3546,3428,3502,2001818,139,1747288,105,2,1472145,529673,275143,-275143,2,254530
2023-08-06,3458,3487,3433,3477,1218088,51,1203532,72,2,885331,332757,318201,-318201,1,14556
2023-08-07,3458,3502,3438,3467,1405118,75,1391143,94,2,1097304,307814,293839,-293839,1,13975
2023-08-08,3458,3511,3448,3453,734029,58,645152,51,2,630775,103254,14377,-14377,1,88877
2023-08-09,3526,3526,3438,3443,875223,44,825733,35,2,725083,150140,100650,-100650,1,49490
2023-08-12,3423,3423,3340,3364,1155118,44,1053371,76,1,1117803,37315,-64432,64432,2,101747
2023-08-13,3364,3423,3311,3340,3828470,118,2886973,53,2,2572870,1255600,314103,-314103,3,941497
2023-08-14,3379,3413,3345,3369,1044012,90,986306,55,1,870232,173780,116074,-116074,1,57706
2023-08-15,3350,3364,3296,3325,1271298,71,505054,62,1,1243649,27649,-738595,738595,3,766244
2023-08-16,3369,3369,3291,3320,534584,61,453367,50,1,419176,115408,34191,-34191,1,81217
2023-08-19,3379,3379,3271,3301,677987,84,513466,47,3,539291,138696,-25825,25825,2,164521
2023-08-20,3325,3443,3281,3413,1735799,32,556390,103,1,1617831,117968,-1061441,1061441,2,1179409
2023-08-21,3271,3433,3271,3379,1478600,38,191038,62,2,1444185,34415,-1253147,1253147,3,1287562
2023-08-22,3330,3399,3281,3306,705941,42,557853,45,2,532466,173475,25387,-25387,1,148088
2023-08-23,3389,3394,3316,3379,702039,55,589650,41,1,442002,260037,147648,-147648,1,112389
2023-08-26,3384,3497,3355,3497,1494237,93,1371701,80,2,1115916,378321,255785,-255785,4,122536
2023-08-27,3433,3614,3413,3477,2424613,86,2323315,128,2,2075181,349432,248134,-248134,2,101298
2023-08-28,3624,3624,3448,3462,3080336,104,2997076,85,0,3080336,0,-83260,83260,2,83260
2023-08-29,3560,3560,3462,3487,1531692,55,1376057,74,1,1372457,159235,3600,-3600,4,155635
2023-08-30,3477,3546,3428,3453,2078656,82,1850889,74,4,630877,1447779,1220012,-1220012,3,227767
2023-09-02,3492,3516,3477,3507,1542509,49,1458303,80,3,839438,703071,618865,-618865,3,84206
2023-09-03,3516,3516,3438,3462,964254,62,780830,61,2,794533,169721,-13703,13703,2,183424
2023-09-04,3453,3526,3443,3526,1364831,60,1230602,80,1,1035986,328845,194616,-194616,3,134229
2023-09-05,3477,3575,3477,3536,2055291,73,2028741,93,3,1710261,345030,318480,-318480,2,26550
2023-09-09,3526,3600,3511,3546,1638978,48,1503523,120,1,1270351,368627,233172,-233172,2,135455
2023-09-10,3492,3551,3492,3511,1008386,42,904341,66,0,1008386,0,-104045,104045,2,104045
2023-09-11,3511,3546,3487,3531,1632646,59,1625436,59,1,679085,953561,946351,-946351,1,7210
2023-09-12,3531,3565,3492,3546,1553819,52,1553819,67,0,1553819,0,0,0,0,0
2023-09-13,3565,3565,3477,3526,1239965,80,1083310,49,0,1239965,0,-156655,156655,2,156655
2023-09-17,3551,3624,3497,3595,8604763,163,8567893,128,3,3380185,5224578,5187708,-5187708,1,36870
2023-09-18,3619,3619,3516,3526,1956890,85,1909371,77,0,1956890,0,-47519,47519,1,47519
2023-09-19,3526,3565,3502,3551,1122063,49,1014170,63,0,1122063,0,-107893,107893,2,107893
2023-09-20,3516,3516,3438,3502,620674,50,620674,46,0,620674,0,0,0,0,0
2023-09-23,3453,3521,3443,3502,634723,44,307316,44,0,634723,0,-327407,327407,3,327407
2023-09-25,3477,3551,3443,3458,1403821,77,1128823,63,0,1403821,0,-274998,274998,2,274998
2023-09-26,3433,3507,3428,3467,942337,81,517195,49,0,942337,0,-425142,425142,3,425142
2023-09-27,3369,3404,3271,3296,25510861,686,16160004,467,6,19039143,6471718,-2879139,2879139,8,9350857
2023-09-30,3301,3364,3203,3252,10787987,385,7688270,350,2,10262569,525418,-2574299,2574299,10,3099717
2023-10-01,3208,3271,3198,3237,6735324,131,3347529,247,1,4749208,1986116,-1401679,1401679,9,3387795
2023-10-02,3218,3306,3203,3232,10732567,209,5713237,212,7,7416238,3316329,-1703001,1703001,4,5019330
2023-10-04,3316,3320,3242,3281,9056467,148,5585218,202,3,5556467,3500000,28751,-28751,2,3471249
2023-10-07,3247,3281,3208,3232,6966439,95,3038684,192,2,6658259,308180,-3619575,3619575,8,3927755
2023-10-08,3203,3252,3095,3144,6813348,137,3889991,196,5,6537635,275713,-2647644,2647644,7,2923357
2023-10-09,3120,3232,3076,3203,7437556,95,2203440,216,3,6798851,638705,-4595411,4595411,5,5234116
2023-10-10,3105,3232,3105,3213,6828474,111,2455322,147,4,4731870,2096604,-2276548,2276548,5,4373152
2023-10-11,3213,3222,3129,3164,5114401,95,2496399,105,4,2934872,2179529,-438473,438473,4,2618002
2023-10-14,3159,3169,3085,3105,3204076,69,868573,115,2,3183142,20934,-2314569,2314569,7,2335503
2023-10-15,3061,3159,3061,3090,3290530,86,1325054,102,2,2480530,810000,-1155476,1155476,5,1965476
2023-10-16,3105,3193,3066,3183,4489069,53,995766,134,4,4074276,414793,-3078510,3078510,5,3493303
2023-10-17,3173,3198,3173,3188,4672410,40,331106,118,3,2777203,1895207,-2446097,2446097,3,4341304
2023-10-18,3169,3178,3120,3134,5176475,42,759306,89,0,5176475,0,-4417169,4417169,3,4417169
2023-10-21,3125,3154,3115,3154,3040838,79,1045296,103,1,2629908,410930,-1584612,1584612,4,1995542
2023-10-22,3144,3164,3120,3120,5047585,80,1925091,98,1,5038976,8609,-3113885,3113885,8,3122494
2023-10-23,3115,3125,3085,3085,2684278,86,1946649,82,0,2684278,0,-737629,737629,4,737629
2023-10-24,3080,3105,3051,3056,1845914,75,1577898,99,1,1737467,108447,-159569,159569,2,268016
2023-10-25,3046,3134,3046,3120,5484163,59,1935451,91,2,4592610,891553,-2657159,2657159,4,3548712
2023-10-28,3061,3066,2973,2997,4043263,101,2913000,112,2,4012945,30318,-1099945,1099945,7,1130263
2023-10-29,3012,3061,2997,3036,1656076,69,1289004,86,0,1656076,0,-367072,367072,2,367072
2023-10-30,3046,3105,3046,3071,3645988,85,1218019,102,2,3143446,502542,-1925427,1925427,8,2427969
2023-10-31,3085,3100,3036,3051,2424993,83,1424052,90,2,2127071,297922,-703019,703019,7,1000941
2023-11-01,3051,3080,3041,3076,3704039,24,712892,140,1,3580604,123435,-2867712,2867712,3,2991147
2023-11-04,3051,3169,3051,3139,2166691,41,597277,119,4,1658580,508111,-1061303,1061303,2,1569414
2023-11-05,3159,3159,3095,3129,3923856,51,1489663,70,3,1126901,2796955,362762,-362762,3,2434193
2023-11-06,3129,3159,3115,3129,3733746,71,2237188,86,3,2130609,1603137,106579,-106579,3,1496558
2023-11-07,3120,3213,3120,3188,3021891,71,2052800,161,0,3021891,0,-969091,969091,3,969091
2023-11-08,3232,3232,3125,3129,6795084,83,4035058,96,5,3501941,3293143,533117,-533117,5,2760026
2023-11-11,3193,3203,3105,3115,9070689,92,5826824,102,4,6301534,2769155,-474710,474710,4,3243865
2023-11-12,3183,3208,3125,3183,5030169,85,2911761,123,5,2646071,2384098,265690,-265690,4,2118408
2023-11-13,3154,3208,3134,3154,3318170,98,1805920,89,4,1552552,1765618,253368,-253368,3,1512250
2023-11-14,3154,3183,3110,3129,7952813,112,6451128,67,3,6405705,1547108,45423,-45423,4,1501685
2023-11-15,3139,3144,3110,3115,8251024,127,6819603,74,5,5948990,2302034,870613,-870613,6,1431421
2023-11-18,3125,3154,3105,3105,4282443,79,3329592,67,3,3050976,1231467,278616,-278616,6,952851
2023-11-19,3105,3139,3085,3129,3587504,100,1935393,105,2,3287504,300000,-1352111,1352111,5,1652111
2023-11-20,3095,3125,3080,3095,2179313,66,1079985,93,3,1539138,640175,-459153,459153,3,1099328
2023-11-21,3125,3144,3100,3110,4922832,80,2166627,77,4,1885380,3037452,281247,-281247,7,2756205
2023-11-22,3115,3144,3095,3100,3383838,75,988951,67,3,1699161,1684677,-710210,710210,5,2394887
2023-11-25,3129,3173,3105,3125,3459405,62,2393529,119,3,1627503,1831902,766026,-766026,6,1065876
2023-11-26,3144,3188,3115,3115,3661136,89,2349339,98,3,1743173,1917963,606166,-606166,5,1311797
2023-11-27,3178,3178,3085,3085,5408980,106,3391824,72,3,3947556,1461424,-555732,555732,4,2017156
2023-11-28,3149,3154,3115,3125,5355377,57,750676,83,4,1264031,4091346,-513355,513355,6,4604701
2023-11-29,3134,3257,3134,3218,7117466,120,6766222,166,5,3176530,3940936,3589692,-3589692,3,351244
2023-12-02,3257,3345,3232,3247,5936519,125,5104276,186,4,3907312,2029207,1196964,-1196964,4,832243
2023-12-03,3281,3394,3227,3374,11589767,178,10320177,207,5,5136645,6453122,5183532,-5183532,4,1269590
2023-12-04,3394,3482,3394,3433,23490494,233,16351535,267,5,11551228,11939266,4800307,-4800307,10,7138959
2023-12-05,3462,3511,3413,3423,9472301,195,8268120,189,6,4117258,5355043,4150862,-4150862,6,1204181
2023-12-06,3428,3462,3379,3428,8333048,189,6532285,147,6,3831679,4502906,2700606,-2700606,11,1802300
2023-12-09,3423,3492,3389,3423,4580654,121,3133716,150,3,3152302,1428352,-18586,18586,5,1446938
2023-12-10,3384,3472,3379,3428,3165188,71,1426891,126,4,2223906,941282,-797015,797015,4,1738297
2023-12-11,3389,3448,3389,3423,4128863,52,2310093,98,6,2362037,1766826,-51944,51944,4,1818770
2023-12-12,3399,3458,3389,3423,3199290,71,1661780,100,2,3067280,132010,-1405500,1405500,6,1537510
2023-12-13,3404,3443,3379,3404,3984509,68,2042272,78,2,3445952,538557,-1403680,1403680,2,1942237
2023-12-16,3438,3477,3404,3467,4003643,84,3874626,128,2,2713458,1290185,1161168,-1161168,2,129017
2023-12-18,3487,3580,3487,3521,6249226,144,5724543,217,5,3889619,2359607,1834924,-1834924,2,524683
2023-12-19,3502,3570,3487,3502,2981866,83,2539765,123,6,2094154,887712,445611,-445611,3,442101
2023-12-20,3497,3560,3492,3507,3945168,71,2187544,110,4,3439292,505876,-1251748,1251748,6,1757624
2023-12-23,3497,3585,3482,3502,6190343,89,3695553,97,6,5566689,623654,-1871136,1871136,5,2494790
2023-12-24,3492,3521,3458,3482,7001459,100,3467427,91,3,1322808,5678651,2144619,-2144619,4,3534032
2023-12-25,3487,3516,3472,3477,3611004,61,1251446,84,1,3576155,34849,-2324709,2324709,5,2359558
2023-12-26,3477,3497,3462,3462,5386180,57,2261615,114,3,4707357,678823,-2445742,2445742,3,3124565
2023-12-27,3467,3526,3467,3507,3827915,49,1875634,133,4,3360438,467477,-1484804,1484804,2,1952281
2023-12-30,3502,3575,3502,3526,2571340,67,2486877,108,2,2100909,470431,385968,-385968,1,84463
2023-12-31,3497,3546,3492,3521,2727966,42,1387204,95,2,2545112,182854,-1157908,1157908,2,1340762
2024-01-01,3502,3536,3472,3477,8785466,72,2859796,104,6,1509063,7276403,1350733,-1350733,3,5925670
2024-01-02,3531,3531,3462,3462,1896214,51,1656357,87,1,1743619,152595,-87262,87262,3,239857
2024-01-03,3472,3497,3462,3467,1603058,51,1269108,77,0,1603058,0,-333950,333950,5,333950
2024-01-06,3458,3492,3404,3428,6337339,111,4585486,88,1,6299564,37775,-1714078,1714078,2,1751853
2024-01-07,3428,3443,3404,3433,3541505,125,2796155,101,3,3444169,97336,-648014,648014,3,745350
2024-01-08,3423,3453,3404,3423,2605810,64,1876623,87,3,2191358,414452,-314735,314735,2,729187
2024-01-09,3413,3453,3409,3418,2630702,72,1292825,67,2,2592653,38049,-1299828,1299828,2,1337877
2024-01-10,3428,3467,3428,3462,3672971,67,2435224,97,3,3311126,361845,-875902,875902,3,1237747
2024-01-13,3433,3472,3433,3443,2629948,59,1975847,126,4,2573708,58247,-597861,597861,3,656108
2024-01-14,3448,3497,3433,3458,3257016,88,2683250,100,3,1852519,1404497,830731,-830731,2,573766
2024-01-15,3453,3477,3428,3443,2331809,50,1884253,77,2,1277179,1054630,607074,-607074,2,447556
2024-01-16,3458,3462,3418,3423,3545363,33,767462,80,2,3243363,302000,-2475901,2475901,4,2777901
2024-01-17,3428,3443,3413,3443,1971423,50,1009684,90,1,1968571,2852,-958887,958887,4,961739
2024-01-20,3428,3462,3384,3384,3231967,62,2133632,104,2,3190461,41506,-1056829,1056829,3,1098335
2024-01-21,3379,3399,3330,3384,2551473,90,1496619,80,1,2420556,130917,-923937,923937,4,1054854
2024-01-22,3404,3404,3345,3369,4286092,68,2411847,81,2,4193442,92650,-1781595,1781595,4,1874245
2024-01-23,3374,3399,3291,3325,4814346,77,2224917,109,1,3920496,893850,-1695579,1695579,5,2589429
2024-01-24,3296,3399,3296,3399,2071641,56,1529564,75,3,1599449,472192,-69885,69885,3,542077
2024-01-27,3306,3379,3306,3350,2002352,63,1407260,68,4,1511644,490708,-104384,104384,4,595092
2024-01-28,3374,3399,3345,3374,4769670,73,2056474,87,4,1581057,3188613,475417,-475417,3,2713196
2024-01-29,3394,3394,3325,3330,2097422,83,1500347,60,2,1870107,227315,-369760,369760,3,597075
2024-01-30,3330,3355,3301,3320,2145336,70,1661544,87,3,1831694,313642,-170150,170150,2,483792
2024-01-31,3330,3335,3271,3286,4526277,119,3393338,82,2,975830,3550447,2417508,-2417508,3,1132939
2024-02-03,3281,3355,3267,3311,7407964,110,6270760,93,3,3340053,4067911,2930707,-2930707,2,1137204
2024-02-04,3374,3374,3296,3306,2564295,52,2261717,88,2,2333437,230858,-71720,71720,3,302578
2024-02-05,3345,3355,3267,3325,4123820,85,2270846,90,2,3877063,246757,-1606217,1606217,4,1852974
2024-02-06,3316,3340,3301,3316,2367909,34,637136,70,2,2041221,326688,-1404085,1404085,4,1730773
2024-02-07,3296,3360,3291,3360,2085982,31,1174746,87,2,1834632,251350,-659886,659886,2,911236
2024-02-10,3360,3399,3340,3384,2321071,51,1898256,105,2,2171137,149934,-272881,272881,1,422815
2024-02-12,3345,3413,3340,3384,3017050,31,2866375,105,1,2897050,120000,-30675,30675,1,150675
2024-02-13,3384,3413,3369,3404,7209075,49,6334752,96,2,2596425,4612650,3738327,-3738327,2,874323
2024-02-14,3389,3404,3330,3389,5453687,44,1640908,134,2,5202888,250799,-3561980,3561980,3,3812779
2024-02-17,3379,3448,3355,3399,11162816,62,4453427,164,5,10303915,858901,-5850488,5850488,3,6709389
2024-02-18,3379,3438,3379,3433,14767596,55,5515800,87,5,5381457,9386139,134343,-134343,3,9251796
2024-02-19,3418,3467,3379,3453,11471311,72,1940614,116,6,6376635,5204118,-4436021,4436021,5,9640139
2024-02-20,3428,3580,3418,3541,19460362,151,4405653,221,7,18843020,617342,-14437367,14437367,4,15054709
2024-02-21,3560,3663,3531,3649,18482082,195,6883094,244,4,12281486,6200596,-5398392,5398392,6,11598988
2024-02-24,3649,3668,3575,3595,3638176,123,2438756,167,4,3196083,442093,-757327,757327,3,1199420
2024-02-26,3619,3619,3467,3482,7515693,94,1958466,106,3,7179011,336682,-5220545,5220545,6,5557227
2024-02-27,3438,3565,3438,3565,2443728,40,283588,110,2,2264472,179256,-1980884,1980884,4,2160140
2024-02-28,3570,3570,3541,3560,3257816,38,704886,95,2,1527144,1730672,-822258,822258,3,2552930
2024-03-02,3453,3683,3453,3624,4866396,98,3597656,144,4,2902496,1963900,695160,-695160,2,1268740
2024-03-03,3668,3727,3575,3688,8619002,97,5609033,185,3,6746417,1872585,-1137384,1137384,2,3009969
2024-03-04,3693,3766,3570,3693,5297350,62,1579088,136,4,3328070,1969280,-1748982,1748982,2,3718262
2024-03-05,3653,3742,3629,3693,6426275,68,2401162,132,3,3930758,2495517,-1529596,1529596,3,4025113
2024-03-06,3698,3820,3678,3771,10082593,68,1866627,203,4,5942192,4140401,-4075565,4075565,2,8215966
2024-03-09,3815,3815,3737,3776,2968731,75,1569263,156,2,2567930,400801,-998667,998667,2,1399468
2024-03-10,3746,3781,3727,3771,6325657,61,584776,161,2,3405090,2920567,-2820314,2820314,2,5740881
2024-03-11,3737,3893,3649,3869,8751924,81,1575070,237,4,6800602,1951322,-5225532,5225532,3,7176854
2024-03-12,3869,3903,3830,3869,6669976,64,866097,153,7,5109914,1560062,-4243817,4243817,3,5803879
2024-03-13,3869,3869,3595,3791,3293185,69,2157283,132,2,2889185,404000,-731902,731902,1,1135902
2024-03-16,3795,3795,3639,3722,4824446,72,2134319,104,2,4624446,200000,-2490127,2490127,2,2690127
2024-03-17,3781,3795,3683,3795,6025867,88,1950576,114,3,3762802,2263065,-1812226,1812226,3,4075291
2024-03-18,3771,3815,3702,3786,1574774,65,1134642,54,1,1463485,111289,-328843,328843,2,440132
2024-03-24,3786,3893,3786,3874,3412682,71,1812289,100,2,2112682,1300000,-300393,300393,1,1600393
2024-03-25,3893,3952,3805,3840,5530788,83,2959251,106,3,5400938,129850,-2441687,2441687,3,2571537
2024-03-26,3918,3918,3805,3835,2722660,40,398863,90,3,2411275,311385,-2012412,2012412,2,2323797
2024-03-27,3820,3893,3810,3825,3401386,58,1253896,83,2,1301386,2100000,-47490,47490,3,2147490
2024-03-30,3786,3869,3786,3805,1165529,41,840276,73,0,1165529,0,-325253,325253,1,325253
2024-04-02,3771,3800,3727,3786,1347927,50,714265,90,0,1347927,0,-633662,633662,1,633662
2024-04-03,3756,3884,3756,3805,2308066,48,1143271,81,2,1779953,528113,-636682,636682,3,1164795
2024-04-06,3727,3869,3688,3737,6863194,44,746380,116,2,6320409,542785,-5574029,5574029,4,6116814
2024-04-07,3751,3795,3751,3791,7488469,47,1090492,105,3,5778469,1710000,-4687977,4687977,5,6397977
2024-04-08,3810,3840,3737,3776,4064686,68,1754249,68,1,3214686,850000,-1460437,1460437,2,2310437
2024-04-09,3771,3805,3771,3786,7623891,58,2822944,67,2,2557623,5066268,265321,-265321,4,4800947
2024-04-13,3791,3791,3698,3707,14491374,43,811170,169,4,10097035,4394339,-9285865,9285865,4,13680204
2024-04-14,3688,3722,3688,3688,24164565,56,830741,239,4,12683447,11481118,-11852706,11852706,3,23333824
2024-04-15,3712,3727,3712,3727,6846401,178,6137337,90,3,2324541,4521860,3812796,-3812796,1,709064
2024-04-22,3968,3968,3742,3753,4526627,124,4519462,126,1,4516627,10000,2835,-2835,1,7165
2024-04-23,3855,3855,3715,3715,2934005,97,2534005,87,2,2348884,585121,185121,-185121,1,400000
2024-04-24,3726,3732,3694,3721,1614538,76,1520077,60,2,1130404,484134,389673,-389673,1,94461
2024-04-27,3737,3742,3613,3618,3167319,142,1908836,73,0,3167319,0,-1258483,1258483,3,1258483
2024-04-28,3608,3683,3565,3597,1538081,79,1056181,55,0,1538081,0,-481900,481900,2,481900
2024-04-29,3667,3699,3640,3645,2960935,68,729595,84,1,2925367,35568,-2195772,2195772,1,2231340
2024-04-30,3618,3694,3608,3667,11886111,35,1649112,98,3,7807463,4078648,-6158351,6158351,1,10236999
2024-05-01,3672,3705,3672,3699,1813998,32,662973,73,2,1624171,189827,-961198,961198,2,1151025
2024-05-05,3678,3699,3656,3662,2146859,29,580953,54,3,1509038,637821,-928085,928085,3,1565906
2024-05-06,3678,3683,3608,3662,2711190,32,686344,80,0,2711190,0,-2024846,2024846,3,2024846
2024-05-07,3672,3688,3635,3683,1844762,28,446626,84,1,1727200,117562,-1280574,1280574,3,1398136
2024-05-08,3694,3705,3624,3651,1517229,26,331594,63,3,1329300,187929,-997706,997706,2,1185635
2024-05-11,3667,3667,3592,3608,1145879,49,849802,66,0,1145879,0,-296077,296077,1,296077
2024-05-12,3667,3667,3543,3543,3096484,70,845740,78,3,2356088,740396,-1510348,1510348,3,2250744
2024-05-13,3662,3662,3554,3554,4578067,44,374111,83,1,4578067,0,-4203956,4203956,3,4203956
2024-05-14,3629,3662,3586,3635,1666798,22,836883,81,0,1666798,0,-829915,829915,3,829915
2024-05-15,3629,3715,3565,3662,2342199,51,831440,84,1,1588177,754022,-756737,756737,4,1510759
2024-05-18,3629,3688,3575,3581,1685619,57,1023325,58,3,1251557,434062,-228232,228232,4,662294
2024-05-19,3602,3629,3452,3484,4765012,68,1293397,80,2,4031782,733230,-2738385,2738385,4,3471615
2024-05-21,3586,3608,3565,3575,1206859,31,754529,43,2,1171794,35065,-417265,417265,3,452330
2024-05-25,3586,3586,3516,3538,2331465,48,723576,66,1,2312974,18491,-1589398,1589398,3,1607889
2024-05-26,3570,3570,3505,3505,3444082,38,526120,62,5,3288602,155480,-2762482,2762482,3,2917962
2024-05-27,3495,3505,3495,3495,4096492,46,742218,43,3,3952493,143999,-3210275,3210275,7,3354274
2024-05-28,3522,3554,3478,3543,2243165,54,1374349,51,1,2241345,1820,-866996,866996,3,868816
2024-05-29,3538,3581,3532,3581,3416701,40,3285884,30,1,3326333,90368,-40449,40449,2,130817
2024-06-01,3543,3548,3473,3478,886907,48,476410,39,4,864305,22602,-387895,387895,1,410497
2024-06-02,3532,3543,3468,3484,3826074,47,603482,49,2,2555188,1270886,-1951706,1951706,7,3222592
2024-06-05,3522,3522,3452,3452,721947,35,308889,36,2,513811,208136,-204922,204922,2,413058
2024-06-08,3446,3452,3446,3446,4015496,25,740070,43,2,3599955,415541,-2859885,2859885,3,3275426
2024-06-09,3489,3505,3441,3462,2472525,17,394649,49,3,2216525,256000,-1821876,1821876,4,2077876
2024-06-10,3489,3505,3452,3500,1217669,36,418695,31,0,1217669,0,-798974,798974,2,798974
2024-06-11,3425,3527,3425,3484,1732489,24,283893,57,4,1716869,15620,-1432976,1432976,2,1448596
2024-06-12,3489,3522,3446,3511,2024401,12,33867,39,4,582827,1441574,-548960,548960,3,1990534
2024-06-15,3489,3489,3446,3452,1233145,10,438123,42,0,1233145,0,-795022,795022,3,795022
2024-06-16,3425,3516,3419,3446,1917214,16,476610,64,2,1486174,431040,-1009564,1009564,4,1440604
2024-06-18,3511,3516,3462,3468,1334275,14,268407,69,1,1332722,1553,-1064315,1064315,3,1065868
2024-06-19,3430,3516,3430,3484,756068,9,186867,30,0,756068,0,-569201,569201,2,569201
2024-06-22,3511,3516,3452,3484,1810871,17,547442,54,2,1609176,201695,-1061734,1061734,4,1263429
2024-06-23,3516,3516,3468,3500,1086418,11,36879,41,3,1024352,62066,-987473,987473,3,1049539
2024-06-24,3538,3538,3446,3473,790538,24,482086,23,0,790538,0,-308452,308452,1,308452
2024-06-26,3441,3527,3441,3516,1412919,47,1158548,43,1,1142179,270740,16369,-16369,1,254371
2024-06-29,3452,3656,3452,3543,548025,28,534565,50,1,545228,2797,-10663,10663,1,13460
2024-06-30,3484,3500,3446,3452,888069,23,128011,45,0,888069,0,-760058,760058,2,760058
2024-07-01,3500,3522,3484,3489,1179166,20,625016,35,2,779166,400000,-154150,154150,2,554150
2024-07-02,3478,3500,3279,3500,1180430,55,756478,52,1,980430,200000,-223952,223952,3,423952
2024-07-03,3505,3565,3484,3543,520262,16,215520,47,1,519533,729,-304013,304013,2,304742
2024-07-06,3688,3688,3672,3688,5640848,52,5028726,85,3,3460848,2180000,1567878,-1567878,2,612122
2024-07-07,3769,3769,3559,3565,1536147,52,1512787,64,2,968166,567981,544621,-544621,1,23360
2024-07-08,3575,3575,3495,3511,1716472,43,754955,49,2,969419,747053,-214464,214464,3,961517
2024-07-09,3452,3624,3452,3543,719803,29,493045,44,1,386698,333105,106347,-106347,2,226758
2024-07-10,3565,3597,3511,3516,1775291,23,371254,37,1,975291,800000,-604037,604037,2,1404037
2024-07-13,3516,3575,3468,3495,2716618,46,1821446,28,1,2679024,37594,-857578,857578,1,895172
2024-07-14,3511,3527,3446,3500,1202491,47,580801,30,1,1199418,3073,-618617,618617,2,621690
2024-07-17,3446,3548,3446,3516,1387732,33,395434,41,1,1323388,64344,-927954,927954,2,992298
2024-07-20,3441,3532,3419,3478,2842847,43,864407,44,3,1936655,906192,-1072248,1072248,2,1978440
2024-07-21,3435,3457,3365,3387,2217680,69,1537853,33,1,1816874,400806,-279021,279021,1,679827
2024-07-22,3387,3532,3376,3511,6250014,47,437655,81,3,3754752,2495262,-3317097,3317097,1,5812359
2024-07-23,3511,3543,3462,3462,1754518,21,458493,25,1,754518,1000000,-296025,296025,1,1296025
2024-07-24,3511,3511,3489,3489,2881927,10,595906,41,2,1231978,1649949,-636072,636072,1,2286021
2024-07-27,3511,3511,3430,3435,2063796,33,477513,36,3,1381498,682298,-903985,903985,2,1586283
2024-07-29,3522,3522,3376,3387,1291533,51,497868,42,3,662772,628761,-164904,164904,2,793665
2024-07-30,3473,3500,3376,3457,2257535,38,707389,66,2,2172024,85511,-1464635,1464635,1,1550146
2024-07-31,3371,3387,3306,3371,517541,42,517541,52,1,497909,19632,19632,-19632,0,0
2024-08-03,3355,3355,3285,3290,2216470,39,441704,48,1,2161397,55073,-1719693,1719693,2,1774766
2024-08-04,3414,3414,3414,3414,270896,16,270896,3,0,270896,0,0,0,0,0
2024-08-05,3414,3462,3414,3414,3941859,13,14226,64,0,3941859,0,-3927633,3927633,1,3927633
2024-08-06,3446,3457,3408,3408,5843768,17,84537,32,3,5156066,687702,-5071529,5071529,1,5759231
2024-08-10,3441,3446,3403,3414,415182,18,109702,38,0,415182,0,-305480,305480,1,305480
2024-08-11,3403,3425,3398,3398,609521,29,409521,32,0,609521,0,-200000,200000,1,200000
2024-08-12,3425,3425,3398,3398,40414,11,40414,6,0,40414,0,0,0,0,0
2024-08-13,3398,3398,3398,3398,15651,6,15651,1,0,15651,0,0,0,0,0
2024-08-14,3398,3408,3398,3403,1488885,39,1288885,37,0,1488885,0,-200000,200000,1,200000
2024-08-17,3376,3435,3376,3408,1405278,52,1405278,40,0,1405278,0,0,0,0,0
2024-08-18,3365,3446,3360,3446,1399395,41,1378899,47,1,1297016,102379,81883,-81883,1,20496
2024-08-19,3382,3414,3360,3360,2380520,70,1780520,37,0,2380520,0,-600000,600000,1,600000
2024-08-20,3355,3355,3349,3349,1770823,22,1320823,23,1,1382001,388822,-61178,61178,3,450000
2024-08-21,3338,3344,3338,3338,2611027,44,2445170,12,1,2305227,305800,139943,-139943,3,165857
2024-08-24,3344,3419,3328,3376,2120424,85,2051852,42,0,2120424,0,-68572,68572,1,68572
2024-08-26,3328,3371,3328,3365,1364085,37,1364085,28,1,1353978,10107,10107,-10107,0,0
2024-08-27,3322,3392,3322,3371,754195,27,754195,51,0,754195,0,0,0,0,0
2024-08-28,3365,3435,3344,3430,2923750,37,2787912,63,1,2623750,300000,164162,-164162,2,135838
2024-09-01,3468,3468,3419,3468,6376958,60,4826958,78,1,4376958,2000000,450000,-450000,1,1550000
2024-09-03,3425,3478,3403,3408,1352176,40,1352176,43,1,902176,450000,450000,-450000,0,0
2024-09-07,3365,3441,3328,3382,1668514,38,771481,53,1,1318514,350000,-547033,547033,2,897033
2024-09-08,3452,3452,3392,3425,1484897,17,467251,41,2,1133897,351000,-666646,666646,3,1017646
2024-09-09,3430,3468,3392,3430,2424039,42,1400544,47,4,960381,1463658,440163,-440163,2,1023495
2024-09-10,3430,3473,3419,3435,1452751,20,459504,33,1,1102751,350000,-643247,643247,4,993247
2024-09-11,3446,3457,3419,3425,1386975,20,350550,40,2,904284,482691,-553734,553734,2,1036425
2024-09-14,3435,3500,3425,3441,1286443,24,881364,66,2,768580,517863,112784,-112784,4,405079
2024-09-15,3441,3441,3387,3387,3308759,27,1405787,21,2,935183,2373576,470604,-470604,2,1902972
2024-09-16,3355,3408,3344,3376,2499366,82,2499366,45,1,2471243,28123,28123,-28123,0,0
2024-09-17,3349,3468,3338,3419,3770235,77,2127314,58,3,2460975,1309260,-333661,333661,2,1642921
2024-09-18,3441,3478,3392,3473,7851239,58,3643678,56,4,2461132,5390107,1182546,-1182546,4,4207561
2024-09-22,3468,3538,3446,3538,27529569,66,25577200,95,7,5249912,22279657,20327288,-20327288,4,1952369
2024-09-23,3608,3635,3602,3635,27741805,195,12749805,110,4,17378781,10363024,-4628976,4628976,3,14992000
2024-09-24,3715,3737,3694,3737,11861336,205,11626336,133,2,7511336,4350000,4115000,-4115000,3,235000
2024-09-25,3769,3796,3662,3791,10280425,90,4780425,153,4,7077900,3202525,-2297475,2297475,2,5500000
2024-09-28,3705,3705,3705,3705,154482,16,154482,2,0,154482,0,0,0,0,0
2024-09-29,3705,3710,3705,3705,7368974,35,1051711,87,0,7368974,0,-6317263,6317263,5,6317263
2024-09-30,3688,3694,3688,3688,10815496,33,815496,83,2,9395496,1420000,-8580000,8580000,3,10000000
2024-10-01,3662,3662,3662,3662,455813,10,455813,12,0,455813,0,0,0,0,0
2024-10-02,3662,3662,3662,3662,239083,12,239083,1,0,239083,0,0,0,0,0
2024-10-05,3662,3662,3662,3662,37130,13,37130,1,0,37130,0,0,0,0,0
2024-10-06,3662,3662,3662,3662,18648,9,18648,1,0,18648,0,0,0,0,0
2024-10-07,3662,3662,3662,3662,812066,10,12066,6,0,812066,0,-800000,800000,1,800000
2024-10-08,3662,3662,3662,3662,2167086,24,567086,4,0,2167086,0,-1600000,1600000,2,1600000
2024-10-09,3656,3656,3656,3656,1117353,34,1117353,5,0,1117353,0,0,0,0,0
2024-10-12,3586,3629,3581,3624,8408979,91,8388979,128,2,7908979,500000,480000,-480000,1,20000
2024-10-13,3554,3688,3554,3581,3078460,39,2282180,73,1,2658460,420000,-376280,376280,2,796280
2024-10-14,3538,3592,3522,3527,4218015,54,3042805,85,2,3758898,459117,-716093,716093,2,1175210
2024-10-15,3505,3527,3489,3500,2192733,48,1992733,65,2,1700733,492000,292000,-292000,1,200000
2024-10-16,3484,3586,3484,3586,2126856,21,123126,70,0,2126856,0,-2003730,2003730,2,2003730
2024-10-19,3581,3581,3473,3473,1954427,32,1654427,39,0,1954427,0,-300000,300000,1,300000
2024-10-20,3468,3468,3462,3462,187680,20,187680,4,0,187680,0,0,0,0,0
2024-10-21,3462,3462,3462,3462,391747,20,391747,1,0,391747,0,0,0,0,0
2024-10-22,3457,3457,3457,3457,130598,16,130598,2,1,90000,40598,40598,-40598,0,0
2024-10-23,3457,3457,3457,3457,197470,12,197470,2,1,187460,10010,10010,-10010,0,0
2024-10-26,3457,3651,3457,3586,4924512,99,4424512,82,0,4924512,0,-500000,500000,1,500000
2024-10-27,3602,3656,3602,3656,3954892,71,3954892,90,0,3954892,0,0,0,0,0
2024-10-28,3613,3635,3570,3570,1539393,35,1522903,56,1,1489393,50000,33510,-33510,1,16490
2024-10-29,3608,3608,3478,3478,2192408,52,1775048,45,0,2192408,0,-417360,417360,1,417360
2024-10-30,3554,3554,3478,3522,1278883,39,876404,43,0,1278883,0,-402479,402479,1,402479
2024-11-02,3543,3543,3462,3462,1004435,43,1004435,32,2,966468,37967,37967,-37967,0,0
2024-11-03,3457,3457,3457,3457,557675,13,557675,10,0,557675,0,0,0,0,0
2024-11-04,3452,3548,3452,3484,1808953,26,906089,61,1,1508953,300000,-602864,602864,1,902864
2024-11-05,3543,3543,3446,3452,820648,22,280591,37,1,520648,300000,-240057,240057,1,540057
2024-11-06,3435,3484,3435,3446,4838860,52,2238860,37,0,4838860,0,-2600000,2600000,3,2600000
2024-11-09,3500,3586,3500,3505,3904368,80,3831493,67,2,3563121,341247,268372,-268372,2,72875
2024-11-10,3597,3613,3559,3613,4979406,14,1358067,81,2,3651728,1327678,-2293661,2293661,1,3621339
2024-11-11,3645,3645,3565,3592,3214745,66,3147516,68,2,2831545,383200,315971,-315971,1,67229
2024-11-12,3570,3613,3532,3532,1607709,36,1419766,52,1,1307709,300000,112057,-112057,2,187943
2024-11-13,3554,3586,3495,3581,2273771,59,2028486,56,1,1973771,300000,54715,-54715,1,245285
2024-11-16,3554,3651,3554,3651,2980283,20,2722910,58,2,2660283,320000,62627,-62627,1,257373
2024-11-17,3672,3672,3662,3672,26246173,140,24646173,115,7,7021987,19224186,17624186,-17624186,2,1600000
2024-11-18,3780,3780,3780,3780,12838604,21,2513604,75,1,9327900,3510704,-6814296,6814296,3,10325000
2024-11-19,3882,3882,3769,3769,13831770,147,10930810,123,6,7858591,5973179,3072219,-3072219,5,2900960
2024-11-20,3818,3877,3748,3796,5391121,108,3679379,117,1,5373932,17189,-1694553,1694553,8,1711742
2024-11-23,3877,3947,3823,3839,7609176,88,4606229,101,5,3917023,3692153,689206,-689206,4,3002947
2024-11-24,3915,3979,3877,3979,13947083,163,10232213,170,4,9703846,4243237,528367,-528367,8,3714870
2024-11-25,4060,4071,4022,4071,11372411,73,6199682,107,3,3007821,8364590,3191861,-3191861,5,5172729
2024-11-26,4168,4168,3974,4071,14116704,118,7228820,206,2,12788764,1327940,-5559944,5559944,9,6887884
2024-11-27,4162,4243,4017,4243,9108436,43,1661246,182,4,6988436,2120000,-5327190,5327190,4,7447190
2024-11-30,4281,4281,4114,4146,8957115,63,3397285,134,2,8551185,405930,-5153900,5153900,5,5559830
2024-12-01,4071,4302,4071,4302,3472577,29,807227,126,4,3205654,266923,-2398427,2398427,4,2665350
2024-12-02,4313,4313,4313,4313,12119817,54,8688748,82,2,1338822,10780995,7349926,-7349926,3,3431069
2024-12-03,4421,4421,4200,4421,27553330,67,9640096,208,6,18949720,8603610,-9309624,9309624,10,17913234
2024-12-04,4496,4550,4421,4550,7072102,73,3811990,207,5,5184496,1887606,-1372506,1372506,6,3260112
2024-12-07,4555,4555,4372,4426,7674781,60,1251808,137,7,5121357,2553424,-3869549,3869549,4,6422973
2024-12-08,4340,4388,4318,4329,11782607,118,4180686,114,4,3396062,8386545,784624,-784624,5,7601921
2024-12-09,4318,4475,4318,4475,6756770,32,3683997,109,2,2216770,4540000,1467227,-1467227,2,3072773
2024-12-10,4539,4539,4426,4437,16276341,90,4055977,128,7,2464905,13811436,1591072,-1591072,3,12220364
2024-12-11,4518,4636,4432,4631,5568252,59,3231147,186,7,3274388,2293864,-43241,43241,1,2337105
2024-12-14,4668,4668,4668,4668,2146053,3,500000,99,2,1930215,215838,-1430215,1430215,1,1646053
2024-12-15,4690,4690,4690,4690,3580029,13,1941655,110,2,2280029,1300000,-338374,338374,1,1638374
2024-12-16,4722,4722,4717,4722,19418059,130,12318059,170,8,9694097,9723962,2623962,-2623962,2,7100000
2024-12-17,4846,4862,4598,4744,17392045,138,7909396,315,6,12963944,4428101,-5054548,5054548,3,9482649
2024-12-18,4690,4943,4690,4943,6290119,33,3080665,189,1,6024377,265742,-2943712,2943712,2,3209454
2024-12-21,4997,4997,4997,4997,5530240,51,5530240,69,3,491414,5038826,5038826,-5038826,0,0
2024-12-22,5056,5056,4997,5056,18408043,108,13121765,115,5,2995145,15412898,10126620,-10126620,4,5286278
2024-12-23,5056,5207,5013,5207,6186519,72,5306519,191,3,5384432,802087,-77913,77913,2,880000
2024-12-24,5272,5272,5272,5272,4217942,27,4217942,106,4,1934775,2283167,2283167,-2283167,0,0
2024-12-25,5320,5320,5320,5320,11622368,24,7822368,128,3,2622368,9000000,5200000,-5200000,3,3800000
2024-12-28,5455,5455,5455,5455,2681259,12,1681259,129,2,2578769,102490,-897510,897510,4,1000000
2024-12-29,5487,5487,5250,5325,45113919,331,28969921,411,7,30460301,14653618,-1490380,1490380,12,16143998
2024-12-30,5304,5428,5304,5304,32456749,177,5901010,349,5,26268092,6188657,-20367082,20367082,8,26555739
2024-12-31,5191,5433,5191,5315,3980563,113,3734094,162,2,3699406,281157,34688,-34688,2,246469
2025-01-01,5406,5482,5331,5482,11582870,220,11582870,381,5,9165220,2417650,2417650,-2417650,0,0
2025-01-04,5627,5627,5627,5627,5282748,88,5282748,95,3,2782748,2500000,2500000,-2500000,0,0
2025-01-05,5697,5697,5697,5697,5539477,22,5539477,120,3,2638046,2901431,2901431,-2901431,0,0
2025-01-06,5778,5778,5772,5778,11432704,167,11398418,133,5,6584644,4848060,4813774,-4813774,2,34286
2025-01-07,5945,5945,5934,5945,20662109,288,20262109,162,4,5105038,15557071,15157071,-15157071,1,400000
2025-01-08,6095,6095,5767,5842,20396467,591,14977647,443,5,19163157,1233310,-4185510,4185510,4,5418820
2025-01-20,5750,5750,5750,5750,39952772,109,10622792,160,3,32131433,7821339,-21508641,21508641,1,29329980
2025-01-21,5580,5750,5580,5720,26036429,251,5151325,240,4,20229159,5807270,-15077834,15077834,1,20885104
2025-01-22,5730,5750,5630,5690,8177731,200,4170830,121,1,4146592,24238,24238,-24238,0,0
2025-01-25,5610,5740,5550,5590,7182866,168,3428978,132,2,6957866,225000,-3528888,3528888,1,3753888
2025-01-26,5680,5680,5500,5570,2177516,108,2177516,107,0,2177516,0,0,0,0,0
2025-01-27,5700,5700,5490,5520,6736122,97,3315899,92,1,1915777,4820345,1400122,-1400122,1,3420223
2025-01-29,5680,5680,5410,5430,4577364,149,3572141,74,1,1577364,3000000,1994777,-1994777,2,1005223
2025-02-01,5430,5500,5390,5390,12633306,151,2127457,112,2,7972875,4660431,-5845418,5845418,2,10505849
2025-02-02,5450,5490,5350,5420,5214665,79,1749186,109,3,4656510,558155,-2907324,2907324,2,3465479
2025-02-03,5350,5510,5290,5490,3117761,79,1309363,112,2,2468954,648807,-1159591,1159591,1,1808398
2025-02-04,5320,5550,5320,5490,1328375,49,1328375,55,1,1324625,3750,3750,-3750,0,0
2025-02-05,5490,5490,5350,5460,1494324,49,580825,67,0,1494324,0,-913499,913499,1,913499
2025-02-09,5610,5610,5400,5550,10701727,121,4596727,196,7,6073105,4623622,-1476378,1476378,1,6100000
2025-02-11,5670,5670,5360,5380,3054624,119,2654624,121,2,3035927,18697,-381303,381303,1,400000
2025-02-15,5370,5400,5340,5340,5773163,70,2005270,92,1,5744104,29059,-3738834,3738834,2,3767893
2025-02-16,5300,5330,5300,5310,3909631,76,1800852,97,1,3841024,68607,-2040172,2040172,1,2108779
2025-02-17,5450,5470,5280,5450,1449052,68,747337,76,3,1319698,129354,-572361,572361,2,701715
2025-02-18,5310,5460,5310,5360,1901310,60,1901310,62,2,1549777,351533,351533,-351533,0,0
2025-02-19,5320,5480,5260,5410,2377806,115,1777806,64,0,2377806,0,-600000,600000,1,600000
2025-02-22,5500,5500,5280,5350,3456193,56,1041096,89,3,3398096,58097,-2357000,2357000,1,2415097
2025-02-23,5470,5540,5260,5460,3891220,82,1883854,113,3,3838041,53179,-1954187,1954187,2,2007366
2025-02-24,5550,5560,5430,5540,3230389,120,3230388,97,1,3200388,30000,30000,-30000,0,0
2025-02-25,5550,5580,5430,5440,2364645,108,2364645,78,4,2013071,351574,351574,-351574,0,0
2025-02-26,5420,5500,5360,5440,1268954,54,1268954,88,0,1268954,0,0,0,0,0
2025-03-01,5430,5550,5340,5490,2356815,74,1063401,60,0,2356815,0,-1293414,1293414,1,1293414
2025-03-02,5350,5490,5350,5420,2737877,77,2737877,75,1,2624877,113000,113000,-113000,0,0
2025-03-03,5390,5400,5270,5270,4133532,136,4133532,67,0,4133532,0,0,0,0,0
2025-03-04,5260,5450,5260,5320,2581386,90,2581386,53,0,2581386,0,0,0,0,0
2025-03-05,5250,5530,5250,5470,6430855,54,6034254,91,3,6218142,212713,-183888,183888,2,396601
2025-03-08,5560,5560,5340,5500,4599592,76,4599592,161,2,4461402,138190,138190,-138190,0,0
2025-03-09,5330,5580,5310,5430,3060712,70,3060712,105,1,2890957,169755,169755,-169755,0,0
2025-03-10,5400,5580,5400,5490,2014226,59,2014226,65,4,1033319,980907,980907,-980907,0,0
2025-03-11,5520,5530,5280,5290,3356832,73,3226948,40,1,2456832,900000,770116,-770116,1,129884
2025-03-12,5270,5460,5270,5460,1738572,69,1477890,76,0,1738572,0,-260682,260682,2,260682
2025-03-15,5580,5580,5440,5520,1193191,22,1193191,29,1,998471,194720,194720,-194720,0,0
2025-03-16,5430,5520,5330,5400,2778217,55,2078617,53,3,845282,1932935,1233335,-1233335,1,699600
2025-03-17,5380,5490,5300,5400,1300383,50,1300383,37,3,977037,323346,323346,-323346,0,0
2025-03-18,5310,5350,5270,5270,5561851,111,3561851,36,0,5561851,0,-2000000,2000000,1,2000000
2025-03-25,5310,5430,5230,5360,4330553,161,4330553,50,1,4324162,6391,6391,-6391,0,0
2025-03-26,5210,5280,5210,5210,67061865,342,13894417,285,8,54503719,12558146,-40609302,40609302,3,53167448
2025-03-29,5070,5140,5060,5090,56203283,252,7326375,224,4,10581490,45621793,-3255115,3255115,2,48876908
2025-03-30,5000,5210,4930,5160,6510056,100,4755565,221,1,6421884,88172,-1666319,1666319,2,1754491
2025-04-05,5090,5110,4940,4980,6232324,138,6232324,146,1,6060896,171428,171428,-171428,0,0
2025-04-06,4960,5060,4930,4960,3129723,112,3129723,92,1,3122009,7714,7714,-7714,0,0
2025-04-07,4930,5080,4910,5000,12904877,154,5283981,129,3,4932321,7972556,351660,-351660,2,7620896
2025-04-08,5090,5150,5090,5150,2194008,42,2194008,56,1,994008,1200000,1200000,-1200000,0,0
