Date,Open,High,Low,Close,Volume,person_buyer_count,company_buyer_count,person_buy_volume,company_buy_volume,person_seller_count,company_seller_count,person_sell_volume,company_sell_volume,person_owner_change,company_owner_change
2015-06-23,92,92,92,92,1889257,64,5,1260716,628541,35,2,130926,1758331,1129790,-1129790
2015-06-24,92,93,92,92,774797,48,3,686687,88110,32,2,162614,612183,524073,-524073
2015-06-27,92,92,92,92,1233891,30,3,1108253,125638,45,1,352871,881020,755382,-755382
2015-06-28,92,92,92,92,3530285,27,4,246860,3283425,64,3,230501,3299784,16359,-16359
2015-06-29,93,94,91,92,1197670,49,1,1141618,56052,19,2,159937,1037733,981681,-981681
2015-06-30,92,95,92,95,8847745,71,8,4513037,4334708,57,5,420899,8426846,4092138,-4092138
2015-07-01,95,95,93,94,4252715,68,7,2843764,1408951,57,2,616984,3635731,2226780,-2226780
2015-07-04,94,98,93,97,3922758,75,7,2150462,1772296,73,6,2436719,1486039,-286257,286257
2015-07-12,99,99,98,98,3822458,90,2,3134664,210000,35,4,1606651,1738013,1528013,-1528013
2015-07-13,103,103,102,103,16770044,227,7,10534671,6235373,126,10,5091501,11678543,5443170,-5443170
2015-07-14,104,106,104,104,10624318,135,6,7812611,2811707,123,9,5229958,5394360,2582653,-2582653
2015-07-15,107,107,102,103,7629076,109,8,2968479,4660597,146,5,4710265,2918811,-1741786,1741786
2015-07-29,104,105,102,103,11284552,157,9,4762692,6521860,86,15,4008350,7276202,754342,-754342
2015-08-01,104,104,102,102,3417342,62,3,870084,326984,47,2,772028,425040,98056,-98056
2015-08-02,100,103,100,102,2099972,57,4,1062163,1037809,48,0,2099972,0,-1037809,1037809
2015-08-03,101,102,101,101,1891299,45,2,1497758,393541,72,1,1791299,100000,-293541,293541
2015-08-04,102,102,100,101,2152040,34,2,153309,1998731,34,0,2152040,0,-1998731,1998731
2015-08-05,101,102,100,100,341786,50,2,278821,62965,22,1,341286,500,-62465,62465
2015-08-08,100,100,99,99,3439681,62,4,739681,2700000,36,1,3378158,61523,-2638477,2638477
2015-08-09,99,99,98,98,707846,64,2,443190,264656,31,0,707846,0,-264656,264656
2015-08-10,101,101,96,96,2356833,59,3,479953,1876880,27,2,2305751,51082,-1825798,1825798
2015-08-12,98,98,95,96,806523,51,3,299615,506908,33,2,758001,48522,-458386,458386
2015-08-15,98,98,94,95,593650,46,3,377546,216104,35,0,593650,0,-216104,216104
2015-08-16,96,96,94,94,456886,36,3,246886,210000,22,0,456886,0,-210000,210000
2015-08-17,95,95,94,94,631182,34,3,301182,330000,22,2,494516,136666,-193334,193334
2015-08-18,94,95,93,93,765211,16,3,21201,173154,15,0,194355,0,-173154,173154
2015-08-19,94,94,92,94,637900,23,3,159272,478628,22,2,501478,136422,-342206,342206
2015-08-22,95,95,93,94,497212,24,3,237298,259914,25,2,387212,110000,-149914,149914
2015-08-23,95,95,93,93,215343,25,3,72943,142400,21,0,215343,0,-142400,142400
2015-08-24,95,95,93,93,303149,12,3,78128,225021,27,2,229648,73501,-151520,151520
2015-08-25,93,93,90,90,1387815,70,3,717815,670000,27,3,1122019,265796,-404204,404204
2015-08-26,91,91,88,89,854616,43,5,283047,571569,27,1,846415,8201,-563368,563368
2015-08-29,93,93,90,91,242744,20,4,99197,152047,16,0,251244,0,-152047,152047
2015-08-30,93,93,90,90,296057,26,4,93227,202830,19,0,296057,0,-202830,202830
2015-08-31,90,91,90,91,3916084,6,4,58719,3857365,20,2,250483,3665601,-191764,191764
2015-09-01,91,91,90,90,254318,20,3,133648,120670,19,3,164640,89678,-30992,30992
2015-09-02,92,92,90,90,548908,36,4,381708,167200,20,1,529271,19637,-147563,147563
2015-09-05,92,92,90,91,653739,25,3,463265,190474,21,0,653739,0,-190474,190474
2015-09-06,91,92,90,91,138582,22,1,97982,40600,15,2,120764,17818,-22782,22782
2015-09-07,92,92,90,91,135215,23,1,82915,52300,19,1,127233,7982,-44318,44318
2015-09-08,92,92,89,89,490290,44,2,418615,71675,25,2,379798,110492,38817,-38817
2015-09-09,91,91,88,89,839860,74,4,665780,174080,20,0,839860,0,-174080,174080
2015-09-12,90,91,88,90,2119763,15,3,52257,2067506,19,3,115213,2004550,-62956,62956
2015-09-13,91,91,85,86,2751816,72,5,636285,2115531,23,1,751816,2000000,-115531,115531
2015-09-14,86,88,85,88,710378,12,5,21185,689193,49,1,640378,70000,-619193,619193
2015-09-15,88,88,86,86,679900,33,4,119077,560823,34,1,656011,23889,-536934,536934
2015-09-16,87,88,86,86,356018,28,3,125398,230620,28,3,248985,107033,-123587,123587
2015-09-19,89,89,86,86,685553,30,4,157553,528000,29,2,560553,125000,-403000,403000
2015-09-20,87,87,82,83,1215250,48,4,428970,786280,31,1,1115250,100000,-686280,686280
2015-09-21,84,84,81,83,397548,14,3,155684,241864,22,1,297548,100000,-141864,141864
2015-09-22,84,85,82,83,329965,37,3,207522,122443,20,0,329965,0,-122443,122443
2015-09-23,83,84,83,84,302164,32,3,138664,163500,22,1,302150,14,-163486,163486
2015-09-26,84,84,83,83,231898,16,3,49642,182256,11,0,231898,0,-182256,182256
2015-09-27,86,86,83,84,627662,15,5,144572,483090,22,1,607870,19792,-463298,463298
2015-09-28,86,86,83,85,234633,10,3,31033,203600,15,0,234633,0,-203600,203600
2015-09-29,85,85,84,84,252674,17,2,153674,99000,13,1,96831,155843,56843,-56843
2015-09-30,85,85,84,84,297812,15,5,87073,210739,19,1,262812,35000,-175739,175739
2015-10-03,85,85,83,83,426568,21,2,302568,124000,24,3,253268,173300,49300,-49300
2015-10-04,84,86,82,85,4344882,11,5,71967,4272915,48,3,1597048,2747834,-1525081,1525081
2015-10-05,86,86,83,83,457906,29,4,215873,242033,22,1,360347,97559,-144474,144474
2015-10-06,85,88,83,87,4236197,26,3,225897,4010300,61,4,2734276,1501921,-2508379,2508379
2015-10-07,88,88,85,86,353620,15,2,79620,274000,12,3,29103,324517,50517,-50517
2015-10-10,88,88,84,87,285107,11,3,120107,165000,20,2,107279,177828,12828,-12828
2015-10-11,88,88,86,86,156495,11,1,89995,66500,11,3,86454,70041,3541,-3541
2015-10-12,87,87,84,86,262976,21,3,138587,124389,14,0,262976,0,-124389,124389
2015-10-13,87,87,86,86,412025,17,2,142425,269600,18,1,142709,269316,-284,284
2015-10-14,89,89,87,89,390008,22,2,312538,77470,38,3,165234,224774,147304,-147304
2015-10-17,90,91,89,91,668573,30,3,523573,145000,53,3,324205,344368,199368,-199368
2015-10-18,92,92,89,89,298040,43,1,276840,21200,24,2,249150,48890,27690,-27690
2015-10-19,92,92,88,88,161985,23,2,110285,51700,10,1,160485,1500,-50200,50200
2015-10-20,90,92,88,92,598556,26,2,87556,511000,33,2,398556,200000,-311000,311000
2015-10-21,92,92,89,92,603189,15,2,290189,313000,45,2,501189,102000,-211000,211000
2015-10-25,93,93,89,90,304332,28,1,289332,15000,12,3,81750,222582,207582,-207582
2015-10-26,92,92,89,90,80146,25,1,67146,13000,11,2,66962,13184,184,-184
2015-10-27,91,91,88,90,631452,16,2,20452,611000,14,3,55678,575774,-35226,35226
2015-10-28,92,93,89,93,753893,13,1,97586,13000,14,2,58036,52550,39550,-39550
2015-10-31,92,92,89,91,138801,21,2,98801,40000,20,1,103827,34974,-5026,5026
2015-11-01,91,91,89,89,586079,59,3,451279,134800,20,3,99347,486732,351932,-351932
2015-11-02,91,91,89,90,10208500,49,3,1136904,9071596,14,4,425336,9783164,711568,-711568
2015-11-03,91,91,89,89,1556335,36,5,139655,1416400,8,3,26393,1529662,113262,-113262
2015-11-04,90,90,87,88,649902,55,3,304461,345441,22,2,319875,330027,-15414,15414
2015-11-07,90,90,86,89,7364759,12,3,24104,7340655,28,4,263136,7101623,-239032,239032
2015-11-08,89,90,87,88,361889,18,3,74534,287355,10,2,57793,304096,16741,-16741
2015-11-09,88,89,87,88,215610,8,3,114744,100866,24,0,215610,0,-100866,100866
2015-11-10,89,89,87,88,106354,13,2,42354,64000,17,1,79398,26956,-37044,37044
2015-11-11,89,89,87,87,161013,22,3,38871,122142,21,0,161013,0,-122142,122142
2015-11-14,87,88,87,87,610981,16,5,100761,510220,37,1,410981,200000,-310220,310220
2015-11-15,88,88,86,87,241974,10,3,37645,204329,24,2,223418,18556,-185773,185773
2015-11-16,87,87,87,87,613289,18,3,152354,460935,34,1,606438,6851,-454084,454084
2015-11-17,88,88,87,87,4829247,9,3,67341,4761906,28,2,547520,4281727,-480179,480179
2015-11-18,89,89,86,88,4852208,13,4,189598,4662610,26,4,500940,4351268,-311342,311342
2015-11-21,86,88,86,87,746034,20,4,525258,220776,21,2,223755,522279,301503,-301503
2015-11-22,88,88,86,87,653719,23,3,265861,387858,29,2,549794,103925,-283933,283933
2015-11-23,87,87,86,87,3473323,6,6,36440,3436883,16,2,369418,3103905,-332978,332978
2015-11-24,88,88,86,87,260168,10,3,77228,182940,19,1,259263,905,-182035,182035
2015-11-25,87,87,86,86,292436,10,4,114326,178110,18,0,292436,0,-178110,178110
2015-11-28,86,87,86,86,493606,22,4,137819,355787,31,0,493606,0,-355787,355787
2015-11-29,87,87,86,87,505931,10,4,386072,119859,47,2,402931,103000,-16859,16859
2015-11-30,87,90,87,90,1890013,41,10,860873,1029140,76,3,970013,920000,-109140,109140
2015-12-01,88,91,88,90,846720,25,4,303297,543423,41,3,492124,354596,-188827,188827
2015-12-05,89,91,89,90,1285640,15,5,226659,1058981,53,3,595640,690000,-368981,368981
2015-12-06,91,91,90,91,2242882,17,3,147977,2094905,35,1,365105,1877777,-217128,217128
2015-12-07,91,92,90,91,754131,9,2,352120,402011,31,2,478631,275500,-126511,126511
2015-12-08,91,95,90,95,1345010,17,4,269836,1075174,79,5,698496,646514,-428660,428660
2015-12-09,95,96,93,96,1882826,17,1,112387,1537720,55,3,620107,1030000,-507720,507720
2015-12-13,98,98,94,94,2031981,36,2,294263,1737718,30,6,1653069,378912,-1358806,1358806
2015-12-14,95,96,95,95,156121,11,1,36886,119235,20,0,156121,0,-119235,119235
2015-12-15,95,96,95,95,1357575,26,6,185860,1171715,40,5,597575,760000,-411715,411715
2015-12-16,96,96,95,96,575542,16,2,234010,341532,30,4,261397,314145,-27387,27387
2015-12-19,95,95,92,93,265059,20,0,265059,0,16,0,265059,0,0,0
2015-12-20,91,92,91,91,285544,19,2,161400,124144,18,2,128936,156608,32464,-32464
2015-12-21,90,95,90,92,352950,16,2,49704,303246,28,0,352950,0,-303246,303246
2015-12-22,92,92,91,91,276481,24,2,156481,120000,14,2,123784,152697,32697,-32697
2015-12-23,91,92,89,92,1110869,50,5,649998,460871,23,2,117497,993372,532501,-532501
2015-12-26,89,91,89,91,552128,20,3,102442,449686,20,2,189538,362590,-87096,87096
2015-12-27,92,95,92,93,7660746,77,6,992746,6668000,46,6,1247403,6413343,-254657,254657
2015-12-28,93,94,93,93,1184030,22,4,94492,1089538,29,2,765630,418400,-671138,671138
2015-12-30,93,93,90,90,4098332,125,5,1478332,2620000,39,6,935020,3163312,543312,-543312
2016-01-10,94,94,93,93,1239054,60,2,933054,306000,43,2,719604,519450,213450,-213450
2016-01-11,93,93,92,93,1378628,63,3,623368,755260,60,4,1173628,205000,-550260,550260
2016-01-12,93,93,92,93,1985068,53,4,603268,1381800,52,2,1980776,4292,-1377508,1377508
2016-01-13,92,93,91,93,1081598,57,2,719297,362301,59,2,1050148,31450,-330851,330851
2016-01-16,93,97,93,96,6219374,200,4,4951234,1268140,81,11,1566750,4652624,3384484,-3384484
2016-01-17,100,100,98,100,14874098,251,6,7462991,7411107,129,14,5330220,9543878,2132771,-2132771
2016-01-18,100,105,100,105,7591996,188,6,5343521,2248475,189,7,4988198,2603798,355323,-355323
2016-01-19,105,108,105,108,15868356,286,2,11567781,4300575,124,10,3325493,12542863,8242288,-8242288
2016-01-20,111,111,104,107,7855681,151,2,1945910,5909771,158,3,7279735,575946,-5333825,5333825
2016-01-23,109,109,102,105,4964042,182,4,3672042,1292000,118,3,3364720,1599322,307322,-307322
2016-01-24,107,108,103,108,5446924,151,2,4429522,1017402,162,3,4713573,733351,-284051,284051
2016-01-25,107,111,105,111,7321064,242,2,6721064,600000,149,7,6007064,1314000,714000,-714000
2016-01-26,114,115,113,115,6962405,208,3,5462405,1500000,103,9,4370310,2592095,1092095,-1092095
2016-01-27,120,120,110,112,3381636,202,2,2920510,461126,118,2,2958814,422822,-38304,38304
2016-01-30,114,114,110,111,1509246,143,0,1509246,0,81,0,1509246,0,0,0
2016-01-31,111,112,108,110,1599817,107,3,1039817,560000,57,1,1511839,87978,-472022,472022
2016-02-01,109,114,109,112,2591489,121,1,2502615,88874,116,2,2163055,428434,339560,-339560
2016-02-02,112,115,108,108,2408599,173,0,2408599,0,93,2,1858599,550000,550000,-550000
2016-02-03,110,110,106,108,5329470,153,0,5329470,0,90,2,5074570,254900,254900,-254900
2016-02-06,107,110,107,108,1542313,124,0,1542313,0,79,1,1392313,150000,150000,-150000
2016-02-07,108,108,106,108,4793513,237,0,4793513,0,154,1,4639517,153996,153996,-153996
2016-02-08,109,113,107,111,6559880,231,2,5139200,1420680,188,3,5703901,855979,-564701,564701
2016-02-09,112,116,109,111,9088523,306,1,9033523,55000,273,9,6464882,2623641,2568641,-2568641
2016-02-10,112,114,110,111,1659197,110,0,1659197,0,112,0,1659197,0,0,0
2016-02-13,114,114,108,108,2140603,119,3,1408803,731800,80,1,1870114,270489,-461311,461311
2016-02-14,107,111,106,108,1668396,114,2,1063389,605007,68,4,958306,710090,105083,-105083
2016-02-15,107,112,106,110,2799244,142,2,1699383,1099861,105,4,2475358,323886,-775975,775975
2016-02-16,108,109,103,105,2292965,135,3,1321965,971000,72,3,1688401,604564,-366436,366436
2016-02-17,105,107,103,103,2053608,190,0,2053608,0,92,4,1009960,1043648,1043648,-1043648
2016-02-20,107,107,101,101,1820260,167,1,1759260,61000,87,3,1426799,393461,332461,-332461
2016-02-21,101,107,99,103,12633052,155,3,1673742,10959310,103,5,1464701,11168351,209041,-209041
2016-02-22,105,106,102,105,1090367,81,1,732367,358000,89,1,1066623,23744,-334256,334256
2016-02-23,105,108,102,103,1447373,54,2,372612,1074761,93,1,1247373,200000,-874761,874761
2016-02-24,103,110,103,110,2179667,63,2,790988,1388679,150,2,1858418,321249,-1067430,1067430
2016-02-27,105,109,105,107,1733776,92,2,1463206,270570,49,3,512678,1221098,950528,-950528
2016-02-28,108,108,103,103,1954106,75,0,1954106,0,46,2,454106,1500000,1500000,-1500000
2016-02-29,103,108,101,108,8224876,119,1,1380248,6844628,69,3,1324876,6900000,55372,-55372
2016-03-01,104,106,104,104,659841,59,1,559841,100000,51,1,589841,70000,-30000,30000
2016-03-02,104,107,102,102,4711578,113,2,1018535,3693043,48,2,1428846,3282732,-410311,410311
2016-03-05,104,104,101,101,3635074,212,1,3535074,100000,46,3,1363599,2271475,2171475,-2171475
2016-03-06,99,103,99,101,152203493,132,2,2203493,150000000,51,4,798411,151405082,1405082,-1405082
2016-03-07,102,105,101,103,3071193,104,0,3071193,0,89,4,1429188,1642005,1642005,-1642005
2016-03-08,100,106,100,106,3093557,51,2,1637887,1455670,120,2,2814531,279026,-1176644,1176644
2016-03-09,105,107,105,107,1859531,61,1,1632202,227329,102,2,1452236,407295,179966,-179966
2016-03-12,108,108,106,108,2659464,97,3,1751439,908025,90,4,1809464,850000,-58025,58025
2016-03-14,108,111,108,108,2888837,66,4,1743525,1145312,156,3,2453771,435066,-710246,710246
2016-03-15,110,112,105,106,3487352,61,3,2095352,1392000,56,1,534226,2953126,1561126,-1561126
2016-03-16,108,112,103,105,5733671,92,3,3056665,2677006,84,1,1985081,3748590,1071584,-1071584
2016-03-26,104,108,104,107,1054501,49,0,1054501,0,26,1,385394,669107,669107,-669107
2016-03-27,108,108,105,105,778342,45,0,778342,0,32,1,426761,351581,351581,-351581
2016-03-28,106,106,105,106,418923,25,3,300923,118000,13,1,100342,318581,200581,-200581
2016-03-29,105,106,105,105,609419,34,1,513780,95639,40,1,515031,94388,-1251,1251
2016-03-30,105,107,104,107,507917,35,0,507917,0,57,0,507917,0,0,0
2016-04-02,106,106,103,103,1969440,85,3,1419440,550000,34,1,1648232,321208,-228792,228792
2016-04-03,103,105,103,105,1040843,37,3,690843,350000,40,0,1040843,0,-350000,350000
2016-04-04,103,107,103,106,1221357,36,1,536581,684776,63,0,1221357,0,-684776,684776
2016-04-05,106,108,105,107,1174332,43,4,305377,868955,90,0,1174332,0,-868955,868955
2016-04-06,105,108,105,105,774263,49,2,674263,100000,40,2,622124,152139,52139,-52139
2016-04-09,105,106,104,105,8795691,35,5,421018,8374673,42,1,1095691,7700000,-674673,674673
2016-04-10,105,107,104,104,643077,30,3,418827,224250,64,3,592106,50971,-173279,173279
2016-04-11,105,108,105,106,10178551,31,4,418600,9759951,68,3,1267551,8911000,-848951,848951
2016-04-12,108,110,105,110,15231904,24,2,258810,14973094,84,1,941904,14290000,-683094,683094
2016-04-13,108,109,104,105,1208594,57,2,1108594,100000,42,1,1108594,100000,0,0
2016-04-16,105,105,103,103,2137016,48,5,852775,1284241,65,1,1637016,500000,-784241,784241
2016-04-17,104,107,104,105,673220,24,3,427231,245989,39,0,673220,0,-245989,245989
2016-04-18,105,108,105,106,1407918,40,3,1267918,140000,72,1,1229658,178260,38260,-38260
2016-04-19,107,112,106,112,12823145,95,6,11342034,1481111,184,3,5693145,7130000,5648889,-5648889
2016-04-20,116,116,111,111,72204557,554,29,54782757,17421800,273,18,13378313,58826244,41404444,-41404444
2016-04-23,111,114,110,112,7942898,202,9,7260328,682570,201,5,6974489,968409,285839,-285839
2016-04-24,113,117,112,117,24948423,331,10,16978423,7970000,285,15,9350996,15597427,7627427,-7627427
2016-04-25,117,118,115,115,6340450,166,3,5415450,925000,134,7,5688978,651472,-273528,273528
2016-04-26,118,120,115,115,14387576,391,10,12380574,2007002,187,10,10130789,4256787,2249785,-2249785
2016-04-27,112,116,111,112,11333519,475,5,11011519,322000,141,2,9767357,1566162,1244162,-1244162
2016-04-30,111,113,109,111,2007681,162,2,1987681,20000,67,3,1976793,30888,10888,-10888
2016-05-01,109,110,107,108,4785705,210,5,4683705,102000,67,2,4326853,458852,356852,-356852
2016-05-02,110,111,107,108,3532258,135,4,3449338,82920,83,2,2011265,1520993,1438073,-1438073
2016-05-03,109,109,107,107,2512031,102,3,2452031,60000,54,4,1359443,1152588,1092588,-1092588
2016-05-04,109,109,106,106,1509721,95,3,1468721,41000,55,1,1434721,75000,34000,-34000
2016-05-07,108,108,106,106,1434269,62,5,730269,704000,69,1,1359269,75000,-629000,629000
2016-05-08,106,112,106,111,5828413,65,4,2583311,3245102,163,4,3114911,2713502,-531600,531600
2016-05-09,110,114,107,113,3278903,78,3,1258903,2020000,124,0,3278903,0,-2020000,2020000
2016-05-10,109,109,106,106,2156314,142,4,1859982,296332,69,2,1851474,304840,8508,-8508
2016-05-11,105,108,103,104,1668375,117,2,1358375,310000,53,0,1668375,0,-310000,310000
2016-05-14,107,107,103,106,4063786,106,6,1176902,2886884,81,2,3213786,850000,-2036884,2036884
2016-05-15,108,108,103,103,3442906,117,6,1876985,1565921,61,2,3006058,436848,-1129073,1129073
2016-05-17,104,104,103,103,1875051,117,3,1477487,397564,44,0,1875051,0,-397564,397564
2016-05-18,104,107,103,107,6006063,82,4,747531,5258532,63,3,5399056,607007,-4651525,4651525
2016-05-21,105,106,105,105,1175015,57,2,1065015,110000,35,1,1170964,4051,-105949,105949
2016-05-23,107,107,104,107,10896835,57,9,2685401,8211434,86,3,2667135,8229700,18266,-18266
2016-05-24,107,107,105,105,2693665,52,4,518699,2174966,64,1,693665,2000000,-174966,174966
2016-05-25,108,109,107,109,10641588,68,3,3466488,7175100,122,3,3067414,7574174,399074,-399074
2016-05-28,109,109,107,107,1012448,63,3,802438,210010,63,0,1012448,0,-210010,210010
2016-05-29,107,109,105,106,850751,52,4,499488,351263,40,1,758124,92627,-258636,258636
2016-05-30,105,108,105,105,1532537,44,3,237437,1295100,42,1,1417337,115200,-1179900,1179900
2016-05-31,107,107,105,105,936459,41,3,626559,309900,24,1,536459,400000,90100,-90100
2016-06-01,104,106,104,105,595767,31,3,182746,413021,45,1,333523,262244,-150777,150777
2016-06-05,105,106,104,105,14009190,92,6,1033567,12975623,44,2,1743058,12266132,-709491,709491
2016-06-06,104,105,103,103,1016458,52,1,816458,200000,29,1,352833,663625,463625,-463625
2016-06-07,104,104,103,103,5074332,130,3,4774332,300000,49,3,4381740,692592,392592,-392592
2016-06-08,103,105,103,103,13521501,94,2,3775635,9745866,81,2,4941501,8580000,-1165866,1165866
2016-06-11,103,103,101,102,1296102,89,3,922558,373544,49,2,957709,338393,-35151,35151
2016-06-12,102,105,102,102,1083630,67,2,779610,304020,29,1,1074650,8980,-295040,295040
2016-06-13,104,104,102,102,1294899,47,2,894899,400000,26,1,1294889,10,-399990,399990
2016-06-14,102,103,101,102,805110,45,2,520137,284973,48,1,776524,28586,-256387,256387
2016-06-15,103,103,102,103,951230,45,1,751030,200200,36,2,707733,243497,43297,-43297
2016-06-18,103,103,102,102,615913,48,1,475632,140281,25,1,309198,306715,166434,-166434
2016-06-19,103,103,99,101,2261070,61,3,1296684,964386,40,1,2020629,240441,-723945,723945
2016-06-20,101,102,100,100,8362228,29,2,671337,7690891,34,2,867118,7495110,-195781,195781
2016-06-21,102,103,100,102,3270839,38,3,768487,2502352,41,2,1393286,1877553,-624799,624799
2016-06-22,103,103,101,102,2267070,98,2,1663570,603500,31,4,743072,1523998,920498,-920498
2016-06-25,103,103,100,102,1153843,37,3,636545,517298,37,1,806142,347701,-169597,169597
2016-06-26,102,103,102,102,920956,38,1,720956,200000,39,0,920956,0,-200000,200000
2016-06-28,103,103,102,102,1927665,75,2,1513173,414492,37,2,1136310,791355,376863,-376863
2016-06-29,102,103,102,103,733911,49,1,658843,75068,40,0,733911,0,-75068,75068
2016-07-02,102,102,102,102,813072,34,3,301990,511082,33,0,813072,0,-511082,511082
2016-07-03,102,104,102,103,3261820,54,6,715331,2546489,55,1,3163175,98645,-2447844,2447844
2016-07-04,104,105,103,105,1903603,31,4,466291,1437312,56,1,1603603,300000,-1137312,1137312
2016-07-05,105,108,103,107,13295925,55,7,576862,12719063,165,4,3062010,10233915,-2485148,2485148
2016-07-09,107,111,107,108,1548717,46,5,462070,1086647,88,5,1274725,273992,-812655,812655
2016-07-10,109,111,108,109,4896592,76,10,2271301,2625291,91,10,2929933,1966659,-658632,658632
2016-07-11,109,109,108,108,542764,46,3,430332,112432,54,1,539525,3239,-109193,109193
2016-07-12,108,110,108,108,2142233,38,3,838733,1303500,92,2,1942232,200001,-1103499,1103499
2016-07-13,108,108,105,107,5432694,109,7,1593922,3838772,94,5,4910533,522161,-3316611,3316611
2016-07-19,112,112,108,108,7410286,105,4,5210286,2200000,34,4,1828966,5581320,3381320,-3381320
2016-07-20,111,111,109,110,3933475,112,3,1779657,2153818,47,5,1355489,2577986,424168,-424168
2016-07-23,111,111,109,109,1585274,112,2,1421288,163986,38,1,1485274,100000,-63986,63986
2016-07-24,109,110,109,109,969583,72,2,908592,60991,40,2,779583,190000,129009,-129009
2016-07-25,109,110,108,109,3430984,93,3,2369211,1061773,51,2,1850984,1580000,518227,-518227
2016-07-26,109,109,105,106,10137549,263,6,8452988,1684561,49,1,1426146,8711403,7026842,-7026842
2016-07-27,106,109,106,108,3032765,85,5,1899765,1133000,81,2,1719534,1313231,180231,-180231
2016-07-31,109,112,108,111,14753224,109,7,1816724,12936500,181,5,5262394,9490830,-3445670,3445670
2016-08-01,110,112,109,109,4190701,64,3,667201,3523500,39,1,690701,3500000,-23500,23500
2016-08-02,110,112,109,110,928278,60,0,928278,0,53,1,828278,100000,100000,-100000
2016-08-03,111,111,110,110,848522,58,1,1030562,2000,42,2,811912,220650,218650,-218650
2016-08-06,112,113,109,111,3153237,89,5,1696237,1457000,80,7,1248726,1904511,447511,-447511
2016-08-07,111,116,111,116,12205384,128,4,10565205,1640179,230,3,8485984,3719400,2079221,-2079221
2016-08-08,117,117,113,114,3486654,115,2,2745449,741205,59,6,1738277,1748377,1007172,-1007172
2016-08-09,113,114,112,113,2719707,115,3,2651957,67750,42,3,2270755,448952,381202,-381202
2016-08-10,114,114,111,112,1124257,85,3,1034257,90000,45,2,1046642,77615,-12385,12385
2016-08-13,112,112,111,112,780673,65,4,592676,187997,45,0,780673,0,-187997,187997
2016-08-14,112,112,111,111,1679114,93,4,1414222,264892,47,2,1431614,247500,-17392,17392
2016-08-15,111,112,111,112,17379674,72,5,921271,16458403,53,4,920047,16459627,1224,-1224
2016-08-16,111,113,111,111,1140139,53,2,856753,283386,38,2,580139,560000,276614,-276614
2016-08-17,112,112,111,111,378004,47,2,263792,114212,26,1,325504,52500,-61712,61712
2016-08-20,112,113,111,112,956012,26,4,413054,542958,51,2,856012,100000,-442958,442958
2016-08-21,111,112,111,111,1430591,80,3,1050591,380000,26,5,1036733,393858,13858,-13858
2016-08-22,111,112,111,112,1147982,36,4,954400,193582,31,3,710211,437771,244189,-244189
2016-08-23,112,112,111,112,1850466,52,0,1850466,0,30,3,949149,901317,901317,-901317
2016-08-24,112,112,111,112,2400750,83,3,1799732,601018,41,3,1047486,1353264,752246,-752246
2016-08-27,112,112,111,111,1478371,42,5,1111355,367016,37,3,723473,754898,387882,-387882
2016-08-28,112,112,109,110,1916518,90,6,1425283,491235,31,6,1187518,729000,237765,-237765
2016-08-29,110,111,108,108,1499001,113,3,1069001,430000,20,4,540145,958856,528856,-528856
2016-08-30,110,110,107,108,1504311,99,3,1184311,320000,21,5,395412,1108899,788899,-788899
2016-08-31,107,108,107,107,3751558,113,11,1843558,1908000,29,4,1183131,2568427,660427,-660427
2016-09-03,108,108,106,106,1484245,72,5,768518,715727,24,4,271944,1212301,496574,-496574
2016-09-04,108,108,105,106,2063786,66,7,928232,1135554,20,3,425106,1638680,503126,-503126
2016-09-05,107,107,105,105,1733585,67,4,956469,777116,12,3,193040,1540545,763429,-763429
2016-09-06,107,110,106,108,1586594,28,2,509469,1077125,59,4,962324,624270,-452855,452855
2016-09-07,109,109,107,107,607805,31,3,483520,124285,18,3,512238,95567,-28718,28718
2016-09-10,107,107,106,106,1365617,49,4,620801,744816,23,1,1273077,92540,-652276,652276
2016-09-11,106,107,106,107,257354,21,2,222170,35184,19,1,242667,14687,-20497,20497
2016-09-13,107,108,106,106,1421821,33,3,1041821,380000,32,2,1217399,204422,-175578,175578
2016-09-14,107,107,106,107,369664,32,3,277664,92000,30,1,364171,5493,-86507,86507
2016-09-17,106,107,106,106,1050741,48,4,617266,433475,33,1,550741,500000,66525,-66525
2016-09-18,106,107,106,107,927880,35,3,602770,325110,40,2,744880,183000,-142110,142110
2016-09-19,106,107,106,107,1239849,37,3,1042072,197777,24,1,470687,769162,571385,-571385
2016-09-21,106,110,105,106,3805129,87,5,1822906,1982223,51,6,2711106,1094023,-888200,888200
2016-09-24,109,109,106,107,2012443,82,4,1029121,983322,34,3,1441065,571378,-411944,411944
2016-09-25,107,107,106,106,2829144,107,4,1949429,879715,36,5,1786077,1043067,163352,-163352
2016-09-26,106,108,106,106,3326606,43,8,1096606,2230000,44,4,1471924,1854682,-375318,375318
2016-09-27,108,108,107,108,1226027,26,2,809196,416831,49,2,924894,301133,-115698,115698
2016-09-28,107,108,107,107,1189240,35,2,710814,478426,46,3,653208,536032,57606,-57606
2016-10-01,108,108,106,107,1554885,70,2,698066,856819,46,2,1371998,182887,-673932,673932
2016-10-02,107,107,105,105,2052894,100,4,1021470,1031424,39,2,1682894,370000,-661424,661424
2016-10-03,107,107,105,105,2352593,124,3,1600265,752328,61,6,1702088,650505,-101823,101823
2016-10-04,105,106,103,103,3860984,153,3,2270634,1590350,41,8,3191984,669000,-921350,921350
2016-10-05,104,104,103,104,1841226,86,3,572804,1268422,37,1,1777846,63380,-1205042,1205042
2016-10-08,105,105,103,104,1527356,62,2,665236,862120,24,3,1377356,150000,-712120,712120
2016-10-09,105,105,103,105,1048576,36,3,193991,854585,32,1,1043576,5000,-849585,849585
2016-10-10,105,106,104,105,1357880,46,2,252362,1105518,45,1,1247088,110792,-994726,994726
2016-10-15,105,106,103,104,1995613,81,3,1095613,900000,34,1,1989038,6575,-893425,893425
2016-10-16,104,104,102,103,4996826,109,5,1661971,3334855,44,0,4996826,0,-3334855,3334855
2016-10-17,103,105,103,105,1333424,47,4,632800,700624,37,0,1333424,0,-700624,700624
2016-10-18,104,104,102,103,2496825,118,6,1618918,877907,39,1,522463,1974362,1096455,-1096455
2016-10-19,102,104,102,103,1261999,59,4,777031,484968,39,0,1261999,0,-484968,484968
2016-10-22,103,104,102,103,2911479,77,5,907911,2003568,34,1,826386,2085093,81525,-81525
2016-10-23,103,105,103,105,718215,39,1,617665,100550,48,0,718215,0,-100550,100550
2016-10-24,105,106,104,105,1918362,78,2,1843494,74868,34,4,554094,1364268,1289400,-1289400
2016-10-25,104,105,104,105,3124998,81,2,2909998,215000,44,3,1352089,1772909,1557909,-1557909
2016-10-26,105,106,105,106,2691367,76,2,2428367,263000,67,2,2104536,586831,323831,-323831
2016-10-29,106,110,106,108,8742120,188,7,7431120,1311000,145,5,3373668,5368452,4057452,-4057452
2016-10-30,110,110,107,108,1487767,77,1,1474767,13000,48,3,722031,765736,752736,-752736
2016-10-31,109,109,105,106,1835752,119,3,1719752,116000,43,0,1835752,0,-116000,116000
2016-11-01,107,107,105,105,1233119,90,4,1084581,148538,51,1,875240,357879,209341,-209341
2016-11-02,105,105,104,105,2117570,119,3,1179560,938010,33,4,712560,1405010,467000,-467000
2016-11-05,105,106,103,104,2918332,85,2,1420922,1497410,29,2,1113671,1804661,307251,-307251
2016-11-06,103,105,103,103,1884736,74,4,1149867,734869,24,3,357634,1527102,792233,-792233
2016-11-07,103,104,102,102,6990930,236,4,5925588,1065342,28,3,1046057,5944873,4879531,-4879531
2016-11-08,103,104,100,101,8866599,239,3,6780233,2086366,32,5,766329,8100270,6013904,-6013904
2016-11-09,99,101,98,100,3246763,138,5,2604881,641882,80,2,3035001,211762,-430120,430120
2016-11-12,102,102,99,99,2736142,145,2,2568024,168118,35,3,1761386,974756,806638,-806638
2016-11-13,99,102,98,99,3253560,63,2,2114560,1139000,39,2,743039,2510521,1371521,-1371521
2016-11-14,99,101,99,100,2288241,77,4,2038241,250000,33,4,554921,1733320,1483320,-1483320
2016-11-15,99,100,99,100,1721480,67,1,1521480,200000,32,2,1491745,229735,29735,-29735
2016-11-16,100,100,98,98,1344441,95,1,1244441,100000,32,5,420415,924026,824026,-824026
2016-11-19,99,100,99,99,1285841,47,4,601048,684793,36,3,739477,546364,-138429,138429
2016-11-21,100,100,99,100,1928149,45,2,644989,1563599,41,3,563923,1644665,81066,-81066
2016-11-22,100,100,99,99,2254254,66,2,613026,1641228,33,5,608947,1645307,4079,-4079
2016-11-23,100,100,98,99,1754301,80,3,973444,780857,31,3,1223789,530512,-250345,250345
2016-11-26,99,99,98,98,1409783,70,2,1134956,274827,36,2,1129228,280555,5728,-5728
2016-11-27,98,99,98,98,9526427,112,1,2426713,7099714,27,4,1721841,7804586,704872,-704872
2016-11-29,99,101,98,101,37527244,125,7,26801534,10725710,68,5,1015673,36511571,25785861,-25785861
2016-12-03,101,101,98,100,16869586,106,4,9051691,7817895,69,2,3723800,13145786,5327891,-5327891
2016-12-04,100,101,99,101,6282809,66,2,4300334,1982475,36,2,1253180,5029629,3047154,-3047154
2016-12-05,100,101,99,100,3891396,78,3,1080929,2810467,42,3,876906,3014490,204023,-204023
2016-12-06,99,102,99,101,4617746,88,1,4378213,239533,78,6,2049884,2567862,2328329,-2328329
2016-12-07,102,102,101,101,18142696,49,3,1688422,16454274,41,2,1088044,17054652,600378,-600378
2016-12-10,101,102,100,100,2803657,41,0,2803657,0,34,2,893988,1909669,1909669,-1909669
2016-12-11,100,100,99,100,1426488,47,0,1426488,0,34,1,626488,800000,800000,-800000
2016-12-12,100,101,99,99,4187139,49,2,607139,3580000,27,2,532339,3654800,74800,-74800
2016-12-13,99,100,99,99,1254191,47,2,1180668,73523,22,3,433455,820736,747213,-747213
2016-12-14,99,100,99,99,1654950,52,0,1654950,0,41,3,1062768,592182,592182,-592182
2016-12-18,100,100,99,99,1018359,46,1,1001156,17203,28,1,984483,33876,16673,-16673
2016-12-19,99,100,98,98,8477543,57,2,552454,7925089,29,3,564766,7912777,-12312,12312
2016-12-20,100,100,98,98,1150640,65,2,888640,262000,33,2,555493,595147,333147,-333147
2016-12-21,98,99,98,98,1012498,65,3,891451,121047,21,1,727837,284661,163614,-163614
2016-12-24,97,99,97,97,3165971,125,2,2603083,562888,25,2,2590471,575500,12612,-12612
2016-12-25,99,99,97,98,1801979,27,3,1327773,474206,25,3,1150914,651065,176859,-176859
2016-12-26,98,98,97,98,3152356,33,3,1124142,2028214,35,8,816831,2335525,307311,-307311
2016-12-27,98,103,98,103,42885738,134,4,6285738,36600000,231,12,9995805,32889933,-3710067,3710067
2016-12-28,103,103,100,101,2046600,81,1,1546600,500000,62,4,1413200,633400,133400,-133400
2016-12-31,102,102,100,100,939946,49,1,839946,100000,30,1,915883,24063,-75937,75937
2017-01-01,101,101,98,99,1729530,66,2,1128530,601000,40,1,1693777,35753,-565247,565247
2017-01-02,98,99,98,98,1752384,47,2,752384,1000000,29,3,379222,1373162,373162,-373162
2017-01-03,98,100,98,98,1191123,40,3,769723,421400,32,1,573055,618068,196668,-196668
2017-01-04,99,100,98,99,1201326,26,1,1126212,300010,35,1,676222,750000,449990,-449990
2017-01-07,99,99,98,99,1239133,32,4,552749,686384,45,2,1008818,230315,-456069,456069
2017-01-08,99,99,98,99,5686099,44,3,1486599,4199500,50,3,1609499,4076600,-122900,122900
2017-01-09,99,99,97,98,774141,37,3,255141,519000,32,1,365641,408500,-110500,110500
2017-01-11,99,100,98,99,1427930,21,4,208702,1219228,64,2,1110839,317091,-902137,902137
2017-01-14,99,101,98,100,4049082,25,5,504993,3544089,52,5,859629,3189453,-354636,354636
2017-01-15,100,100,99,99,844585,27,3,359585,485000,20,2,440153,404432,-80568,80568
2017-01-16,100,101,99,99,1573278,35,3,768387,804891,17,3,250113,1323165,518274,-518274
2017-01-17,100,100,99,100,2772240,18,3,196555,2575685,40,2,1372240,1400000,-1175685,1175685
2017-01-18,100,100,99,99,2247350,44,3,1127350,1120000,30,2,1870283,377067,-742933,742933
2017-01-21,99,100,99,99,1024770,41,4,808170,216600,32,1,909435,115335,-101265,101265
2017-01-22,99,100,98,99,858838,50,2,344077,514761,22,1,658838,200000,-314761,314761
2017-01-23,99,100,99,99,1742905,27,5,1098213,644692,49,1,1582905,160000,-484692,484692
2017-01-24,99,99,99,99,962552,21,3,518552,444000,42,1,938502,24050,-419950,419950
2017-01-25,99,99,99,99,961275,38,3,641275,320000,26,2,452966,508309,188309,-188309
2017-01-28,99,100,98,99,1199120,38,4,507607,691513,29,0,1199120,0,-691513,691513
2017-01-29,99,100,98,98,955429,36,5,440649,514780,25,1,684597,270832,-243948,243948
2017-01-30,99,99,99,99,1214938,26,3,1023725,191213,38,0,1214938,0,-191213,191213
2017-01-31,99,100,97,98,7758811,98,5,3258811,4500000,43,1,4758811,3000000,-1500000,1500000
2017-02-01,98,99,98,99,1332388,41,3,973971,358417,46,0,1332388,0,-358417,358417
2017-02-04,98,99,97,98,1035257,38,3,617813,417444,52,0,1035257,0,-417444,417444
2017-02-05,98,99,97,99,2037223,37,3,1610249,426974,82,0,2037223,0,-426974,426974
2017-02-06,98,99,98,98,7112333,23,3,1147284,5965049,35,2,933787,6178546,213497,-213497
2017-02-07,99,99,98,99,9471567,30,4,2337067,7134500,26,4,5341567,4130000,-3004500,3004500
2017-02-08,99,99,98,98,5857705,51,4,4709505,1148200,31,2,1316033,4541672,3393472,-3393472
2017-02-11,98,98,97,97,1730104,54,4,1073518,656586,27,2,612014,1118090,461504,-461504
2017-02-12,97,98,97,98,3085855,36,4,2153355,932500,32,3,859392,2226463,1293963,-1293963
2017-02-13,97,98,97,98,844748,34,5,356681,488067,28,2,825685,19063,-469004,469004
2017-02-14,98,99,98,99,1559137,23,3,353484,1209151,34,3,824131,738504,-470647,470647
2017-02-15,99,101,99,101,11732943,52,4,7712943,4020000,81,3,961039,10771904,6751904,-6751904
2017-02-18,101,102,99,100,6400245,46,3,1600245,4800000,34,4,453767,5946478,1146478,-1146478
2017-02-19,101,102,101,102,17746117,113,7,10494117,7252000,71,5,1852564,15893553,8641553,-8641553
2017-02-20,102,104,102,103,10168218,89,7,5757551,4410667,80,2,4378218,5790000,1379333,-1379333
2017-02-21,103,106,103,105,7908292,115,5,5483292,2425000,118,4,6367380,1540912,-884088,884088
2017-02-22,106,106,104,105,4227514,76,4,2653080,1574434,59,3,1846744,2380770,806336,-806336
2017-02-25,105,105,104,105,3288269,44,3,1232269,2056000,70,4,2304346,983923,-1072077,1072077
2017-02-26,105,105,104,105,2836176,24,4,324225,2511951,55,1,2650176,186000,-2325951,2325951
2017-02-27,104,105,104,104,3958262,34,4,734627,3223635,53,2,3680142,278120,-2945515,2945515
2017-02-28,104,104,103,104,5107207,52,3,2654207,2453000,59,2,1757887,3349320,896320,-896320
2017-03-01,104,106,103,105,6775084,45,10,2623084,4152000,69,3,5013900,1761184,-2390816,2390816
2017-03-04,106,108,104,105,4810948,123,4,4349528,461420,78,1,3460948,1350000,888580,-888580
2017-03-05,105,106,103,105,3295478,58,3,1424764,1870714,39,1,3293312,2166,-1868548,1868548
2017-03-06,103,104,103,103,2702479,54,1,2508609,193870,34,1,1647197,1055282,861412,-861412
2017-03-07,103,105,103,104,2859286,34,0,2859286,0,38,1,2689574,169712,169712,-169712
2017-03-08,105,105,103,104,3161828,52,2,2161828,1000000,55,1,2761828,400000,-600000,600000
2017-03-11,104,104,103,104,3418973,38,2,2050101,1368872,41,2,2518973,900000,-468872,468872
2017-03-12,105,105,104,104,6419153,92,4,3580610,2838543,41,3,5840949,578204,-2260339,2260339
2017-03-13,104,105,103,103,9517967,104,6,3917962,5600005,35,2,3635426,5882541,282536,-282536
2017-03-14,105,105,103,104,6006754,66,5,3723394,2283360,37,3,3993078,2013676,-269684,269684
2017-03-15,104,109,104,108,10234052,52,8,2716357,7517695,129,5,5301501,4932551,-2585144,2585144
2017-03-18,109,111,108,109,6181354,74,2,2176354,4005000,74,9,2037233,4144121,139121,-139121
2017-03-25,110,112,109,110,1490954,55,1,1480954,10000,33,1,1440629,50325,40325,-40325
2017-03-26,112,112,110,112,2974628,53,2,2666307,308321,77,4,1079570,1895058,1586737,-1586737
2017-03-27,112,113,111,112,1221519,56,1,1061519,160000,40,3,558519,663000,503000,-503000
2017-03-28,112,112,111,112,1525766,59,2,1302087,223679,37,2,905766,620000,396321,-396321
2017-03-29,112,112,110,110,8949199,124,12,5269199,3680000,48,6,1438917,7510282,3830282,-3830282
2017-04-03,111,111,109,109,2586729,93,5,1735729,851000,32,4,1880767,705962,-145038,145038
2017-04-04,111,111,108,108,881958,60,0,881958,0,26,2,674670,207288,207288,-207288
2017-04-05,110,111,109,111,15907481,58,7,8628462,7279019,75,9,4704441,11203040,3924021,-3924021
2017-04-08,111,115,110,115,22947202,66,5,4874693,18072509,131,4,4128738,18818464,745955,-745955
2017-04-09,114,117,113,117,13559787,81,5,2849357,10710430,165,7,4353386,9206401,-1504029,1504029
2017-04-10,117,117,116,117,14677146,97,6,3242305,11434841,67,4,3778482,10898664,-536177,536177
2017-04-12,119,119,117,118,20555208,78,10,2529013,18026195,55,5,3605210,16949998,-1076197,1076197
2017-04-15,118,121,117,119,7451443,62,7,2257480,5193963,90,5,3717802,3733641,-1460322,1460322
2017-04-16,119,124,119,120,14513183,100,5,4418798,10094385,114,5,5902373,8610810,-1483575,1483575
2017-04-17,123,123,119,120,7243877,46,9,1227165,6016712,70,5,2591073,4652804,-1363908,1363908
2017-04-18,122,123,119,120,5031037,37,7,1975554,3055483,53,6,658740,4372297,1316814,-1316814
2017-04-19,118,121,118,120,3843580,33,6,755472,3088108,51,5,1120111,2723469,-364639,364639
2017-04-22,121,124,120,120,13284273,81,9,2587624,10696649,111,8,6346864,6937409,-3759240,3759240
2017-04-23,120,122,120,121,1968463,29,5,645257,1323206,40,4,1262644,705819,-617387,617387
2017-04-24,121,121,120,121,4628434,36,5,1873534,2754900,55,5,2536636,2091798,-663102,663102
2017-04-26,121,121,119,120,5027579,44,4,1247214,3780365,55,5,880310,4147269,366904,-366904
2017-04-29,120,123,120,120,2274893,40,3,438156,1836737,49,4,1756021,518872,-1317865,1317865
2017-04-30,120,121,119,119,1739620,62,4,874290,865330,55,2,1731785,7835,-857495,857495
2017-05-01,121,121,119,121,6001321,22,6,1508649,4492672,86,4,2729880,3271441,-1221231,1221231
2017-05-02,122,122,120,120,5546502,31,5,1652864,3893638,52,5,2880602,2665900,-1227738,1227738
2017-05-03,120,120,119,120,1268158,23,4,192400,1075758,48,3,1077838,190320,-885438,885438
2017-05-06,120,120,118,119,1378277,47,3,892505,485772,47,1,1245134,133143,-352629,352629
2017-05-07,118,122,118,118,3289435,56,3,710600,2578835,53,3,2222503,1066932,-1511903,1511903
2017-05-08,118,120,117,118,602661,30,3,297651,305010,32,1,600661,2000,-303010,303010
2017-05-09,117,121,117,119,9760957,28,3,1134658,8626299,72,4,5306457,4454500,-4171799,4171799
2017-05-10,119,120,118,119,1843173,30,4,705992,1137181,28,4,1420873,422300,-714881,714881
2017-05-13,120,120,117,119,1146260,32,2,677343,468917,24,3,535105,611155,142238,-142238
2017-05-14,119,119,118,118,1978051,29,5,1237165,740886,34,2,1241700,736351,-4535,4535
2017-05-15,119,119,118,118,1162073,25,2,964745,197328,21,3,461093,700980,503652,-503652
2017-05-16,118,120,117,119,4524278,44,3,745896,3778382,43,5,2211059,2313219,-1465163,1465163
2017-05-17,120,120,118,119,4244692,34,5,1158511,3086181,46,5,1937202,2307490,-778691,778691
2017-05-20,120,121,119,121,5861277,46,4,2715082,3146195,57,5,869967,4991310,1845115,-1845115
2017-05-21,121,121,120,120,1753687,32,3,851831,901856,37,3,662997,1090690,188834,-188834
2017-05-22,121,121,119,120,1365009,22,4,508640,856369,40,4,897646,467363,-389006,389006
2017-05-23,120,121,119,120,762080,27,3,283216,478864,36,1,497971,264109,-214755,214755
2017-05-24,120,121,120,121,1180623,32,4,535448,645175,52,2,1094013,86610,-558565,558565
2017-05-27,121,121,120,120,859801,25,2,343423,516378,29,2,845800,14001,-502377,502377
2017-05-28,121,121,120,120,2006135,26,3,397060,1609075,43,1,1006135,1000000,-609075,609075
2017-05-29,121,122,120,121,5786103,32,4,627867,5158236,68,2,1771103,4015000,-1143236,1143236
2017-05-30,121,121,120,121,6350135,36,6,953731,5396404,49,4,2771135,3579000,-1817404,1817404
2017-05-31,121,121,120,120,776056,34,2,464948,311108,22,3,421316,354740,43632,-43632
2017-06-03,120,120,119,120,2891710,62,5,1682145,1209565,30,1,1565710,1326000,116435,-116435
2017-06-06,120,120,118,119,2034370,70,3,1554531,479839,19,3,370014,1664356,1184517,-1184517
2017-06-07,118,119,115,117,2253440,79,5,1709880,543560,38,3,1463463,789977,246417,-246417
2017-06-10,118,119,116,118,3028033,60,5,1969783,1058250,38,3,833879,2194154,1135904,-1135904
2017-06-11,118,118,117,118,2428117,35,5,1420436,1007681,39,3,847635,1580482,572801,-572801
2017-06-12,118,118,116,116,3880716,46,6,2653463,1227253,20,2,241716,3639000,2411747,-2411747
2017-06-13,118,118,116,116,12355293,84,8,7168199,5187094,29,2,640293,11715000,6527906,-6527906
2017-06-14,117,119,117,118,9531564,53,5,3980874,5550690,45,5,2162967,7368597,1817907,-1817907
2017-06-17,118,123,118,120,8338074,60,5,2421492,5916582,68,7,2072848,6265226,348644,-348644
2017-06-18,121,122,119,120,7893520,41,6,2941069,4952451,51,5,1170233,6723287,1770836,-1770836
2017-06-19,121,122,120,121,5194364,20,3,473622,4720742,84,3,2625365,2568999,-2151743,2151743
2017-06-20,121,122,121,121,14915895,33,7,1928067,12987828,60,8,2688566,12227329,-760499,760499
2017-06-21,122,122,121,121,2124126,19,4,661926,1462200,42,3,1264593,859533,-602667,602667
2017-06-24,121,122,121,122,2516986,18,3,153383,2363603,46,4,1065105,1451881,-911722,911722
2017-06-25,122,122,121,121,3629008,35,3,566066,3062942,40,4,1357125,2271883,-791059,791059
2017-06-28,122,123,120,122,6599653,33,3,611530,5988123,35,3,1661676,4937977,-1050146,1050146
2017-07-01,122,123,122,123,3300535,71,2,2243735,1056800,56,4,1521752,1778783,721983,-721983
2017-07-02,123,123,122,123,2710519,56,3,1920331,790188,39,3,1010456,1700063,909875,-909875
2017-07-03,123,123,121,122,3396978,63,4,1361960,2035018,44,5,1742381,1654597,-380421,380421
2017-07-04,123,123,121,122,2458530,64,7,1314699,1143831,38,4,854109,1604421,460590,-460590
2017-07-05,122,122,121,121,3529330,64,6,1364996,2164334,36,5,779870,2749460,585126,-585126
2017-07-08,121,121,120,121,5529059,65,6,1729773,3799286,41,3,2821987,2707072,-1092214,1092214
2017-07-09,121,121,119,120,4168413,101,6,3011403,1157010,44,5,1763614,2404799,1247789,-1247789
2017-07-10,119,121,117,118,16365375,153,10,6354865,10010510,51,5,1513834,14851541,4841031,-4841031
2017-07-11,119,125,119,122,23028101,132,12,6697066,16331035,208,10,12146421,10881680,-5449355,5449355
2017-07-17,128,129,126,128,23677523,106,5,6248220,17429303,96,9,7518523,16159000,-1270303,1270303
2017-07-18,128,131,128,129,4561272,90,5,3133103,1428169,106,3,4145349,415923,-1012246,1012246
2017-07-19,128,134,128,132,8091146,113,7,2356146,5735000,65,5,4718873,3372273,-2362727,2362727
2017-07-22,133,134,132,132,3851236,75,5,1485236,2366000,54,3,3416273,434963,-1931037,1931037
2017-07-23,133,133,132,133,2850785,44,4,666323,2184462,55,3,2545320,305465,-1878997,1878997
2017-07-24,134,134,130,130,2150994,82,6,1299395,851599,31,0,2150994,0,-851599,851599
2017-07-25,131,131,128,129,3028694,61,4,731331,2297363,38,1,2704069,324625,-1972738,1972738
2017-07-26,129,130,125,127,3007875,124,2,2135275,872600,46,0,3007875,0,-872600,872600
2017-07-29,130,130,125,127,1026114,66,2,653680,372434,29,1,1022504,3610,-368824,368824
2017-07-30,129,132,128,128,3503847,27,5,809847,2694000,67,3,2703212,800635,-1893365,1893365
2017-07-31,130,130,128,129,865209,35,3,740209,125000,30,1,854582,10627,-114373,114373
2017-08-01,129,132,127,131,4124173,47,4,874490,3249683,47,4,2815620,1308553,-1941130,1941130
2017-08-02,131,131,128,129,1863577,29,5,532557,1331020,24,3,574087,1289490,-41530,41530
2017-08-06,129,129,126,126,1714961,76,3,1664661,50300,20,1,1614961,100000,49700,-49700
2017-08-07,129,129,126,126,1024714,52,1,1001214,23500,27,1,886214,138500,115000,-115000
2017-08-08,128,128,126,127,515767,36,1,492767,23000,25,0,515767,0,-23000,23000
2017-08-09,126,128,125,126,1048912,68,1,1009912,39000,38,0,1048912,0,-39000,39000
2017-08-12,128,129,125,125,773659,52,1,738959,34700,32,1,771259,2400,-32300,32300
2017-08-13,125,127,125,126,1174141,40,3,1085141,89000,34,0,1174141,0,-89000,89000
2017-08-14,125,127,124,125,2599338,70,2,2479338,120000,21,0,2599338,0,-120000,120000
2017-08-15,126,127,124,124,1300645,86,1,1242945,57700,23,0,1300645,0,-57700,57700
2017-08-16,127,127,123,125,1247657,49,1,665616,582041,25,0,1247657,0,-582041,582041
2017-08-19,125,127,124,125,2521039,38,1,976983,1544056,42,4,1558508,962531,-581525,581525
2017-08-20,126,127,125,126,1145292,18,1,219292,926000,32,1,557992,587300,-338700,338700
2017-08-21,125,130,125,127,4383418,32,3,355789,4027629,53,9,3059208,1324210,-2703419,2703419
2017-08-22,127,128,126,127,1894960,21,2,321761,1573199,32,1,1715925,179035,-1394164,1394164
2017-08-23,128,130,126,128,1467993,30,3,725493,742500,40,1,1409993,58000,-684500,684500
2017-08-26,129,130,128,130,2058076,39,4,553933,1504143,62,3,1792045,266031,-1238112,1238112
2017-08-27,130,130,128,129,1740860,44,4,571341,1169519,32,1,1690860,50000,-1119519,1119519
2017-08-28,130,130,128,129,1331660,43,2,909160,422500,21,0,1331660,0,-422500,422500
2017-08-30,130,131,129,130,1252468,32,1,1122468,130000,26,4,642871,609597,479597,-479597
2017-09-02,131,131,129,130,6027655,42,2,5809655,218000,40,2,3529679,2497976,2279976,-2279976
2017-09-03,130,131,129,130,580048,31,1,402048,178000,43,1,579420,628,-177372,177372
2017-09-04,130,131,130,130,2052466,39,3,1096852,955614,40,1,2051852,614,-955000,955000
2017-09-05,131,135,130,134,12951341,47,2,1495617,11455724,98,3,2878507,10072834,-1382890,1382890
2017-09-06,135,137,133,136,5441404,61,4,2517904,2923500,67,2,2625437,2815967,-107533,107533
2017-09-10,137,137,134,134,5042838,55,1,1042838,4000000,36,1,3421952,1620886,-2379114,2379114
2017-09-11,134,136,134,134,6088642,60,2,988642,5100000,34,2,1277550,4811092,-288908,288908
2017-09-12,136,136,134,134,2009494,34,2,1009494,1000000,43,2,1291274,718220,-281780,281780
2017-09-13,134,134,133,133,878973,55,0,878973,0,49,1,868973,10000,10000,-10000
2017-09-16,133,136,130,130,5519673,73,1,1787798,3731875,38,2,1242236,4277437,545562,-545562
2017-09-17,133,133,130,133,599761,40,0,599761,0,26,1,443761,156000,156000,-156000
2017-09-18,133,133,132,133,490368,33,1,468318,22050,20,3,283908,206460,184410,-184410
2017-09-19,134,138,133,137,2043473,34,7,823473,1220000,92,3,1903837,139636,-1080364,1080364
2017-09-20,138,138,136,136,1286784,45,1,1236784,50000,32,2,718436,568348,518348,-518348
2017-09-23,137,139,136,136,1191565,35,1,1137565,54000,35,2,354626,836939,782939,-782939
2017-09-24,135,136,134,134,2863763,79,1,2477763,386000,28,5,1364833,1498930,1112930,-1112930
2017-09-25,134,135,133,134,1669846,50,0,1669846,0,27,1,1569846,100000,100000,-100000
2017-09-26,134,134,133,134,2630977,61,2,1310977,1320000,23,4,613559,2017418,697418,-697418
2017-09-27,133,134,133,134,2103636,37,0,2103636,0,28,1,2098553,5083,5083,-5083
2017-10-02,135,135,133,134,2604330,43,1,2224330,380000,34,2,1400930,1203400,823400,-823400
2017-10-03,133,134,133,134,1034763,26,1,834763,200000,35,2,891107,143656,-56344,56344
2017-10-04,133,136,133,135,6633534,39,2,6383534,250000,33,6,564945,6068589,5818589,-5818589
2017-10-07,135,135,133,134,8155399,36,2,759199,7396200,40,4,954399,7201000,-195200,195200
2017-10-08,133,135,130,135,5275751,68,4,957968,4317783,49,3,2105690,3170061,-1147722,1147722
2017-10-09,131,135,131,132,1054035,41,2,479035,575000,35,4,521035,533000,-42000,42000
2017-10-10,133,134,133,133,383200,13,2,267129,116071,13,3,70908,312292,196221,-196221
2017-10-11,133,135,133,133,518850,28,1,428850,90000,14,1,469052,49798,-40202,40202
2017-10-14,132,134,132,133,801766,36,2,466966,334800,22,2,440614,361152,26352,-26352
2017-10-15,132,133,132,133,1055775,39,2,815775,240000,21,1,922172,133603,-106397,106397
2017-10-16,133,133,133,133,778949,37,2,593909,185040,31,1,650350,128599,-56441,56441
2017-10-17,133,133,132,132,1420422,39,4,1211405,209017,36,3,1172405,248017,39000,-39000
2017-10-18,133,133,132,133,5291747,29,4,545932,4745815,49,4,1003870,4287877,-457938,457938
2017-10-21,133,133,133,133,1957341,42,3,1210798,746543,33,6,678631,1278710,532167,-532167
2017-10-22,133,133,131,132,1117857,69,3,883276,234581,35,2,895278,222579,-12002,12002
2017-10-23,132,137,131,133,3328343,89,3,2196034,1132309,42,4,2241951,1086392,-45917,45917
2017-10-24,134,137,132,133,1076089,30,3,283433,792656,32,0,1076089,0,-792656,792656
2017-10-25,133,137,133,135,9863268,38,2,4393268,5470000,43,2,9723268,140000,-5330000,5330000
2017-10-28,134,137,134,134,1241725,35,1,741725,500000,47,4,855765,385960,-114040,114040
2017-10-29,134,135,133,135,3315959,60,4,2035959,1280000,39,1,2815959,500000,-780000,780000
2017-10-30,136,136,133,135,730760,24,3,603542,127218,30,2,614760,116000,-11218,11218
2017-10-31,135,136,134,136,1042143,33,1,842143,200000,35,2,742143,300000,100000,-100000
2017-11-01,135,136,134,135,4620393,50,2,4233572,386821,14,1,4618529,1864,-384957,384957
2017-11-04,135,136,134,135,1875715,27,3,530715,1345000,21,3,988306,887409,-457591,457591
2017-11-05,134,136,134,136,1414225,36,0,1414225,0,31,3,1015436,398789,398789,-398789
2017-11-06,136,136,134,134,3471182,66,5,2925460,545722,19,2,3165432,305750,-239972,239972
2017-11-07,134,135,134,134,1124472,20,2,1104462,20010,13,1,1120862,3610,-16400,16400
2017-11-08,134,134,134,134,713887,29,1,513177,200710,12,0,713887,0,-200710,200710
2017-11-11,134,135,134,134,3026760,26,2,672317,2354443,21,2,526760,2500000,145557,-145557
2017-11-12,134,135,134,135,585712,22,1,435712,150000,20,1,485712,100000,-50000,50000
2017-11-13,134,135,134,135,4635996,28,1,4435996,200000,20,2,431992,4204004,4004004,-4004004
2017-11-14,135,135,134,135,1668515,49,3,915299,753216,21,3,612215,1056300,303084,-303084
2017-11-15,135,135,134,134,1728439,38,2,485035,1243404,26,1,728439,1000000,-243404,243404
2017-11-18,135,135,134,134,946004,28,2,836004,110000,13,3,775945,170059,60059,-60059
2017-11-20,135,136,135,135,2845492,19,2,1395492,1450000,29,1,2745492,100000,-1350000,1350000
2017-11-21,134,135,134,134,3850796,36,2,3840796,5010000,23,3,578693,8272103,3262103,-3262103
2017-11-22,137,138,136,136,3888950,72,3,1828950,2060000,53,6,1474833,2414117,354117,-354117
2017-11-25,136,139,136,139,19211007,220,5,11199007,8012000,56,6,2014077,17196930,9184930,-9184930
2017-11-26,139,142,138,141,17029468,74,4,13331768,3697700,58,3,1727426,15302042,11604342,-11604342
2017-11-28,141,147,141,147,58740297,437,34,43476522,15263775,138,10,5100297,53640000,38376225,-38376225
2017-11-29,151,151,145,146,9033599,193,8,6813599,2220000,219,8,3366851,5666748,3446748,-3446748
2017-12-02,147,148,144,144,3875550,120,1,3259036,616514,67,5,1493855,2381695,1765181,-1765181
2017-12-03,146,146,144,145,5313198,66,5,3698273,1614925,64,3,1668181,3645017,2030092,-2030092
2017-12-04,143,145,143,144,3578259,22,4,969948,2608311,39,2,1577259,2001000,-607311,607311
2017-12-05,144,145,142,143,3234700,63,4,2721843,512857,58,7,2538693,696007,183150,-183150
2017-12-09,142,145,142,145,1661107,18,5,345768,1315339,47,1,1623333,37774,-1277565,1277565
2017-12-10,143,144,142,143,2424728,51,6,1179728,1245000,37,2,2145728,279000,-966000,966000
2017-12-11,142,143,142,142,2187712,66,2,1995811,191901,49,0,2187712,0,-191901,191901
2017-12-12,142,145,142,142,5560944,103,5,3962845,1598099,64,5,2907101,2653843,1055744,-1055744
2017-12-13,143,149,142,147,23096901,208,17,14477101,8619800,115,11,4580073,18516828,9897028,-9897028
2017-12-16,149,153,149,150,13205931,192,3,10285931,2920000,82,10,4453436,8752495,5832495,-5832495
2017-12-17,152,152,146,146,12152419,239,6,8344865,3807554,66,3,3088219,9064200,5256646,-5256646
2017-12-18,149,149,145,147,2542110,68,1,1098219,1443891,45,3,1093753,1448357,4466,-4466
2017-12-19,147,147,144,144,5637028,153,4,2737028,2900000,48,3,2527028,3110000,210000,-210000
2017-12-20,145,147,144,146,1964804,31,1,655949,326453,52,2,769912,212490,-113963,113963
2017-12-23,146,149,145,146,3295165,115,3,2885365,409800,31,2,1347363,1947802,1538002,-1538002
2017-12-24,146,149,146,149,4033150,61,5,1247700,2785450,70,1,3733150,300000,-2485450,2485450
2017-12-25,149,149,147,149,5219597,26,2,831285,95000,36,1,726285,200000,105000,-105000
2017-12-26,149,152,148,150,7852131,54,5,3045990,5006141,87,0,8052131,0,-5006141,5006141
2017-12-27,150,152,150,151,5593804,59,4,3236604,2357200,80,1,5393804,200000,-2157200,2157200
2017-12-30,149,149,144,149,2827633,78,2,1945933,882700,65,2,2777633,51000,-831700,831700
2017-12-31,144,151,142,146,10020467,135,5,2732812,7294655,145,3,9487467,540000,-6754655,6754655
2018-01-01,147,150,147,149,1732482,22,1,1162911,569571,54,1,1683482,49000,-520571,520571
2018-01-02,150,150,148,148,3490277,28,4,1229251,2261026,45,1,3457943,32334,-2228692,2228692
2018-01-03,150,150,148,149,3302832,24,2,341416,1310000,41,1,1648481,2935,-1307065,1307065
2018-01-06,150,150,149,149,547470,27,3,422907,124563,34,0,547470,0,-124563,124563
2018-01-07,149,151,148,149,2700293,49,2,1117793,1582500,47,2,2500293,200000,-1382500,1382500
2018-01-08,149,150,146,147,2351968,67,8,870887,1481081,20,1,1451968,900000,-581081,581081
2018-01-09,146,149,146,147,901680,22,3,368323,533357,24,1,744555,157125,-376232,376232
2018-01-10,148,149,147,148,910418,23,2,490473,419945,34,4,389724,520694,100749,-100749
2018-01-13,148,149,146,147,2249017,67,3,1632991,616026,26,2,1733017,516000,-100026,100026
2018-01-14,149,149,147,148,2227659,38,4,1108092,1119567,53,5,1771286,456373,-663194,663194
2018-01-15,147,149,147,149,18537439,62,4,5286839,13250600,50,5,2389483,16147956,2897356,-2897356
2018-01-16,149,152,149,151,2485077,70,2,2065077,420000,80,3,2015787,469290,49290,-49290
2018-01-17,152,154,152,152,3817369,75,3,2612759,1204610,85,7,1465916,2351453,1146843,-1146843
2018-01-20,154,154,152,154,2683254,61,1,2592612,90642,54,3,2251689,431565,340923,-340923
2018-01-21,153,153,151,153,2003694,45,3,1237694,766000,47,3,1766585,237109,-528891,528891
2018-01-22,153,155,153,154,1540811,82,0,1540811,0,41,4,950812,589999,589999,-589999
2018-01-23,154,158,153,157,2887687,56,1,2187687,700000,72,4,2143899,743788,43788,-43788
2018-01-24,156,167,156,162,12037879,178,3,11582879,455000,130,11,5448931,6588948,6133948,-6133948
2018-01-27,164,166,161,164,13494166,106,2,9427166,4067000,97,30,3929826,9564340,5497340,-5497340
2018-01-28,165,165,160,160,3231722,105,2,3085895,145827,54,4,2142177,1089545,943718,-943718
2018-01-29,162,162,157,157,3554114,106,2,3142264,411850,49,12,2764926,789188,377338,-377338
2018-01-30,157,162,156,159,3840222,80,7,1737107,2103115,92,8,2941693,898529,-1204586,1204586
2018-01-31,159,163,157,162,4327195,31,5,334973,3992222,65,13,2801962,1525233,-2466989,2466989
2018-02-03,162,162,157,160,2258739,63,4,1373959,884780,31,4,1207294,1051445,166665,-166665
2018-02-04,160,162,157,160,3357855,47,3,538427,2819428,53,6,2248855,1109000,-1710428,1710428
2018-02-05,160,161,160,160,5112779,57,6,1105418,4007361,55,5,2986779,2126000,-1881361,1881361
2018-02-06,162,162,159,159,1476536,42,4,668336,808200,54,3,868474,608062,-200138,200138
2018-02-07,158,160,158,159,1841343,45,3,832434,1008909,38,5,703776,1137567,128658,-128658
2018-02-10,160,162,158,159,4672250,46,5,1203183,3458867,36,7,2426234,2235816,-1223051,1223051
2018-02-12,159,161,158,159,2429223,57,3,1704223,725000,40,4,1085586,1343637,618637,-618637
2018-02-13,158,159,154,156,11506859,236,8,9225212,2281647,28,5,2717106,8789753,6508106,-6508106
2018-02-14,160,161,158,159,10067725,175,4,8844939,1222786,92,8,2127723,7940002,6717216,-6717216
2018-02-17,160,161,158,159,3539712,81,1,3310924,228788,44,8,1256919,2282793,2054005,-2054005
2018-02-18,159,160,159,160,3642342,51,1,1642342,2000000,49,3,1142076,2500266,500266,-500266
2018-02-19,160,160,159,159,3267021,63,4,1266689,2000332,42,3,747257,2519764,519432,-519432
2018-02-21,159,160,157,157,19147950,102,6,6056950,13091000,28,5,313233,18834717,5743717,-5743717
2018-02-24,159,159,155,157,3262416,92,3,1684019,1578397,46,6,1444396,1818020,239623,-239623
2018-02-25,159,159,156,157,1107796,50,3,875565,232231,25,2,867150,240646,8415,-8415
2018-02-26,159,160,157,158,1418831,49,2,688831,730000,33,3,561742,857089,127089,-127089
2018-02-27,157,161,157,159,9664112,69,5,6564860,3099252,42,2,1104913,8559199,5459947,-5459947
2018-02-28,157,160,157,158,16558663,58,4,4617206,11941457,30,3,3025642,13533021,1591564,-1591564
2018-03-03,159,160,158,158,5532899,45,2,3132899,2400000,59,6,2550534,2982365,582365,-582365
2018-03-04,160,160,158,159,6851449,62,2,5990110,861339,38,3,550949,6300500,5439161,-5439161
2018-03-05,159,160,157,157,4535047,59,1,4503331,31716,21,4,393898,4141149,4109433,-4109433
2018-03-06,157,160,157,159,7726625,46,2,6406625,1320000,42,6,890716,6835909,5515909,-5515909
2018-03-07,159,160,158,159,2627612,63,3,1367612,1260000,38,4,861240,1766372,506372,-506372
2018-03-10,159,159,158,158,1492709,66,3,1346159,146550,24,0,1492709,0,-146550,146550
2018-03-11,158,160,158,159,2427717,56,3,1761617,666100,44,8,1245228,1182489,516389,-516389
2018-03-12,159,160,158,158,4461837,48,4,3159837,1302000,36,5,1570379,2891458,1589458,-1589458
2018-03-13,158,160,158,159,6927092,70,9,5037092,1890000,28,5,2499180,4427912,2537912,-2537912
2018-03-17,160,164,160,162,6288454,117,4,5288454,1000000,63,9,1146695,5141759,4141759,-4141759
2018-03-19,163,167,163,166,10703632,111,5,6715828,3987804,88,9,3566728,7136904,3149100,-3149100
2018-03-26,168,168,165,166,2842105,73,3,1905983,936122,47,5,949865,1892240,956118,-956118
2018-03-27,167,168,166,168,8351967,54,13,1637358,6714609,64,3,2857467,5494500,-1220109,1220109
2018-03-28,168,169,167,167,3911112,87,6,2402679,1508433,41,5,1410054,2501058,992625,-992625
2018-04-03,168,168,167,167,1769183,77,1,1646792,122391,36,5,695952,1073231,950840,-950840
2018-04-04,168,168,167,168,2020018,71,0,2020018,0,50,4,1299793,720225,720225,-720225
2018-04-07,168,168,165,166,1597152,73,1,1577851,19301,47,5,1296539,300613,281312,-281312
2018-04-08,165,167,161,161,2547162,114,3,2027162,520000,44,2,2243532,303630,-216370,216370
2018-04-09,165,165,163,164,3995736,98,5,2561676,1434060,64,5,2865230,1130506,-303554,303554
2018-04-10,158,164,158,160,930086,70,1,918150,11936,26,1,885086,45000,33064,-33064
2018-04-11,160,164,157,159,2385936,99,2,1495936,890000,50,0,2385936,0,-890000,890000
2018-04-15,162,162,156,156,2133667,90,2,1733667,400000,30,0,2133667,0,-400000,400000
2018-04-16,157,157,155,156,1708700,47,3,1052695,656005,34,1,1674700,34000,-622005,622005
2018-04-17,157,157,155,155,1790911,102,2,1655911,135000,29,0,1790911,0,-135000,135000
2018-04-18,155,156,154,154,2342020,114,6,1644227,697793,26,1,2107020,235000,-462793,462793
2018-04-21,155,155,152,152,5259590,129,6,3094195,2165395,28,2,4331764,927826,-1237569,1237569
2018-04-22,152,152,150,152,3159929,85,6,956238,2203691,34,2,2080503,1079426,-1124265,1124265
2018-04-23,153,154,151,154,1054426,48,3,385713,668713,33,2,996895,57531,-611182,611182
2018-04-24,154,157,153,157,1844316,53,2,1413225,431091,31,2,1684316,160000,-271091,271091
2018-04-25,157,157,154,154,8118240,69,3,5475558,2642682,26,1,8116245,1995,-2640687,2640687
2018-04-28,156,156,152,153,1818432,58,2,1332672,485760,34,1,1766569,51863,-433897,433897
2018-04-29,153,154,151,152,2942817,78,1,2707929,234888,19,2,2934356,8461,-226427,226427
2018-04-30,153,153,150,151,1126064,83,1,1105064,21000,16,1,1070464,55600,34600,-34600
2018-05-01,152,153,149,151,2142069,80,3,1632069,510000,22,2,1905119,236950,-273050,273050
2018-05-05,150,151,148,149,2543862,77,2,1643862,900000,43,0,2543862,0,-900000,900000
2018-05-06,150,150,148,149,1695269,58,1,1495269,200000,25,0,1695269,0,-200000,200000
2018-05-07,149,154,149,152,1871441,32,3,1291441,580000,25,1,857553,1013888,433888,-433888
2018-05-08,154,154,152,152,2473112,63,5,1728472,744640,31,0,2473112,0,-744640,744640
2018-05-09,152,154,150,150,9099808,49,5,1359553,7740255,62,8,6955558,2144250,-5596005,5596005
2018-05-12,153,153,153,153,2655309,38,5,489342,2165967,20,4,1485940,1169369,-996598,996598
2018-05-13,154,155,153,154,3234737,66,6,2724590,510147,36,7,1372817,1861920,1351773,-1351773
2018-05-14,155,158,155,157,3902213,66,6,2338713,1563500,42,6,1748024,2154189,590689,-590689
2018-05-15,158,158,155,156,2326660,65,6,1447568,879092,28,2,1444161,882499,3407,-3407
2018-05-16,157,160,156,158,3254420,45,4,936922,2317498,56,5,1624541,1629879,-687619,687619
2018-05-19,159,159,158,159,1558441,52,2,1018441,540000,27,2,698060,860381,320381,-320381
2018-05-20,159,159,155,156,1558633,88,1,1433633,125000,20,3,671062,887571,762571,-762571
2018-05-21,157,157,155,156,1804851,45,2,660727,1144124,32,1,839552,965299,-178825,178825
2018-05-22,158,158,152,156,3433488,112,6,1868542,1564946,28,1,2609075,824413,-740533,740533
2018-05-23,156,157,153,157,3792152,75,4,1091903,2700249,34,2,2435618,1356534,-1343715,1343715
2018-05-26,156,158,156,158,2842836,50,4,1322086,1520750,40,2,592836,2250000,729250,-729250
2018-05-27,157,158,156,157,1527513,43,3,609160,918353,23,2,529541,997972,79619,-79619
2018-05-28,157,158,156,156,3540323,62,4,1875322,1665001,13,3,968736,2571587,906586,-906586
2018-05-29,157,157,155,156,1965341,53,4,788461,1176880,22,2,273644,1691697,514817,-514817
2018-05-30,156,157,155,157,3762871,36,3,498211,3264660,32,4,1952984,1809887,-1454773,1454773
2018-06-02,157,161,156,160,7046901,67,2,5202249,1844652,92,4,2664292,4382609,2537957,-2537957
2018-06-03,160,162,160,160,5927103,57,5,3681017,2246086,70,4,791765,5135338,2889252,-2889252
2018-06-09,162,165,159,162,3942694,78,2,2984646,958048,79,4,1691669,2251025,1292977,-1292977
2018-06-10,161,165,160,162,2808419,67,4,1180176,1628243,68,3,1533453,1274966,-353277,353277
2018-06-11,164,167,163,164,14627720,73,5,5793147,8822490,54,2,1494391,13121246,4298756,-4298756
2018-06-12,163,167,163,166,28387770,64,5,19634213,8753557,61,9,1586434,26801336,18047779,-18047779
2018-06-13,167,173,167,171,19927824,176,5,13127824,6800000,98,8,2820170,17107654,10307654,-10307654
2018-06-17,173,179,173,179,62992289,245,7,50289032,12703257,87,16,2883115,60109174,47405917,-47405917
2018-06-18,188,188,182,186,153234358,771,20,105949204,47285154,309,39,28874423,124359935,77074781,-77074781
2018-06-19,185,197,179,193,42137490,498,15,27081050,15056440,313,11,30117825,12019665,-3036775,3036775
2018-06-20,195,202,195,202,11622109,150,3,8069768,3552341,141,8,6627092,4995017,1442676,-1442676
2018-06-23,197,200,193,196,17842207,211,9,9319923,8522284,205,14,12019431,5822776,-2699508,2699508
2018-06-24,195,207,195,207,34647134,302,12,19185741,15440000,242,17,12146380,22479361,7039361,-7039361
2018-06-25,216,226,214,219,14113779,255,3,13822779,291000,114,7,9894685,4219094,3928094,-3928094
2018-06-26,207,207,197,201,20330385,197,9,8252406,12077979,184,3,15794610,4535775,-7542204,7542204
2018-06-27,203,204,194,195,48431242,299,11,18264799,30166443,241,4,40968012,7463230,-22703213,22703213
2018-06-30,195,200,189,190,9587386,157,5,4029386,5558000,116,4,7880916,1706470,-3851530,3851530
2018-07-01,197,197,185,185,20831898,190,11,9261346,11570552,141,7,13649701,7182197,-4388355,4388355
2018-07-02,183,192,183,191,11804320,130,6,7524320,4280000,95,8,3088856,8715464,4435464,-4435464
2018-07-03,189,198,189,195,13889561,135,5,7367117,6522444,111,12,4480071,9409490,2887046,-2887046
2018-07-04,199,199,193,195,6602950,121,13,2210736,4392214,129,4,4601777,2001173,-2391041,2391041
2018-07-07,193,196,191,195,4794773,87,3,2790273,2004500,88,2,4644773,150000,-1854500,1854500
2018-07-08,193,202,192,200,20189675,129,10,6694946,13494729,219,11,7747827,12441848,-1052881,1052881
2018-07-10,200,204,197,200,10497678,89,4,4418993,6078685,150,11,5848550,4649128,-1429557,1429557
2018-07-11,199,202,195,202,18282648,177,4,9754076,8528572,166,4,6965648,11317000,2788428,-2788428
2018-07-16,204,204,199,200,20688970,93,11,3788970,16900000,134,6,16201603,4487367,-12412633,12412633
2018-07-17,197,202,195,198,13058213,120,6,3211371,9846842,118,3,7832955,5225258,-4621584,4621584
2018-07-18,198,200,193,196,11415618,115,9,3787147,7628471,89,3,7195236,4220382,-3408089,3408089
2018-07-21,193,196,193,193,3403743,77,2,991828,2411915,54,1,2817943,585800,-1826115,1826115
2018-07-22,196,205,196,201,19730233,250,7,15861233,3869000,149,3,7517530,12212703,8343703,-8343703
2018-07-23,204,204,200,201,3251452,99,1,3151452,100000,80,5,2354502,896950,796950,-796950
2018-07-24,205,205,201,202,4581951,95,4,2884209,1697742,70,3,2271951,2310000,612258,-612258
2018-07-25,203,203,198,202,3289236,76,3,1415404,1873832,75,0,3289236,0,-1873832,1873832
2018-07-28,204,211,204,211,24397837,232,13,16523534,7874303,141,27,5916828,18481009,10606706,-10606706
2018-07-29,215,219,212,218,14572741,181,8,6834557,7738184,213,10,12125630,2447111,-5291073,5291073
2018-07-30,215,227,215,227,16186802,133,11,10586802,5600000,123,18,4432145,11754657,6154657,-6154657
2018-07-31,237,237,237,237,12811769,115,2,6111769,6700000,28,6,620025,12191744,5491744,-5491744
2018-08-01,249,249,249,249,5068613,23,10,2567798,2500815,20,4,821585,4247028,1746213,-1746213
2018-08-04,249,259,244,245,29143276,391,12,22083581,7059695,265,15,20328705,8814571,1754876,-1754876
2018-08-05,251,263,250,260,42247672,667,12,33350121,8897551,335,14,22678995,19568677,10671126,-10671126
2018-08-06,275,275,266,266,64255523,692,14,46979902,17275621,323,23,21863306,42392217,25116596,-25116596
2018-08-07,261,284,261,261,24906618,347,7,10466618,14440000,319,15,22487518,2419100,-12020900,12020900
2018-08-08,254,259,252,252,14479246,208,7,5039246,9440000,196,4,13796062,683184,-8756816,8756816
2018-08-11,241,250,239,241,13857941,292,4,7057941,6800000,228,3,12757941,1100000,-5700000,5700000
2018-08-12,239,250,239,241,4880392,151,2,2850392,2030000,117,3,3516463,1363929,-666071,666071
2018-08-13,247,247,235,241,6733774,131,2,4416575,2317199,80,3,4985974,1747800,-569399,569399
2018-08-14,243,252,243,248,14260224,212,6,9662360,4597864,200,8,10465378,3794846,-803018,803018
2018-08-15,243,248,243,246,2884823,73,4,1564537,1320286,67,2,2794823,90000,-1230286,1230286
2018-08-18,246,250,239,247,5319879,126,4,2074438,3245441,127,1,5225638,94241,-3151200,3151200
2018-08-19,248,254,245,246,4149332,169,2,4089332,60000,102,1,3287692,861640,801640,-801640
2018-08-20,250,255,245,254,10042934,130,5,3751784,6291150,191,1,7744855,2298079,-3993071,3993071
2018-08-21,254,254,243,246,7454877,248,2,6813997,640880,84,2,3003281,4451596,3810716,-3810716
2018-08-25,251,251,241,242,7133334,231,4,4983334,2150000,112,1,5133334,2000000,-150000,150000
2018-08-26,241,245,235,243,10760272,319,5,8853104,1907168,130,2,6384297,4375975,2468807,-2468807
2018-08-27,246,247,243,245,11446688,49,1,1572848,4100000,37,1,1672848,4000000,-100000,100000
2018-08-29,247,255,246,247,8987222,255,2,8837222,150000,101,5,5069710,3917512,3767512,-3767512
2018-09-01,249,249,242,245,5534790,208,1,4107243,1427547,98,2,5214942,319848,-1107699,1107699
2018-09-02,245,245,238,241,6149556,166,2,3335243,2814313,96,2,4776083,1373473,-1440840,1440840
2018-09-03,241,243,238,239,5862138,144,3,3548851,2313287,66,3,2806824,3055314,742027,-742027
2018-09-04,243,246,240,241,5389199,177,2,3738704,1650495,94,2,4219284,1169915,-480580,480580
2018-09-05,242,245,240,241,14235481,150,2,3290604,10944877,87,2,4235481,10000000,-944877,944877
2018-09-08,241,246,240,245,18501074,187,5,4345187,14155887,177,4,6057381,12443693,-1712194,1712194
2018-09-09,246,255,246,254,13884275,302,4,10061896,3822379,261,5,9326747,4557528,735149,-735149
2018-09-10,255,262,255,261,23276628,254,4,10866345,12410283,261,11,10435829,12840799,430516,-430516
2018-09-11,261,261,254,258,10095227,210,1,6975227,3120000,204,1,7095227,3000000,-120000,120000
2018-09-12,268,271,268,271,73711696,382,7,36154149,37557547,194,10,14575696,59136000,21578453,-21578453
2018-09-15,285,285,272,276,50787509,837,21,42662514,8124995,299,12,32101100,18686409,10561414,-10561414
2018-09-16,278,278,269,276,15356106,428,9,13863259,1492847,261,2,13349106,2007000,514153,-514153
2018-09-17,281,284,274,274,9041074,307,2,8536074,505000,242,5,7838147,1202927,697927,-697927
2018-09-18,279,279,266,268,21142507,673,21,17170507,3972000,133,4,5523626,15618881,11646881,-11646881
2018-09-22,276,277,267,269,15780169,519,1,15746169,34000,230,5,6477622,9302547,9268547,-9268547
2018-09-23,274,280,273,277,20672346,435,4,19242346,1430000,268,6,12768177,7904169,6474169,-6474169
2018-09-24,281,287,278,287,17122320,442,2,14461848,2660472,324,7,10801952,6320368,3659896,-3659896
2018-09-25,290,297,287,292,58232780,822,4,40827040,17405740,283,15,26275558,31957222,14551482,-14551482
2018-09-26,308,308,294,302,27687540,785,4,26037540,1650000,324,10,16589215,11098325,9448325,-9448325
2018-09-29,314,314,310,314,69358407,1360,13,64885407,4473000,330,14,13422343,55936064,51463064,-51463064
2018-09-30,329,329,328,329,66788255,1294,26,52617755,14170500,186,17,12813325,53974930,39804430,-39804430
2018-10-01,326,326,313,313,36219385,832,7,29959385,6260000,235,1,35219385,1000000,-5260000,5260000
2018-10-02,300,300,285,285,36281054,378,5,29876956,6404098,244,0,36281054,0,-6404098,6404098
2018-10-03,276,290,276,288,40614236,725,4,35172088,5442148,771,6,37372088,3242148,-2200000,2200000
2018-10-06,292,293,266,267,34653329,725,8,27095704,7557625,470,7,28961393,5691936,-1865689,1865689
2018-10-07,264,271,260,260,44995938,465,41,19909863,25086075,396,6,42487951,2507987,-22578088,22578088
2018-10-08,256,270,250,263,16019998,379,6,13721703,2298295,499,4,15474998,545000,-1753295,1753295
2018-10-09,272,272,268,272,14936641,325,1,14836641,100000,130,5,10127502,4809139,4709139,-4709139
2018-10-10,267,273,262,266,11218770,393,2,10698770,520000,196,2,11160785,57985,-462015,462015
2018-10-13,267,267,253,253,15440995,361,5,7940995,7500000,354,1,14940995,500000,-7000000,7000000
2018-10-14,246,267,246,256,3783037,78,3,2749559,1033478,129,1,3641837,141200,-892278,892278
2018-10-15,261,267,261,267,21045905,489,4,19562085,1483820,236,9,11012754,10033151,8549331,-8549331
2018-10-16,272,279,268,272,19492735,364,9,9665821,9826914,255,8,14625057,4867678,-4959236,4959236
2018-10-17,269,274,265,270,11407814,208,2,9664154,1743660,276,3,9123852,2283962,540302,-540302
2018-10-20,273,282,273,280,9544020,391,2,9458320,85700,207,3,6446047,3097973,3012273,-3012273
2018-10-21,281,281,271,275,9283079,301,2,7192233,2090846,245,1,7873109,1409970,-680876,680876
2018-10-22,272,278,269,272,11136711,251,4,6577747,4548964,249,0,11126711,0,-4548964,4548964
2018-10-23,280,285,272,279,12457238,348,3,11355648,1101590,349,4,11415307,1041931,-59659,59659
2018-10-24,280,280,269,271,5918711,302,3,5318378,600333,203,1,5408241,510470,-89863,89863
2018-10-27,280,286,272,272,20359253,332,4,16808931,3550322,359,6,10777553,9581700,6031378,-6031378
2018-10-28,277,282,274,281,11746113,311,4,9853915,1892198,183,2,6565517,5180596,3288398,-3288398
2018-10-29,281,285,277,283,10733438,291,5,5522234,5211204,251,5,9343427,1390011,-3821193,3821193
2018-10-31,282,289,279,282,6501341,184,8,3100341,3401000,182,1,6401341,100000,-3301000,3301000
2018-11-03,281,284,275,281,7723053,179,4,3153053,4570000,205,1,6811752,911301,-3658699,3658699
2018-11-04,279,284,272,276,6498793,201,4,5122093,1376700,167,1,5498793,1000000,-376700,376700
2018-11-05,273,281,273,278,4028092,131,4,2087492,1940600,145,2,3349017,679075,-1261525,1261525
2018-11-06,277,281,274,278,9155884,194,4,3869269,5286615,275,3,7358668,1797216,-3489399,3489399
2018-11-10,278,285,274,278,5796412,141,3,2665289,3131123,183,1,5536412,260000,-2871123,2871123
2018-11-11,277,277,269,271,5866192,223,4,5245358,620834,108,1,5865891,301,-620533,620533
2018-11-12,275,276,273,275,3491121,125,3,2162845,1328276,121,2,2393736,1097385,-230891,230891
2018-11-13,274,277,271,272,6659431,168,5,2934431,3725000,158,2,5191176,1468255,-2256745,2256745
2018-11-14,273,278,269,272,5308103,98,4,2056703,3251400,196,1,4778350,529753,-2721647,2721647
2018-11-17,270,270,259,260,5684942,314,1,5634942,50000,307,0,5684942,0,-50000,50000
2018-11-18,261,269,255,260,5702482,293,4,3515694,2186788,205,1,5648627,53855,-2132933,2132933
2018-11-19,263,267,259,261,4100954,189,3,2326879,1774075,144,1,4032257,68697,-1705378,1705378
2018-11-20,266,266,259,261,3993471,148,4,2176018,1817453,125,1,3956793,36678,-1780775,1780775
2018-11-21,261,264,259,261,4580406,162,4,2821220,1759186,108,1,4550406,30000,-1729186,1729186
2018-11-24,250,263,248,254,7814593,262,4,3064554,4750039,176,3,6614591,1200002,-3550037,3550037
2018-11-26,254,254,244,248,4492621,219,3,2192621,2300000,182,2,4387926,104695,-2195305,2195305
2018-11-27,252,254,250,251,4032309,217,1,2332309,1700000,126,3,3184399,847910,-852090,852090
2018-11-28,253,253,246,246,2715406,201,3,2195406,520000,79,2,2643689,71717,-448283,448283
2018-12-01,246,250,237,247,8456211,176,5,2614299,5841912,230,2,8339103,117108,-5724804,5724804
2018-12-02,247,253,246,252,3397086,166,3,2838543,558543,122,0,3397086,0,-558543,558543
2018-12-03,253,261,253,260,2558219,154,1,2058219,500000,138,1,2541964,16255,-483745,483745
2018-12-04,260,260,252,257,2323542,133,1,2023542,300000,135,3,2085081,238461,-61539,61539
2018-12-05,257,266,254,261,4430447,114,1,2430447,2000000,150,2,3202066,1228381,-771619,771619
2018-12-08,262,268,257,259,5549722,156,6,2961210,2588512,116,2,2399118,3150604,562092,-562092
2018-12-09,259,261,256,256,1706511,103,4,1436511,270000,104,0,1706511,0,-270000,270000
2018-12-10,258,267,255,263,4189284,122,3,1239213,2950071,150,1,4154453,34831,-2915240,2915240
2018-12-11,262,267,260,264,1803934,45,3,763128,1040806,118,1,1803923,11,-1040795,1040795
2018-12-12,264,264,257,260,1472246,108,1,1429706,42540,90,1,1436401,35845,-6695,6695
2018-12-15,259,259,255,256,1430971,150,1,1325671,105300,61,1,1350234,80737,-24563,24563
2018-12-16,255,264,252,254,2168006,132,2,1733006,435000,77,0,2168006,0,-435000,435000
2018-12-17,252,255,249,251,3631356,216,5,2243212,1388144,85,2,2570344,1061012,-327132,327132
2018-12-18,252,259,249,253,3733542,87,3,1232052,2501490,130,2,3702760,30782,-2470708,2470708
2018-12-19,254,254,247,253,2044168,99,3,738662,1305506,76,1,2044158,10,-1305496,1305496
2018-12-22,252,252,246,250,1566659,85,2,1387738,178921,56,2,1462199,104460,-74461,74461
2018-12-23,251,258,251,254,2554632,99,1,2504632,50000,104,1,2532959,21673,-28327,28327
2018-12-24,254,257,253,253,1821018,69,2,1671018,150000,61,2,1151561,669457,519457,-519457
2018-12-25,254,259,252,253,2171540,94,3,888040,1283500,81,2,1332348,839192,-444308,444308
2018-12-26,256,258,250,255,4813071,133,1,4768371,44700,122,2,3377719,1435352,1390652,-1390652
2018-12-29,255,262,255,258,4230477,140,2,3380477,850000,114,3,2167372,2063105,1213105,-1213105
2018-12-30,256,258,254,256,3555828,134,3,2655828,900000,74,1,2886187,669641,-230359,230359
2018-12-31,256,258,254,255,3004512,115,3,2034143,970369,69,4,1775257,1229255,258886,-258886
2019-01-01,258,258,252,253,2904450,142,1,2804450,100000,69,1,2660934,243516,143516,-143516
2019-01-02,253,258,250,253,2620743,91,4,1140743,1480000,92,4,2354091,266652,-1213348,1213348
2019-01-05,253,253,248,252,3624694,168,1,3398361,226333,59,3,3171728,452966,226633,-226633
2019-01-06,251,252,247,252,6227084,177,4,3963197,2263887,92,2,5855155,371929,-1891958,1891958
2019-01-07,253,259,253,258,4987117,173,2,4813117,174000,163,3,4115387,871730,697730,-697730
2019-01-08,259,266,258,262,4269579,173,5,2590841,1678738,166,5,2768624,1500955,-177783,177783
2019-01-09,263,268,262,266,3754278,135,2,3653278,101000,189,4,3227800,526478,425478,-425478
2019-01-12,268,270,266,267,4498921,101,4,3600921,898000,156,2,2917723,1581198,683198,-683198
2019-01-13,263,267,262,266,4071461,102,5,1831853,2239608,145,3,3837539,233922,-2005686,2005686
2019-01-14,268,269,263,267,4377917,125,3,3268917,1109000,101,5,1983288,2394629,1285629,-1285629
2019-01-15,268,275,268,272,4737753,178,4,4558318,179435,168,8,2540353,2197400,2017965,-2017965
2019-01-16,274,274,269,272,6879202,100,5,2123319,4755883,132,4,4978225,1900977,-2854906,2854906
2019-01-19,271,276,271,273,4332141,101,1,4192682,139459,95,5,2342532,1989609,1850150,-1850150
2019-01-20,274,275,269,270,2037141,117,3,1706313,330828,94,1,2000545,36596,-294232,294232
2019-01-21,268,268,258,262,5647409,220,7,3047363,2600046,108,0,5647409,0,-2600046,2600046
2019-01-22,263,268,263,264,2127132,121,3,1715695,411437,70,1,1927132,200000,-211437,211437
2019-01-23,267,267,260,262,2141102,122,4,1730075,411027,149,1,2091102,50000,-361027,361027
2019-01-26,265,268,261,263,2683361,81,3,1382361,1301000,106,2,2627044,56317,-1244683,1244683
2019-01-27,261,263,260,262,2502337,107,3,1367076,1135261,98,2,2149659,352678,-782583,782583
2019-01-28,262,262,259,261,6457658,109,7,2096357,4361301,83,1,6055658,402000,-3959301,3959301
2019-01-29,262,262,258,259,6065763,113,6,2093811,3971952,79,3,4320270,1745493,-2226459,2226459
2019-01-30,261,261,257,258,4122026,136,5,1640376,2481650,51,4,1929885,2192141,-289509,289509
2019-02-02,259,262,257,257,4882855,104,3,1882855,3000000,75,5,3188072,1694783,-1305217,1305217
2019-02-03,257,259,254,257,5099771,157,5,1740621,3359150,101,3,2941697,2158074,-1201076,1201076
2019-02-04,257,259,257,258,3918552,115,4,1908552,2010000,70,3,1964925,1953627,-56373,56373
2019-02-05,259,259,256,258,7753990,122,7,2921129,4832861,90,4,4102118,3651872,-1180989,1180989
2019-02-06,257,259,257,258,3643827,91,4,1132441,2511386,60,4,2637432,1006395,-1504991,1504991
2019-02-10,258,259,256,256,3535313,98,2,1335313,2200000,57,2,2843178,692135,-1507865,1507865
2019-02-12,257,257,256,257,4817939,66,3,972523,3845416,84,1,3579521,1238418,-2606998,2606998
2019-02-13,255,257,255,257,2143507,41,9,255953,1887554,114,1,1943507,200000,-1687554,1687554
2019-02-16,255,261,255,259,2603376,62,5,2061487,541889,133,2,2589766,13610,-528279,528279
2019-02-17,256,261,256,258,1808411,61,4,1035369,773042,53,1,1758411,50000,-723042,723042
2019-02-18,259,265,259,262,3382895,89,7,2193119,1189776,106,3,2036970,1345925,156149,-156149
2019-02-19,265,265,263,264,2659339,131,3,2199363,459976,71,6,1081466,1577873,1117897,-1117897
2019-02-20,260,268,260,267,5152913,114,5,2884384,2268529,96,6,1895923,3256990,988461,-988461
2019-02-23,268,280,268,277,24155882,188,6,20581476,3574406,337,10,11437188,12718694,9144288,-9144288
2019-02-24,281,281,273,277,8422160,161,3,7678547,743613,125,17,2532172,5889988,5146375,-5146375
2019-02-25,278,278,272,275,4563842,129,4,3538125,1025717,125,4,2741865,1821977,796260,-796260
2019-02-26,273,274,267,271,2125543,145,1,1718543,407000,103,3,1766135,359408,-47592,47592
2019-02-27,271,274,270,273,2158766,77,3,1957992,200774,74,3,1643528,515238,314464,-314464
2019-03-02,277,278,269,270,2016885,98,4,1420125,596760,76,3,1954385,62500,-534260,534260
2019-03-03,269,277,268,271,2688227,80,5,1326121,1362106,95,2,2258227,430000,-932106,932106
2019-03-04,271,272,269,269,3259281,100,3,3051568,207713,82,2,2448910,810371,602658,-602658
2019-03-05,269,269,266,266,2234708,111,1,2184325,50383,65,2,1705030,529678,479295,-479295
2019-03-06,269,269,263,264,2545750,150,1,2496171,49579,57,1,1415750,1130000,1080421,-1080421
2019-03-09,264,266,263,264,3587914,107,6,1435629,2152285,51,2,3018660,569254,-1583031,1583031
2019-03-10,264,269,262,268,9616801,164,6,3898801,5718000,94,3,6654301,2962500,-2755500,2755500
2019-03-11,265,272,265,271,3956692,193,2,3600152,338866,141,8,2765119,1173899,835033,-835033
2019-03-12,271,275,271,274,5906501,119,5,3622871,2283630,142,6,2209269,3697232,1413602,-1413602
2019-03-13,275,275,273,275,2634136,124,2,2127191,506945,185,4,2102832,531304,24359,-24359
2019-03-16,274,281,274,278,6369740,208,4,5900380,469360,208,6,2953339,3416401,2947041,-2947041
2019-03-17,280,286,280,286,6422978,143,1,6097978,325000,237,6,4761283,1661695,1336695,-1336695
2019-03-18,284,291,284,290,6692308,289,2,6350308,342000,199,14,3503672,3188636,2846636,-2846636
2019-03-19,292,303,292,297,9127062,378,2,8766062,361000,188,10,5372055,3755007,3394007,-3394007
2019-03-25,297,307,292,304,3580879,145,2,3035481,545398,168,5,3489058,91821,-453577,453577
2019-03-26,304,305,302,303,7854786,158,4,2515236,5339550,131,2,7475647,379139,-4960411,4960411
2019-03-27,304,304,295,303,9025844,198,8,8119630,906214,156,2,3975844,5050000,4143786,-4143786
2019-03-30,304,312,304,312,12988421,255,3,12865009,123412,176,6,6400785,6587636,6464224,-6464224
2019-03-31,312,316,309,310,8265190,206,3,5879404,2385786,234,5,6938895,1326295,-1059491,1059491
2019-04-06,312,318,305,314,5064785,152,2,4699080,365705,196,0,5064785,0,-365705,365705
2019-04-07,317,317,308,314,4969039,204,2,3396789,1572250,173,3,3349039,1620000,47750,-47750
2019-04-08,314,315,308,313,9909610,138,7,2071369,7838241,167,5,4357688,5551922,-2286319,2286319
2019-04-09,313,320,307,313,8379689,177,8,2746274,5633415,153,3,6150488,2229201,-3404214,3404214
2019-04-10,311,319,311,315,17030378,145,5,4726682,12303696,168,16,8639434,8390944,-3912752,3912752
2019-04-13,317,317,310,312,9405615,187,5,4525367,4880248,171,5,8754972,650643,-4229605,4229605
2019-04-14,315,316,309,314,4822514,164,4,2997077,1825437,171,2,3682532,1139982,-685455,685455
2019-04-15,314,327,314,319,8242029,174,4,4539829,3702200,190,5,4803935,3438094,-264106,264106
2019-04-16,320,324,312,312,7210641,160,5,3264144,3945997,132,7,4244030,2966111,-979886,979886
2019-04-17,311,317,311,313,4542737,132,3,3018415,1524322,117,15,3528264,1014473,-509849,509849
2019-04-20,313,324,313,324,9476548,209,5,8554748,921800,152,4,5431686,4044862,3123062,-3123062
2019-04-22,326,330,316,318,5725205,218,2,5026531,698674,141,3,4824665,900540,201866,-201866
2019-04-23,319,319,312,312,3858058,183,5,3161048,697010,93,4,3676407,181651,-515359,515359
2019-04-24,311,324,311,317,6770285,188,5,3992727,2777558,124,5,4170453,2599832,-177726,177726
2019-04-27,321,321,314,317,2946085,140,3,2559085,387000,148,2,2514638,431447,44447,-44447
2019-04-28,318,324,318,322,6140706,146,3,5703379,437327,179,4,5514591,626115,188788,-188788
2019-04-29,321,326,321,324,17147161,200,5,8997161,8150000,270,7,10052400,7094761,-1055239,1055239
2019-04-30,326,337,322,337,12120553,191,3,5615282,6505271,252,6,9594068,2526485,-3978786,3978786
2019-05-01,337,345,335,345,18982317,373,8,11342244,7640073,277,13,7169193,11813124,4173051,-4173051
2019-05-04,348,360,346,357,15642392,278,8,6179492,9462900,200,10,7689221,7953171,-1509729,1509729
2019-05-05,359,361,341,348,12918406,301,9,8200242,4718164,218,4,9941140,2977266,-1740898,1740898
2019-05-06,344,348,333,335,17612965,289,5,7493769,10119196,319,4,15983039,1629926,-8489270,8489270
2019-05-07,333,333,319,319,12856967,285,7,7536967,5320000,226,1,12756967,100000,-5220000,5220000
2019-05-08,318,335,312,330,10204982,303,4,6749793,3455189,171,8,5672927,4532055,1076866,-1076866
2019-05-11,337,337,321,322,5554564,211,4,3896120,1658444,132,6,3387804,2166760,508316,-508316
2019-05-12,325,337,318,328,16045272,133,12,2885856,13159416,215,9,9785231,6260041,-6899375,6899375
2019-05-13,322,334,322,326,7114666,177,3,3962577,3152089,97,14,4163177,2951489,-200600,200600
2019-05-14,330,335,329,331,15937699,214,3,12917348,3020351,104,3,11219706,4717993,1697642,-1697642
2019-05-15,332,332,326,328,4348630,133,2,3168630,1180000,103,3,4043436,305194,-874806,874806
2019-05-18,330,332,329,329,6049168,179,3,5880004,169164,117,2,5751748,297420,128256,-128256
2019-05-19,329,332,325,330,6548658,173,4,5208658,1340000,95,1,4548658,2000000,660000,-660000
2019-05-20,327,331,323,330,2794884,112,0,2794884,0,101,2,2580384,214500,214500,-214500
2019-05-21,330,334,329,332,6072983,126,3,5306783,766200,121,5,1489945,4583038,3816838,-3816838
2019-05-22,325,333,325,330,6928345,108,6,5667345,1261000,78,4,1959829,4968516,3707516,-3707516
2019-05-25,333,339,332,337,7454538,181,1,7054538,400000,161,8,2592531,4862007,4462007,-4462007
2019-05-26,339,344,337,339,8141466,182,5,4711466,3430000,141,6,1941511,6199955,2769955,-2769955
2019-05-28,340,350,338,347,15895537,188,4,3865537,12030000,142,10,3054449,12841088,811088,-811088
2019-05-29,342,348,341,341,3055793,152,1,2834793,221000,98,4,2139593,916200,695200,-695200
2019-06-01,345,345,334,343,3871540,133,2,1841540,2030000,101,1,3571540,300000,-1730000,1730000
2019-06-02,345,347,341,344,2607367,128,3,2484367,123000,94,2,2402367,205000,82000,-82000
2019-06-03,341,356,341,351,12710248,137,2,8245394,4464854,187,5,4681609,8028639,3563785,-3563785
2019-06-08,351,353,342,353,4418542,86,5,1827521,2591021,129,4,2200263,2218279,-372742,372742
2019-06-09,349,353,347,352,4729052,156,5,2274552,2454500,118,4,3499132,1229920,-1224580,1224580
2019-06-10,353,357,347,347,5530059,138,3,2660059,2870000,133,7,3830289,1699770,-1170230,1170230
2019-06-11,347,352,345,349,2936217,113,3,1696217,1240000,103,4,2497927,438290,-801710,801710
2019-06-12,348,352,346,347,8721375,173,3,8385156,336219,133,5,5449827,3271548,2935329,-2935329
2019-06-15,345,355,341,354,6045632,97,6,5450496,595136,172,6,4256909,1788723,1193587,-1193587
2019-06-16,353,357,348,349,7059442,131,5,3410721,3648721,127,5,2356764,4702678,1053957,-1053957
2019-06-17,349,353,345,349,2159032,76,2,893264,1265768,180,1,1929032,230000,-1035768,1035768
2019-06-18,349,354,345,348,3647826,115,5,2338676,1309150,101,2,1425657,2222169,913019,-913019
2019-06-19,366,366,363,366,73034089,798,13,58202495,14831594,314,19,26282265,46751824,31920230,-31920230
2019-06-22,370,384,368,383,26462291,666,5,24540936,1921355,364,14,21123640,5338651,3417296,-3417296
2019-06-23,387,393,385,392,17578756,402,5,11017925,6560831,229,9,5283690,12295066,5734235,-5734235
2019-06-24,402,402,387,390,12544370,378,5,9444370,3100000,280,6,10006560,2537810,-562190,562190
2019-06-25,392,402,387,400,8983926,237,5,4213926,4770000,257,8,6310144,2673782,-2096218,2096218
2019-06-26,402,409,388,388,18932331,427,12,9275300,9657031,155,9,10466034,8466297,-1190734,1190734
2019-06-30,391,395,383,384,11771625,404,8,7764089,4007536,191,6,7014385,4757240,749704,-749704
2019-07-01,387,395,379,393,7098649,324,6,5959320,1139329,198,6,4107153,2991496,1852167,-1852167
2019-07-02,395,403,389,403,13309676,348,5,9067189,4242487,313,10,8723233,4586443,343956,-343956
2019-07-03,406,412,397,397,8237766,427,5,7597810,639956,194,7,5810940,2426826,1786870,-1786870
2019-07-06,402,402,389,392,6732179,291,6,5143614,1588565,171,4,6532826,199353,-1389212,1389212
2019-07-07,395,402,393,402,5842267,260,6,4710921,1131346,181,3,5499221,343046,-788300,788300
2019-07-08,406,408,397,400,11424973,314,5,6924973,4500000,153,6,4549858,6875115,2375115,-2375115
2019-07-09,401,401,388,397,12084354,224,10,6681783,5402571,176,2,9769354,2315000,-3087571,3087571
2019-07-10,395,398,393,398,12437845,193,9,5068520,7369325,223,2,7357845,5080000,-2289325,2289325
2019-07-13,396,398,391,397,23739721,210,5,9248869,14490852,308,12,7686484,16053237,1562385,-1562385
2019-07-14,393,402,393,397,15454451,533,7,8678510,6775941,208,10,11760789,3693662,-3082279,3082279
2019-07-15,399,402,393,395,15053122,491,7,12057180,2995942,213,11,7844474,7208648,4212706,-4212706
2019-07-21,396,399,389,390,12539555,230,5,4689555,7850000,152,1,12489977,49578,-7800422,7800422
2019-07-22,380,388,372,373,26791632,723,15,13198215,13593417,359,4,26165143,626489,-12966928,12966928
2019-07-23,373,381,358,359,10103644,471,7,6559035,3544609,221,1,10089296,14348,-3530261,3530261
2019-07-24,365,365,352,358,6546002,306,3,5226002,1320000,190,2,6347274,198728,-1121272,1121272
2019-07-27,359,364,351,353,5999461,333,4,5274343,725118,157,3,5687175,312286,-412832,412832
2019-07-28,355,359,341,343,10749872,497,6,7734791,3015081,150,1,10743872,6000,-3009081,3009081
2019-07-29,349,349,342,343,6624183,343,5,4904183,1720000,153,0,6624183,0,-1720000,1720000
2019-07-30,341,346,336,342,9274372,306,7,4739600,4534772,156,4,7408402,1865970,-2668802,2668802
2019-07-31,347,347,336,339,8535216,403,7,4402082,4133134,150,6,4886349,3648867,-484267,484267
2019-08-03,346,346,338,340,10055604,733,6,7845604,2210000,152,5,6137840,3917764,1707764,-1707764
2019-08-04,341,348,341,344,10762730,583,4,8932730,1830000,168,5,6466410,4296320,2466320,-2466320
2019-08-05,344,348,343,344,7732037,468,4,6475557,1216480,182,8,4609383,3082654,1866174,-1866174
2019-08-06,347,347,341,342,5824827,368,6,4767494,1057333,179,6,4938194,886633,-170700,170700
2019-08-07,341,342,337,340,6850545,464,8,6155385,695160,183,3,6750739,99806,-595354,595354
2019-08-10,345,345,338,340,7547874,407,3,5364680,2183194,241,4,4399684,3148190,964996,-964996
2019-08-11,345,346,338,342,8382836,567,3,6661624,1721212,178,5,5271670,3111166,1389954,-1389954
2019-08-13,345,346,342,345,7972736,633,3,7774919,197817,193,5,4431022,3541714,3343897,-3343897
2019-08-14,346,362,346,362,30552303,1198,3,29940734,611569,583,6,16321363,14230940,13619371,-13619371
2019-08-17,373,373,364,373,58469651,2402,2,57854651,615000,571,10,19439651,39030000,38415000,-38415000
2019-08-18,387,387,365,372,21724578,1356,8,19568788,2155790,845,11,17511839,4212739,2056949,-2056949
2019-08-19,373,376,362,370,21081735,1009,8,14133072,6948663,589,3,13078765,8002970,1054307,-1054307
2019-08-21,369,376,364,367,14304894,734,6,9064267,5240627,421,4,8370772,5934122,693495,-693495
2019-08-24,374,374,367,368,22828742,956,7,16597586,6231156,587,7,14877510,7951232,1720076,-1720076
2019-08-25,369,369,354,365,18153003,773,8,10194036,7958967,473,5,15559925,2593078,-5365889,5365889
2019-08-26,369,374,360,364,24903273,655,9,10036782,14866491,533,6,8466077,16437196,1570705,-1570705
2019-08-27,369,374,366,368,17659491,633,5,7681960,9977531,587,6,12391225,5268266,-4709265,4709265
2019-08-28,366,370,364,366,16636187,566,4,8539448,8096739,460,2,8406187,8230000,133261,-133261
2019-08-31,373,384,372,377,18741605,718,4,13441205,5300400,785,6,14680665,4060940,-1239460,1239460
2019-09-01,379,381,371,379,9012444,392,4,6792164,2220280,482,3,7253550,1758894,-461386,461386
2019-09-02,384,389,370,379,11667186,430,4,5765305,5901881,579,3,10017060,1650126,-4251755,4251755
2019-09-03,381,381,374,378,6787789,332,7,3555222,3232567,428,3,6721769,66020,-3166547,3166547
2019-09-04,379,382,376,378,11347633,502,5,8945192,2402441,632,5,10040937,1306696,-1095745,1095745
2019-09-07,377,386,376,384,19177707,592,12,10083118,9089939,759,6,15065044,4108013,-4981926,4981926
2019-09-08,387,395,383,388,12932168,416,12,4735738,8196430,540,8,8503033,4429135,-3767295,3767295
2019-09-11,390,397,390,394,8315336,393,4,6732944,1582392,490,7,7107523,1207813,-374579,374579
2019-09-14,397,413,395,413,53526339,410,1,53178284,348055,678,10,13253564,40272775,39924720,-39924720
2019-09-15,420,421,403,419,16616993,758,9,13418442,3198551,628,8,13734198,2882795,-315756,315756
2019-09-16,426,436,419,430,20659208,716,3,17732611,2926597,682,8,17332738,3326470,399873,-399873
2019-09-17,427,435,418,427,18648226,367,12,15376097,3272129,614,3,18054725,593501,-2678628,2678628
2019-09-18,422,422,405,417,11135980,341,7,8642150,2493830,585,4,10817481,318499,-2175331,2175331
2019-09-21,395,420,395,409,10670475,322,5,8794475,1876000,431,6,7049885,3620590,1744590,-1744590
2019-09-22,411,431,411,431,14978736,534,4,14283104,695632,696,8,10697332,4281404,3585772,-3585772
2019-09-23,446,448,437,448,56596926,676,3,22596926,34000000,580,9,10774406,45822520,11822520,-11822520
2019-09-24,458,458,429,443,13032428,657,3,11233163,1799265,587,4,12082428,950000,-849265,849265
2019-09-25,433,465,433,465,30233092,732,6,26331787,3901305,942,10,20257222,9975870,6074565,-6074565
2019-09-28,478,480,462,463,15423063,1231,8,12667218,2755845,537,4,14689915,733148,-2022697,2022697
2019-09-29,473,473,451,463,12315242,717,5,9222114,3093128,629,1,12165242,150000,-2943128,2943128
2019-09-30,461,479,457,474,18116144,498,8,8025058,10088007,730,4,15167002,2946063,-7141944,7141944
2019-10-01,478,487,458,460,20682797,687,8,13146294,7536503,738,11,17268567,3414230,-4122273,4122273
2019-10-02,468,480,462,473,10645412,321,8,3479157,7166255,439,2,10618182,27230,-7139025,7139025
2019-10-05,477,494,459,464,14082085,445,4,11581348,2500737,555,6,12222373,1859712,-641025,641025
2019-10-06,474,474,451,451,18764206,490,6,10999206,7765000,382,12,18149206,615000,-7150000,7150000
2019-10-07,435,464,435,449,16808513,560,5,12916696,3891817,666,1,16568513,240000,-3651817,3651817
2019-10-08,443,452,421,421,18639870,489,13,13100633,5539237,524,3,18060297,579573,-4959664,4959664
2019-10-09,411,443,411,443,11411527,325,8,7453788,3957739,486,3,10564697,846830,-3110909,3110909
2019-10-12,439,449,434,447,5792402,309,5,4858660,933742,264,5,3565180,2227222,1293480,-1293480
2019-10-13,452,462,435,439,6936428,259,4,6277075,659353,303,3,5585302,1351126,691773,-691773
2019-10-14,438,445,427,430,4868219,291,4,3368219,1500000,199,2,4208219,660000,-840000,840000
2019-10-15,433,441,412,412,11718032,388,9,5408958,6309074,347,3,11562940,155092,-6153982,6153982
2019-10-16,399,421,399,413,5323172,297,7,3078328,2244844,229,5,4545508,777664,-1467180,1467180
2019-10-20,411,420,394,397,6980751,288,9,2936310,4044441,316,2,6934251,46500,-3997941,3997941
2019-10-21,386,416,383,413,6927904,293,6,3743781,3184123,283,3,5957904,970000,-2214123,2214123
2019-10-22,417,424,416,419,6303911,334,3,3319764,2984147,183,3,5322378,981533,-2002614,2002614
2019-10-23,417,422,406,421,9142823,229,7,1752823,7390000,205,1,6842823,2300000,-5090000,5090000
2019-10-26,422,426,413,416,2387227,173,2,1087227,1300000,149,1,2287227,100000,-1200000,1200000
2019-10-28,404,427,404,424,6286203,215,3,1220082,5066121,163,1,6276203,10000,-5056121,5056121
2019-10-30,432,437,424,434,4554210,253,1,2397968,2156242,193,1,4504210,50000,-2106242,2106242
2019-11-02,438,441,425,435,5612954,218,5,1898713,3714241,210,2,4572954,1040000,-2674241,2674241
2019-11-03,433,440,428,431,5201245,202,3,3044512,2156733,210,2,4931245,270000,-1886733,1886733
2019-11-04,436,436,411,424,17249586,231,6,3587621,13661965,195,3,4047332,13202254,-459711,459711
2019-11-05,422,438,419,436,5364885,113,5,2457237,2907648,289,2,4404885,960000,-1947648,1947648
2019-11-09,438,443,430,435,2786320,132,2,1806320,980000,178,1,1759279,1027041,47041,-47041
2019-11-10,433,438,428,436,7182334,76,3,2351776,4830558,207,1,6852434,329900,-4500658,4500658
2019-11-11,436,439,424,439,8612442,75,2,1307307,7305135,268,2,8342442,270000,-7035135,7035135
2019-11-12,435,448,435,444,8284764,111,3,4644762,3640002,289,4,6674764,1610000,-2030002,2030002
2019-11-13,447,453,444,451,4834135,177,2,3475649,1358486,284,5,3655117,1179018,-179468,179468
2019-11-16,448,454,440,441,5699591,154,6,1384591,4315000,194,2,5595304,104287,-4210713,4210713
2019-11-17,427,449,427,440,5325494,105,7,1705284,3620210,202,4,4046723,1278771,-2341439,2341439
2019-11-18,436,442,428,438,2875996,97,5,1853375,1022621,98,3,2441421,434575,-588046,588046
2019-11-19,430,447,430,441,1806779,64,3,312715,1494064,126,0,1806779,0,-1494064,1494064
2019-11-20,445,445,438,443,5013070,98,3,1873070,3140000,138,3,3962328,1050742,-2089258,2089258
2019-11-23,438,458,438,458,16931851,176,3,10532059,6399792,345,6,14596851,2335000,-4064792,4064792
2019-11-24,458,460,452,454,6544422,129,3,2467781,4076641,206,5,2918415,3626007,-450634,450634
2019-11-25,454,470,451,469,15486356,136,2,10160732,5325624,358,7,12183359,3302997,-2022627,2022627
2019-11-26,464,472,464,464,5089266,142,2,2349493,2739773,211,2,2889266,2200000,-539773,539773
2019-11-27,464,476,457,476,14268170,137,1,11203143,3065027,382,6,8024122,6244048,3179021,-3179021
2019-11-30,475,496,475,494,12465328,238,2,4421486,8043842,511,4,10695335,1769993,-6273849,6273849
2019-12-01,496,511,485,506,12223883,209,5,9189745,3034138,496,6,9477480,2746403,-287735,287735
2019-12-02,506,509,485,501,13426266,181,3,11432258,1994008,403,6,8110308,5315958,3321950,-3321950
2019-12-03,501,511,491,507,16656887,134,4,3444867,13212020,315,3,4415223,12241664,-970356,970356
2019-12-04,513,513,499,502,3888587,166,2,3577842,310745,211,2,1968610,1919977,1609232,-1609232
2019-12-07,502,530,495,529,13625131,220,3,5484484,8140647,657,7,10002830,3622301,-4518346,4518346
2019-12-08,538,538,522,524,7755516,256,3,5934788,1820728,223,2,6494233,1261283,-559445,559445
2019-12-09,531,538,516,524,7589208,182,3,4929208,2660000,316,4,5412623,2176585,-483415,483415
2019-12-10,528,528,511,512,7524730,260,3,6568078,956652,323,5,3989047,3535683,2579031,-2579031
2019-12-11,502,528,502,519,8927737,172,4,7942951,984786,272,4,5998179,2929558,1944772,-1944772
2019-12-14,514,517,507,517,5269956,172,8,3183827,2086129,211,4,2936086,2333870,247741,-247741
2019-12-15,517,525,504,507,7808083,221,3,2729548,5078535,180,4,2319123,5488960,410425,-410425
2019-12-16,535,535,519,526,8803715,196,4,6702018,2101697,229,5,2705723,6097992,3996295,-3996295
2019-12-17,543,543,532,539,14325558,298,2,13945558,380000,223,9,2965002,11360556,10980556,-10980556
2019-12-18,541,542,534,536,4756523,225,4,3775635,980888,214,2,3024442,1732081,751193,-751193
2019-12-21,550,550,535,549,6556959,136,3,6469494,87465,271,2,3627979,2928980,2841515,-2841515
2019-12-22,543,558,543,554,3543898,175,0,3543898,0,210,2,2093898,1450000,1450000,-1450000
2019-12-23,559,559,539,549,5541903,191,3,2466373,3075530,231,4,4444209,1097694,-1977836,1977836
2019-12-24,548,552,538,549,10206896,110,3,5174222,5032674,192,5,2595774,7611122,2578448,-2578448
2019-12-25,551,575,548,569,15980068,435,2,14589900,1390168,342,7,5315767,10664301,9274133,-9274133
2019-12-28,567,581,561,575,8269215,301,3,7630051,639164,238,6,4635979,3633236,2994072,-2994072
2019-12-29,582,592,574,591,10361577,279,0,10361577,0,192,4,3156493,7205084,7205084,-7205084
2019-12-30,597,607,591,604,10396826,385,0,10396826,0,228,8,2877128,7519698,7519698,-7519698
2019-12-31,611,611,590,602,6513727,230,4,4960946,1552781,264,1,6501415,12312,-1540469,1540469
2020-01-01,601,620,592,615,17289108,217,2,11439108,5850000,281,6,6352658,10936450,5086450,-5086450
2020-01-04,583,587,583,583,28545944,138,7,1608409,26937535,370,3,26975980,1569964,-25367571,25367571
2020-01-05,560,595,560,591,9623496,215,6,6855077,2768419,374,0,9623496,0,-2768419,2768419
2020-01-07,612,612,554,556,7159013,250,4,3406629,3752384,339,1,7139013,20000,-3732384,3732384
2020-01-08,564,573,564,564,11878115,100,5,4678115,7200000,232,0,11878115,0,-7200000,7200000
2020-01-11,576,576,576,576,1916622,31,0,1916622,0,30,2,516619,1400003,1400003,-1400003
2020-01-12,604,604,601,604,9295862,169,3,5316868,3978994,82,3,2185259,7110603,3131609,-3131609
2020-01-13,633,634,612,634,16652270,264,5,8711169,7941101,287,9,4394302,12257968,4316867,-4316867
2020-01-14,643,643,617,620,5046132,323,2,3671529,1374603,202,2,4607379,438753,-935850,935850
2020-01-15,616,636,612,634,8477670,156,2,8367670,110000,186,5,6626138,1851532,1741532,-1741532
2020-01-18,634,649,633,639,9876374,269,3,9531374,345000,216,5,7464580,2411794,2066794,-2066794
2020-01-19,640,645,628,638,12057876,189,2,8942273,3115603,205,5,9308936,2748940,-366663,366663
2020-01-20,634,639,629,633,6563132,196,1,6523132,40000,197,5,3131287,3431845,3391845,-3391845
2020-01-21,623,635,623,629,4881314,189,1,4454999,416315,220,5,3234149,1637165,1220850,-1220850
2020-01-22,633,646,623,644,11520360,196,2,11436221,84139,255,7,4515384,7004976,6920837,-6920837
2020-01-25,650,663,639,659,21164639,385,1,21124639,40000,272,9,3786916,17377723,17337723,-17337723
2020-01-26,654,665,634,649,18542571,301,4,7473692,11068879,256,2,8497181,10045390,-1023489,1023489
2020-01-27,649,659,633,645,7181449,172,3,6962009,219440,189,3,6123628,1057821,838381,-838381
2020-01-28,642,661,642,654,6891686,179,2,6801686,90000,242,4,3738265,3153421,3063421,-3063421
2020-02-01,658,658,644,647,9153078,189,2,8533078,620000,202,6,5533499,3619579,2999579,-2999579
2020-02-02,654,656,638,652,11090799,201,5,8422510,2668289,250,3,9616829,1473970,-1194319,1194319
2020-02-03,650,670,648,665,18841270,282,3,18361270,480000,320,8,5648765,13192505,12712505,-12712505
2020-02-04,670,670,648,653,5093814,238,4,3901223,1192591,201,5,4487547,606267,-586324,586324
2020-02-05,647,658,644,654,11158357,217,3,9657910,1500447,267,5,5541612,5616745,4116298,-4116298
2020-02-08,664,669,647,652,8456804,292,2,7317789,1139015,220,7,4223511,4233293,3094278,-3094278
2020-02-09,652,660,652,654,18714063,267,3,16594156,2119907,256,4,3142717,15571346,13451439,-13451439
2020-02-10,654,659,643,651,8471442,177,4,5166646,3304796,236,1,6824867,1646575,-1658221,1658221
2020-02-12,663,679,644,670,14371494,311,3,12224351,2147143,334,6,9437303,4934191,2787048,-2787048
2020-02-15,671,680,661,675,3620045,274,2,3500045,120000,194,3,2838031,782014,662014,-662014
2020-02-16,675,696,675,692,5540430,240,1,5539430,1000,248,3,4943287,597143,596143,-596143
2020-02-17,700,705,682,684,8870838,338,4,6167989,2702849,252,3,8294444,576394,-2126455,2126455
2020-02-18,704,704,686,694,6824864,314,2,6736598,88266,244,2,4026544,2798320,2710054,-2710054
2020-02-19,690,714,690,697,12854286,342,5,8486929,4367357,328,3,5654331,7199955,2832598,-2832598
2020-02-22,697,721,697,707,4410110,192,1,4370110,40000,159,3,3458510,951600,911600,-911600
2020-02-23,709,743,709,717,20361886,481,3,15661886,4700000,272,9,7019840,13342046,8642046,-8642046
2020-02-24,749,749,712,739,6749655,411,2,4468716,2275939,280,1,6447957,296698,-1979241,1979241
2020-02-25,735,759,727,756,5224254,285,1,4660193,564061,281,3,4665885,558369,-5692,5692
2020-02-26,770,775,750,754,5483742,306,2,4673742,810000,203,3,2833742,2650000,1840000,-1840000
2020-02-29,740,743,722,722,8323322,449,3,5953322,2370000,175,4,5560969,2762353,392353,-392353
2020-03-01,707,740,707,739,9244690,374,5,4739581,4505109,263,6,6951082,2293608,-2211501,2211501
2020-03-02,749,764,739,764,35898568,554,7,15785549,20113019,347,7,8538568,27360000,7246981,-7246981
2020-03-03,783,787,771,787,23886315,272,3,5105944,18780371,322,8,6154842,17731473,-1048898,1048898
2020-03-04,825,825,802,825,22758629,408,2,16549079,6209550,327,8,5108516,17650113,11440563,-11440563
2020-03-07,811,823,802,820,7902557,295,4,4345416,3557141,370,1,7841047,61510,-3495631,3495631
2020-03-09,801,801,770,770,3499958,243,3,2070386,1429572,55,1,3299958,200000,-1229572,1229572
2020-03-10,750,762,750,750,11500487,336,5,5888402,5612085,220,1,10900487,600000,-5012085,5012085
2020-03-11,724,770,713,714,12864204,523,4,8455994,4408210,289,6,10547659,2316545,-2091665,2091665
2020-03-14,697,738,694,694,6657384,255,4,2412384,4245000,75,2,3868099,2789285,-1455715,1455715
2020-03-15,663,717,663,694,17058327,364,6,3819340,13238987,323,3,13825074,3233253,-10005734,10005734
2020-03-16,701,701,686,701,11580207,251,2,9049622,2530585,145,6,2552277,9027930,6497345,-6497345
2020-03-17,706,717,671,716,5500924,337,2,3460183,2040741,150,1,5420924,80000,-1960741,1960741
2020-03-18,724,738,704,737,5203313,234,2,2131409,3071904,165,3,3254433,1948880,-1123024,1123024
2020-03-24,741,776,740,762,5944995,749,2,5807949,137046,232,6,4202507,1742488,1605442,-1605442
2020-03-25,778,789,778,789,4810569,210,2,3788684,1021885,180,4,2287046,2523523,1501638,-1501638
2020-03-28,815,815,806,815,14733749,988,2,14642479,91270,268,7,7033749,7700000,7608730,-7608730
2020-03-29,855,855,822,839,21736211,749,6,7416211,14320000,465,7,18185891,3550320,-10769680,10769680
2020-03-30,839,881,821,855,14317190,663,5,9306990,5010000,442,4,8998033,5318957,308957,-308957
2020-04-04,860,892,860,892,7218972,162,2,5839098,1379874,262,4,4366720,2852252,1472378,-1472378
2020-04-05,934,935,904,935,16250580,834,6,7157775,9092805,428,6,13519614,2730966,-6361839,6361839
2020-04-06,963,965,879,946,6214546,495,3,6018528,196018,517,0,6214546,0,-196018,196018
2020-04-07,969,983,950,983,10866200,296,4,7391650,3474550,466,6,6016201,4849999,1375449,-1375449
2020-04-08,1028,1028,1019,1028,8470025,462,3,5903296,2566729,349,5,5348140,3121885,555156,-555156
2020-04-11,1055,1080,1028,1080,12469171,796,2,9684171,2600000,486,4,9827021,2457150,-142850,142850
2020-04-12,1097,1127,1087,1127,22893235,517,6,9032166,13861069,323,9,5543235,17350000,3488931,-3488931
2020-04-13,1177,1177,1139,1139,597129,82,0,597129,0,25,0,597129,0,0,0
2020-04-18,1185,1185,1185,1185,6633712,263,2,4433712,2200000,153,2,3783712,2850000,650000,-650000
2020-04-19,1244,1244,1192,1230,19128804,1091,6,15250949,3877855,456,6,12962853,6165951,2288096,-2288096
2020-04-20,1240,1300,1203,1300,15590892,639,3,12040892,3550000,456,7,5336892,10254000,6704000,-6704000
2020-04-21,1359,1359,1340,1359,16925871,872,4,15595871,1330000,297,9,5327704,11598167,10268167,-10268167
2020-04-22,1427,1498,1427,1498,9361329,703,4,8329537,1031792,403,4,7251329,2110000,1078208,-1078208
2020-04-25,1566,1566,1566,1566,6500586,97,2,3900586,2600000,116,3,443274,6057312,3457312,-3457312
2020-04-26,1644,1644,1583,1644,74351548,2608,19,54242646,20108902,695,12,18325454,56026094,35917192,-35917192
2020-04-27,1724,1725,1584,1725,44150745,3320,16,34757618,9393127,724,12,19952660,24198085,14804958,-14804958
2020-04-28,1802,1802,1762,1802,34197789,2160,9,22540687,11657102,560,13,19285140,14912649,3255547,-3255547
2020-04-29,1891,1891,1857,1891,22469690,2030,8,13478690,8991000,301,7,7275115,15194575,6203575,-6203575
2020-05-02,1985,1985,1985,1985,24986367,2163,14,14474554,10511813,234,6,2701367,22285000,11773187,-11773187
2020-05-03,2085,2085,2077,2085,105524060,9425,30,73165625,32358435,852,15,38227791,67296269,34937834,-34937834
2020-05-04,2085,2085,1981,1981,62110996,5084,16,54452003,7658993,1661,7,60179116,1931880,-5727113,5727113
2020-05-05,1952,1981,1899,1899,19559066,2357,11,13751022,5808044,395,0,19559066,0,-5808044,5808044
2020-05-06,1822,1857,1822,1822,142469371,3167,22,82335672,60133699,2214,7,131321323,11148048,-48985651,48985651
2020-05-09,1854,1914,1815,1914,187935096,6944,48,128138058,59797038,3275,16,164724304,23210792,-36586246,36586246
2020-05-10,1957,1957,1900,1957,73783098,2847,26,52074801,21708297,1570,19,42647906,31135192,9426895,-9426895
2020-05-11,2052,2052,1857,1857,57828715,5612,12,47966042,9862673,2021,12,48972099,8856616,-1006057,1006057
2020-05-12,1870,1870,1870,1870,2611976,596,4,1696576,915400,18,0,2611976,0,-915400,915400
2020-05-13,1828,1926,1828,1828,68406361,2856,21,37126947,31279414,2531,9,64367211,4039150,-27240264,27240264
2020-05-16,1762,1794,1742,1742,6210199,658,4,4509886,1700313,232,3,2693533,3516666,1816353,-1816353
2020-05-17,1661,1661,1661,1661,5340290,489,5,3336790,2003500,55,2,5040290,300000,-1703500,1703500
2020-05-18,1641,1751,1584,1635,67693774,3380,16,51724498,10663830,2614,11,51198323,11190005,526175,-526175
2020-05-19,1681,1738,1656,1738,44284832,1518,13,20160978,24123854,2075,14,36777552,7507280,-16616574,16616574
2020-05-20,1786,1786,1720,1786,46956109,1555,4,43597374,3358735,2132,14,40838248,6117861,2759126,-2759126
2020-05-23,1783,1783,1692,1692,16903285,948,8,8395685,8507600,830,1,16768285,135000,-8372600,8372600
2020-05-26,1624,1678,1624,1624,9357340,745,7,6697340,2660000,781,0,9357340,0,-2660000,2660000
2020-05-27,1546,1673,1546,1603,21647219,1457,9,19591021,2056198,1664,8,19282199,2365020,308822,-308822
2020-05-30,1654,1663,1650,1663,15111610,1521,5,14469987,641623,513,4,6438725,8672885,8031262,-8031262
2020-05-31,1727,1727,1579,1635,20426030,1633,12,16895038,3530992,1018,2,20186030,240000,-3290992,3290992
2020-06-01,1635,1701,1583,1701,17879729,498,6,9389781,8489948,949,5,12940579,4939150,-3550798,3550798
2020-06-02,1778,1778,1750,1778,10327013,597,5,6694668,3632345,546,3,8427013,1900000,-1732345,1732345
2020-06-06,1866,1866,1866,1866,11170789,649,0,11170789,0,467,5,2353789,8817000,8817000,-8817000
2020-06-07,1960,1960,1960,1960,4885159,57,0,4885159,0,408,5,2910159,1975000,1975000,-1975000
2020-06-08,1846,2040,1846,1952,47198153,4111,11,37714330,9270123,2059,14,38216357,8768096,-502027,502027
2020-06-09,1982,2100,1941,1975,18772640,2359,3,17372640,1400000,1622,5,18156374,616266,-783734,783734
2020-06-10,2005,2047,1957,2047,26093475,2169,7,21404884,4688591,2289,3,24413475,1680000,-3008591,3008591
2020-06-13,2079,2089,2005,2015,25030878,2544,10,17424172,7606706,2164,6,21832398,3198480,-4408226,4408226
2020-06-14,2015,2016,1926,1941,32195748,2005,11,19862748,12333000,2176,7,25180732,7015016,-5317984,5317984
2020-06-15,1921,2046,1921,1973,49743273,2572,8,42756839,6986434,2453,16,23836216,25907057,18920623,-18920623
2020-06-16,2046,2111,1994,2111,22897101,888,8,15202143,7694958,1913,11,16732301,6164800,-1530158,1530158
2020-06-20,2195,2195,2195,2195,10606612,884,2,5581565,5025047,714,8,4156904,6449708,1424661,-1424661
2020-06-21,2304,2304,2163,2304,58825342,4903,20,49778502,9046840,2550,18,32851023,25974319,16927479,-16927479
2020-06-22,2344,2367,2300,2367,35263561,1616,7,23641094,11622467,1040,17,10598104,24665457,13042990,-13042990
2020-06-23,2483,2483,2483,2483,9411909,187,1,3011909,6400000,213,2,4401909,5010000,-1390000,1390000
2020-06-28,2437,2606,2359,2533,44460747,2164,18,27894130,16566617,2270,16,33103255,11357492,-5209125,5209125
2020-06-29,2520,2585,2408,2510,49959778,2143,23,24514445,25445333,2601,6,27240156,22719622,-2725711,2725711
2020-06-30,2490,2589,2490,2589,27148027,596,11,14621318,12526709,1416,9,8328993,18819034,6292325,-6292325
2020-07-01,2714,2714,2660,2714,35383794,1494,8,18619527,16764267,1449,13,14371067,21012727,4248460,-4248460
2020-07-04,2848,2848,2578,2701,31958918,3501,14,19783426,12175492,2476,8,28164918,3794000,-8381492,8381492
2020-07-05,2775,2890,2617,2890,36641295,2041,16,22561583,14079712,2015,12,19390600,17250695,3170983,-3170983
2020-07-06,2992,2992,2954,2992,28191308,1858,8,16424296,11767012,995,12,10018308,18173000,6405988,-6405988
2020-07-07,3044,3044,2843,2843,38378474,4387,25,22509762,15868712,2195,11,31778217,6600257,-9268455,9268455
2020-07-08,2727,2843,2727,2727,9580672,1735,4,7880472,1700200,772,2,9270672,310000,-1390200,1390200
2020-07-11,2593,2662,2593,2593,39380074,2017,14,29377695,10002379,2054,6,37573872,1806202,-8196177,8196177
2020-07-12,2642,2727,2471,2582,46581484,2376,15,31694525,14886959,2257,19,30635238,15946246,1059287,-1059287
2020-07-13,2574,2627,2574,2574,24407993,2236,15,17938293,6469700,2170,15,20090990,4317003,-2152697,2152697
2020-07-14,2581,2659,2453,2522,32808099,2593,14,22987229,9820870,2946,13,27195228,5612871,-4207999,4207999
2020-07-20,2898,3042,2843,2952,123202442,4126,20,94201992,29000450,3540,24,54002849,69199593,40199143,-40199143
2020-07-21,2909,3129,2909,3129,170679221,5360,21,152640802,18038419,3797,14,54173959,116505262,98466843,-98466843
2020-07-22,3147,3147,3007,3147,220028150,5284,25,186477264,33550886,1262,6,58128150,161900000,128349114,-128349114
2020-07-25,3302,3302,2990,3028,207549566,15679,44,175880153,31669413,3682,19,184280853,23268713,-8400700,8400700
2020-07-26,3043,3043,3043,3043,10410773,2665,5,4895182,5515591,32,2,10133565,277208,-5238383,5238383
2020-07-27,2891,2996,2891,2891,167689646,7997,33,129188811,38162214,6136,21,146705461,20645564,-17516650,17516650
2020-07-28,2963,3044,2788,2816,108012030,8642,28,91763502,16248528,4473,13,74308167,33703863,17455335,-17455335
2020-07-29,2823,3113,2818,3113,147149257,9012,19,126862032,20287225,5650,23,68628518,78520739,58233514,-58233514
2020-08-01,3152,3152,3152,3152,3585411,68,4,3185411,400000,687,3,2065311,1520100,1120100,-1120100
2020-08-02,3307,3307,3301,3307,401123514,19276,76,317694854,83428660,1787,28,81173195,319950319,236521659,-236521659
2020-08-03,3345,3472,3305,3472,273449660,29634,41,235984713,37464947,4003,24,105263808,168185852,130720905,-130720905
2020-08-04,3587,3587,3416,3581,259879222,23970,45,206626894,53252328,2609,25,74109242,185769980,132517652,-132517652
2020-08-05,3583,3762,3405,3435,264271637,32839,52,208724457,23210120,10839,28,196065962,35868615,12658495,-12658495
2020-08-09,3412,3623,3302,3488,188319038,24602,43,166003458,22315580,10322,29,149782536,38536502,16220922,-16220922
2020-08-10,3524,3525,3353,3353,93399585,12414,28,81801760,11597825,3672,5,83536252,9863333,-1734492,1734492
2020-08-11,3199,3199,3199,3199,22815652,2448,10,10414097,12401555,143,3,18255526,4560126,-7841429,7841429
2020-08-12,3226,3336,3039,3039,103215439,7458,31,57988786,45226653,3327,11,75823406,27392033,-17834620,17834620
2020-08-15,2970,2970,2970,2970,9211205,1603,7,2551205,6660000,59,1,8211205,1000000,-5660000,5660000
2020-08-16,2822,2822,2822,2822,18536175,1384,9,1970411,16565764,193,14,15171175,3365000,-13200764,13200764
2020-08-17,2681,2822,2681,2784,62917490,7945,27,62468693,30339281,5811,13,88476630,4331344,-26007937,26007937
2020-08-17,2784,2821,2723,2788,29890484,7945,27,62468693,30339281,5811,13,88476630,4331344,-26007937,26007937
2020-08-18,2706,2715,2600,2603,76103920,4014,22,46479169,82569195,3306,23,91791168,37257196,-45311999,45311999
2020-08-18,2603,2603,2600,2600,52944444,4014,22,46479169,82569195,3306,23,91791168,37257196,-45311999,45311999
2020-08-19,2472,2472,2472,2472,4651506,1042,4,1500597,3904406,113,5,4933452,471551,-3432855,3432855
2020-08-19,2472,2472,2472,2472,753497,1042,4,1500597,3904406,113,5,4933452,471551,-3432855,3432855
2020-08-22,2596,2596,2349,2351,99090528,6018,26,51972476,47118052,5930,26,76819015,22271513,-24846539,24846539
2020-08-23,2444,2482,2315,2315,128472199,2485,20,19250418,109221781,4198,25,93386685,35085514,-74136267,74136267
2020-08-24,2357,2402,2207,2207,105430806,2809,14,31122049,74309757,3715,19,76496918,28934888,-45374869,45374869
2020-08-25,2307,2328,2306,2328,17975966,507,2,16075966,1900000,1587,2,17175966,800000,-1100000,1100000
2020-08-26,2441,2441,2441,2441,4443366,59,1,4143366,300000,574,4,3026957,1416409,1116409,-1116409
2020-08-31,2562,2562,2329,2414,81222625,6520,15,57787596,23435029,4328,21,64673788,16548837,-6886192,6886192
2020-09-01,2454,2454,2346,2346,13469415,1254,5,6293415,7176000,1102,3,12280401,1189014,-5986986,5986986
2020-09-02,2253,2255,2253,2253,32061615,916,5,5544615,26517000,2300,7,29673036,2388579,-24128421,24128421
2020-09-05,2276,2365,2187,2365,61389040,2468,18,34435612,26953428,4996,15,57826555,3562485,-23390943,23390943
2020-09-06,2365,2373,2175,2175,39102241,2947,14,20181365,18920876,2300,5,33080241,6022000,-12898876,12898876
2020-09-07,2101,2132,2101,2101,15025597,656,4,2755597,12270000,819,2,14750303,275294,-11994706,11994706
2020-09-08,1996,1996,1996,1996,6302027,209,2,802027,5500000,80,4,5625656,676371,-4823629,4823629
2020-09-09,1896,2026,1896,2001,70996877,3400,19,37788533,33208344,4678,20,52332443,18664434,-14543910,14543910
2020-09-12,1949,2016,1886,1989,31465493,3410,6,29336583,2128910,2684,9,27206766,4258727,2129817,-2129817
2020-09-13,1981,2012,1883,1923,32492178,2027,11,16157512,16334666,2375,4,30761890,1730288,-14604378,14604378
2020-09-14,1931,2027,1867,2027,48457427,1727,13,29753641,18703786,3171,10,33670427,14787000,-3916786,3916786
2020-09-15,2094,2094,2078,2094,15974833,765,6,12169739,3805094,770,5,9780131,6194702,2389608,-2389608
2020-09-16,2198,2198,2118,2198,38956748,1814,7,32005796,6950952,2203,9,29267026,9689722,2738770,-2738770
2020-09-19,2227,2302,2089,2209,31154258,2831,14,23965088,7189170,3638,5,29468258,1686000,-5503170,5503170
2020-09-20,2209,2234,2135,2135,8624235,1124,10,4484219,4140016,681,0,8624235,0,-4140016,4140016
2020-09-21,2056,2075,2056,2056,23440228,806,12,7232228,16208000,1300,6,19968781,3471447,-12736553,12736553
2020-09-22,2056,2118,1953,2110,29605867,1627,12,12031028,17574839,2863,7,26996594,2609273,-14965566,14965566
2020-09-23,2128,2130,2061,2128,27327166,2319,10,16762624,10564542,2373,4,25714586,1612580,-8951962,8951962
2020-10-03,2292,2384,2292,2356,22082796,2194,7,20548471,1534325,463,9,10411815,11670981,10136656,-10136656
2020-10-04,2338,2340,2202,2202,36168089,1988,7,13431582,22736507,2416,10,33018233,3149856,-19586651,19586651
2020-10-05,2138,2248,2134,2182,26517070,1353,9,9817341,16699729,1988,8,22217422,4299648,-12400081,12400081
2020-10-06,2147,2250,2147,2250,25269054,858,2,17461107,7807947,1402,10,15285579,9983475,2175528,-2175528
2020-10-07,2358,2358,2255,2358,26294528,2431,3,19527829,6766699,1568,11,20465528,5829000,-937699,937699
2020-10-10,2347,2384,2255,2320,21533348,1945,3,10805434,10727914,1804,3,20877182,656166,-10071748,10071748
2020-10-11,2366,2444,2329,2384,27716520,3381,4,20009840,7706680,2225,8,23017049,4699471,-3007209,3007209
2020-10-12,2373,2421,2292,2314,18027665,1298,12,7917930,10109735,2003,2,17877344,150321,-9959414,9959414
2020-10-13,2340,2378,2226,2340,16594488,1111,7,5799664,10794824,1773,2,14987081,1607407,-9187417,9187417
2020-10-14,2283,2311,2169,2200,22931094,1406,8,7780509,15150585,1511,8,17257269,5673825,-9476760,9476760
2020-10-18,2145,2169,2079,2079,16071817,675,7,3501817,12570000,1015,9,13153415,2918402,-9651598,9651598
2020-10-19,1980,2037,1980,1980,8284025,363,4,2174025,6110000,755,4,6432025,1852000,-4258000,4258000
2020-10-20,1900,1925,1900,1925,9173004,442,3,3093925,6079079,744,5,6508134,2664870,-3414209,3414209
2020-10-21,1925,2004,1834,1918,12826521,949,9,8206552,4619969,1473,8,10832614,1993907,-2626062,2626062
2020-10-24,1852,1856,1819,1819,16946065,443,5,2858684,14087381,862,5,14174576,2771489,-11315892,11315892
2020-10-26,1731,1742,1731,1733,26149821,640,10,9893384,16256437,1769,6,19826951,6322870,-9933567,9933567
2020-10-27,1733,1733,1645,1645,26991577,592,10,5771577,21220000,1373,7,23982443,3009134,-18210866,18210866
2020-10-28,1573,1715,1573,1702,9923944,783,5,7434869,2489075,1261,4,7884902,2039042,-450033,450033
2020-10-31,1715,1737,1669,1737,10854047,711,4,9749832,1104215,976,4,10314047,540000,-564215,564215
2020-11-01,1777,1777,1654,1660,6358790,467,2,6153556,205234,765,2,6118019,240771,35537,-35537
2020-11-02,1619,1733,1619,1665,5266953,459,5,4732516,534437,665,4,4464822,802131,267694,-267694
2020-11-04,1731,1760,1687,1760,16681107,536,7,14602402,2078705,978,5,10953240,5727867,3649162,-3649162
2020-11-07,1669,1729,1667,1667,3466183,379,4,2146183,1320000,107,0,3466183,0,-1320000,1320000
2020-11-08,1639,1639,1639,1639,11370615,132,5,350615,11020000,237,1,10470615,900000,-10120000,10120000
2020-11-09,1564,1632,1559,1564,15816248,535,9,7506135,8310113,1137,6,11497502,4318746,-3991367,3991367
2020-11-10,1577,1608,1494,1539,8426253,494,8,5453582,2972671,950,4,7990994,435259,-2537412,2537412
2020-11-11,1496,1581,1474,1553,19178184,721,8,14683738,4494446,1010,9,13614698,5563486,1069040,-1069040
2020-11-14,1572,1606,1553,1606,8894149,361,2,8139149,755000,513,6,6338630,2555519,1800519,-1800519
2020-11-15,1669,1669,1548,1570,12568594,1046,5,9330104,3238490,824,5,12037875,530719,-2707771,2707771
2020-11-16,1553,1696,1553,1649,15207610,1558,7,11853849,3353761,947,3,13409135,1798475,-1555286,1555286
2020-11-17,1674,1733,1616,1733,18339710,1154,3,13566410,4773300,1246,6,16354568,1985142,-2788158,2788158
2020-11-18,1779,1803,1729,1803,13105342,1045,5,9112277,3993065,890,8,9145172,3960170,-32895,32895
2020-11-21,1861,1861,1704,1704,17579059,1757,5,14988852,2590207,1310,4,15690769,1888290,-701917,701917
2020-11-22,1687,1786,1683,1742,10155028,639,10,7334430,2820598,846,4,9156028,999000,-1821598,1821598
2020-11-23,1751,1815,1742,1788,12752033,928,4,12538136,213897,924,5,11491349,1260684,1046787,-1046787
2020-11-24,1793,1806,1683,1702,26617514,1436,6,13550499,13052546,1616,5,24886299,1716746,-11335800,11335800
2020-11-25,1685,1759,1665,1715,13092210,947,5,9798389,3293821,1275,3,12069151,1023059,-2270762,2270762
2020-11-28,1650,1803,1645,1803,43391306,1717,6,36231449,7159857,2064,9,23596005,19795301,12635444,-12635444
2020-11-29,1863,1863,1806,1863,17560120,732,2,15648561,1911559,680,7,10953510,6606610,4695051,-4695051
2020-11-30,1953,1953,1953,1953,11088323,474,1,9088323,2000000,513,4,3114023,7974300,5974300,-5974300
2020-12-01,2017,2050,1900,2046,64205351,2703,10,51589126,12616225,2469,9,48592183,15613168,2996943,-2996943
2020-12-02,2061,2100,2019,2048,12895690,1267,7,10107635,2788055,934,5,11907755,987935,-1800120,1800120
2020-12-05,2100,2111,2017,2057,17799621,1534,10,13755676,4043945,1353,5,16670621,1129000,-2914945,2914945
2020-12-06,2059,2156,2059,2156,41017447,2295,11,31418975,9598472,2259,16,29548748,11468699,1870227,-1870227
2020-12-07,2081,2241,2059,2127,31601030,1687,10,21414712,10186318,2311,16,21684129,9916901,-269417,269417
2020-12-08,2109,2197,2081,2094,18711310,1408,11,14571841,4139469,1756,5,14090410,4620900,481431,-481431
2020-12-09,2063,2164,2035,2149,16872864,1452,12,11273138,5599726,2212,1,16667864,205000,-5394726,5394726
2020-12-12,2118,2204,2112,2140,36347092,2389,4,33464412,2909217,2309,21,22766130,13607499,10698282,-10698282
2020-12-13,2182,2219,2083,2098,12779986,1314,7,10655728,2124258,1393,4,12518363,261623,-1862635,1862635
2020-12-14,2151,2169,2015,2015,15603972,925,6,5625099,9978873,639,3,12862317,2741655,-7237218,7237218
2020-12-15,1931,1940,1931,1931,7417160,255,3,1017160,6400000,403,0,7417160,0,-6400000,6400000
2020-12-16,1863,1920,1863,1872,22211650,1254,14,11754165,10457485,1823,5,19240072,2971578,-7485907,7485907
2020-12-19,1872,1920,1819,1887,11827915,968,6,10456095,1371820,1291,8,9633524,2194391,822571,-822571
2020-12-20,1914,1914,1792,1830,14789450,788,7,6737868,8051582,1371,5,11635123,3154327,-4897255,4897255
2020-12-21,1852,1887,1797,1847,20748793,1185,5,17312122,3436671,1324,5,18776065,1972728,-1463943,1463943
2020-12-22,1859,1925,1814,1907,14097046,937,4,13174046,923000,1321,5,11606940,2490106,1567106,-1567106
2020-12-23,1944,1944,1841,1885,11403182,1034,4,8716448,2688271,1256,3,11097719,307000,-2381271,2381271
2020-12-26,1922,1940,1825,1878,16562851,1586,7,14908694,1654157,1699,5,14957270,1605581,-48576,48576
2020-12-27,1869,1916,1795,1837,12148148,1005,6,8317365,3830783,1433,3,11905744,242404,-3588379,3588379
2020-12-28,1803,1933,1803,1876,19228316,1314,5,16243462,2984854,1686,10,17394552,1833764,-1151090,1151090
2020-12-29,1865,1870,1804,1834,17924169,1210,7,12209169,5715000,1205,3,17772390,151779,-5563221,5563221
2020-12-30,1786,1830,1742,1770,15337342,826,8,7115885,8221457,1338,5,14035593,1301749,-6919708,6919708
2021-01-02,1672,1735,1672,1672,12167601,746,7,6675797,5491804,1094,2,12066701,100900,-5390904,5390904
2021-01-03,1616,1707,1614,1667,9206834,712,7,6753921,2452913,1283,1,9182765,24069,-2428844,2428844
2021-01-04,1660,1718,1641,1669,8785956,880,2,7973956,812000,855,1,8285956,500000,-312000,312000
2021-01-05,1658,1658,1584,1586,15486390,1067,6,8952300,6534090,1196,4,14198390,1288000,-5246090,5246090
2021-01-06,1522,1540,1520,1520,14478633,772,10,7062848,7415785,990,3,11906056,2572577,-4843208,4843208
2021-01-09,1485,1566,1447,1550,15879330,810,6,13502077,2377253,1487,5,14913612,965718,-1411535,1411535
2021-01-10,1570,1575,1524,1575,13431614,862,2,11830670,1600944,943,4,9127614,4304000,2703056,-2703056
2021-01-11,1606,1630,1522,1577,14084766,853,5,8823510,5261256,994,3,11179366,2905400,-2355856,2355856
2021-01-12,1504,1564,1494,1498,14983067,640,8,5763636,9219431,1038,1,14633067,350000,-8869431,8869431
2021-01-13,1430,1557,1430,1461,11495958,620,7,6253080,5242878,1068,4,9191860,2304098,-2938780,2938780
2021-01-16,1412,1465,1394,1394,16246822,508,11,4163301,12083521,1264,1,16226822,20000,-12063521,12063521
2021-01-18,1339,1357,1328,1328,17416143,360,9,3139906,14276237,1098,5,13302933,4113210,-10163027,10163027
2021-01-19,1276,1395,1273,1395,8554999,573,6,6556973,1998026,804,6,7388279,1166720,-831306,831306
2021-01-20,1419,1419,1366,1419,14655903,441,0,14655903,0,338,5,8505703,6150200,6150200,-6150200
2021-01-23,1487,1489,1463,1489,15884072,277,1,14884072,1000000,282,3,2880316,13003756,12003756,-12003756
2021-01-24,1562,1562,1439,1498,22591768,1649,4,21215126,1376642,902,5,17714768,4877000,3500358,-3500358
2021-01-25,1498,1583,1476,1537,10486688,610,4,8448329,2038359,741,3,7306688,3180000,1141641,-1141641
2021-01-26,1515,1546,1441,1467,12335104,516,5,6097212,6237892,641,1,12315411,19693,-6218199,6218199
2021-01-27,1467,1513,1412,1482,7433697,399,6,3886148,3547549,739,0,7433697,0,-3547549,3547549
2021-01-30,1467,1535,1467,1535,7683639,123,3,5120874,2562765,520,4,5529639,2154000,-408765,408765
2021-01-31,1584,1586,1511,1531,14123626,887,3,13668626,455000,873,2,13673626,450000,-5000,5000
2021-02-01,1577,1628,1493,1529,7792085,518,4,5920150,1871935,801,3,7375085,417000,-1454935,1454935
2021-02-02,1570,1599,1502,1570,8420464,356,6,4514953,3905511,774,2,7749464,671000,-3234511,3234511
2021-02-03,1480,1561,1465,1467,12881749,401,4,5045161,7836588,601,2,12681039,200710,-7635878,7635878
2021-02-06,1410,1410,1399,1401,10772743,277,7,2878978,7893765,593,0,10772743,0,-7893765,7893765
2021-02-07,1405,1471,1405,1471,6383154,121,0,6383154,0,505,5,3585612,2797542,2797542,-2797542
2021-02-08,1511,1511,1430,1498,14308462,473,5,7098462,7210000,841,4,12487906,1820556,-5389444,5389444
2021-02-09,1531,1535,1487,1517,4141441,450,2,3836441,305000,513,1,4111441,30000,-275000,275000
2021-02-13,1577,1584,1528,1584,23859703,587,1,23832703,27000,757,9,6504703,17355000,17328000,-17328000
2021-02-14,1647,1647,1551,1553,10885955,684,3,8052748,2833207,567,1,10542953,343002,-2490205,2490205
2021-02-15,1548,1594,1548,1548,7480897,337,7,2628735,4852162,465,1,7280897,200000,-4652162,4652162
2021-02-16,1528,1528,1528,1528,7377665,123,3,277665,7100000,284,0,7377665,0,-7100000,7100000
2021-02-17,1507,1559,1507,1507,7393557,242,6,2328959,5064598,442,1,7086657,306900,-4757698,4757698
2021-02-20,1489,1520,1489,1489,6984526,170,4,1944526,5040000,261,2,6084526,900000,-4140000,4140000
2021-02-21,1471,1471,1471,1471,4466401,64,3,160482,4305919,164,3,2066401,2400000,-1905919,1905919
2021-02-22,1458,1458,1458,1458,4201063,58,1,101063,4100000,25,2,2227729,1973334,-2126666,2126666
2021-02-23,1447,1489,1447,1489,9371565,247,4,6901565,2470000,501,5,5971565,3400000,930000,-930000
2021-02-24,1432,1496,1427,1427,5376151,330,4,2987543,2388608,442,1,5094401,281750,-2106858,2106858
2021-02-27,1416,1417,1416,1416,3030496,133,5,834748,2195748,331,0,3030496,0,-2195748,2195748
2021-02-28,1408,1408,1408,1408,3532867,117,3,412174,3120693,284,3,3032867,500000,-2620693,2620693
2021-03-01,1399,1449,1399,1399,11140313,393,8,6475460,4664853,632,5,4388740,6751573,2086720,-2086720
2021-03-02,1377,1430,1375,1384,4573650,451,5,3848553,725097,540,1,4218042,355608,-369489,369489
2021-03-03,1373,1401,1370,1390,5210356,219,5,2637007,2573349,490,1,5110356,100000,-2473349,2473349
2021-03-06,1366,1401,1361,1375,5891471,293,3,2316026,3575445,440,2,5388787,502684,-3072761,3072761
2021-03-07,1350,1417,1350,1388,10286983,324,6,5767689,4519294,553,5,3746306,6540677,2021383,-2021383
2021-03-08,1461,1461,1419,1461,25813295,657,2,23339096,2474199,703,6,4416718,21396577,18922378,-18922378
2021-03-09,1482,1513,1461,1489,15145419,933,1,14945419,200000,954,2,14645419,500000,300000,-300000
2021-03-10,1456,1494,1456,1494,5954353,351,5,3940989,2013364,527,2,5054353,900000,-1113364,1113364
2021-03-13,1458,1562,1452,1561,10383834,335,3,7383834,3000000,798,4,7783834,2600000,-400000,400000
2021-03-14,1540,1605,1540,1586,7004850,463,2,4604850,2400000,730,4,6132850,872000,-1528000,1528000
2021-03-15,1586,1601,1540,1594,5420719,341,5,4516537,904182,661,3,5118079,302640,-601542,601542
2021-03-16,1570,1660,1570,1660,22688011,446,4,14831566,7856445,623,8,5988011,16700000,8843555,-8843555
2021-03-17,1680,1705,1625,1665,11864352,673,5,6857888,5006464,651,2,11502818,361534,-4644930,4644930
2021-03-28,1641,1663,1610,1663,4723478,311,4,2492588,2230890,358,2,4623478,100000,-2130890,2130890
2021-03-30,1621,1665,1616,1660,3376172,272,3,2058760,1317412,431,1,3304413,71759,-1245653,1245653
2021-03-31,1621,1654,1612,1617,4051755,248,3,2850860,1200895,387,1,4050805,950,-1199945,1199945
2021-04-03,1605,1608,1603,1603,3111738,103,3,465353,2646385,221,2,2796738,315000,-2331385,2331385
2021-04-04,1594,1603,1594,1594,5872740,73,4,282740,5590000,203,1,4750503,1122237,-4467763,4467763
2021-04-05,1577,1608,1577,1583,3918482,221,5,2574282,1344200,433,2,3808482,110000,-1234200,1234200
2021-04-06,1568,1610,1568,1568,6084479,135,5,1163310,4921169,181,3,2856430,3228049,-1693120,1693120
2021-04-07,1551,1553,1551,1551,3212182,72,5,269592,2942590,233,3,2858426,353756,-2588834,2588834
2021-04-10,1542,1542,1542,1542,4167930,39,1,67930,4100000,228,1,4142430,25500,-4074500,4074500
2021-04-11,1529,1540,1529,1529,3341553,70,6,442466,2899087,243,1,3241553,100000,-2799087,2799087
2021-04-12,1522,1529,1522,1524,4208286,98,4,921212,3287074,235,3,4001139,207147,-3079927,3079927
2021-04-13,1518,1617,1518,1548,7465769,280,2,4946049,2519720,621,5,6154623,1311146,-1208574,1208574
2021-04-14,1537,1575,1537,1539,3619192,149,7,1002169,2617023,373,1,3616692,2500,-2614523,2614523
2021-04-17,1528,1533,1528,1528,3397662,54,2,174010,3223652,262,2,3377066,20596,-3203056,3203056
2021-04-18,1520,1520,1520,1520,2431734,31,1,106734,2325000,165,0,2431734,0,-2325000,2325000
2021-04-19,1513,1537,1513,1517,5194679,103,6,585163,4609516,265,2,4057741,1136938,-3472578,3472578
2021-04-20,1504,1529,1498,1498,4604613,265,8,1791938,2812675,354,0,4604613,0,-2812675,2812675
2021-04-21,1472,1566,1472,1472,4194129,134,7,1063737,3130392,248,1,2138492,2055637,-1074755,1074755
2021-04-24,1458,1469,1458,1458,4247041,104,7,658946,3588095,268,0,4247041,0,-3588095,3588095
2021-04-25,1441,1546,1441,1441,3185597,115,8,593089,2592508,228,3,3129294,56303,-2536205,2536205
2021-04-26,1430,1469,1430,1467,4567998,167,7,1149988,3418010,321,2,4417997,150001,-3268009,3268009
2021-04-27,1417,1485,1417,1467,4698993,229,5,4112632,586361,400,3,3390290,1308703,722342,-722342
2021-04-28,1423,1483,1423,1439,6074981,251,7,4138271,1936710,206,3,3629674,2445307,508597,-508597
2021-05-01,1416,1445,1408,1410,2823523,166,6,1281379,1542144,270,3,1948461,875062,-667082,667082
2021-05-02,1399,1428,1399,1399,4422044,105,6,476989,3945055,224,4,3964996,457048,-3488007,3488007
2021-05-03,1383,1394,1383,1386,2422863,127,7,682330,1740533,225,0,2422863,0,-1740533,1740533
2021-05-05,1373,1430,1373,1381,4129506,173,6,1399453,2730053,332,5,2893534,1235972,-1494081,1494081
2021-05-08,1366,1421,1364,1375,11447618,177,11,1364840,10082778,406,2,5947618,5500000,-4582778,4582778
2021-05-09,1326,1350,1326,1331,2275884,93,6,746756,1529128,304,1,2272524,3360,-1525768,1525768
2021-05-10,1320,1383,1320,1357,3147470,186,6,2315341,832129,318,2,3084640,62830,-769299,769299
2021-05-11,1348,1408,1348,1384,2311060,230,2,2205429,105631,298,3,1499112,811948,706317,-706317
2021-05-12,1320,1412,1320,1370,66158911,1209,5,18226154,47932757,3222,16,49264400,16894511,-31038246,31038246
2021-05-15,1320,1375,1300,1328,32169076,800,11,16220430,15948646,1755,11,18273848,13895228,-2053418,2053418
2021-05-16,1287,1329,1287,1311,21683222,438,11,9224044,12459178,1444,8,16490483,5192739,-7266439,7266439
2021-05-17,1269,1309,1251,1284,19444832,329,10,5527690,13917142,1146,4,16108869,3335963,-10581179,10581179
2021-05-18,1265,1306,1245,1284,20947134,392,14,8318574,12628560,1080,7,13534797,7412337,-5216223,5216223
2021-05-19,1265,1284,1229,1247,11140644,232,8,6109128,5031516,932,3,9878816,1261828,-3769688,3769688
2021-05-22,1194,1241,1188,1210,23853141,281,9,8544812,15308329,879,5,19017917,4835224,-10473105,10473105
2021-05-23,1144,1212,1144,1192,12214452,314,8,7457022,4757430,915,3,11683757,530695,-4226735,4226735
2021-05-24,1161,1218,1159,1207,12330826,243,7,3883279,8447547,1107,2,10703587,1627239,-6820308,6820308
2021-05-25,1192,1256,1192,1252,16451163,492,4,8466182,7984981,1159,10,9381621,7069542,-915439,915439
2021-05-26,1212,1280,1212,1247,11137370,468,4,6804646,4332724,1038,5,6394151,4743219,410495,-410495
2021-05-29,1230,1309,1230,1309,16914287,280,3,12534287,4380000,610,6,6452058,10462229,6082229,-6082229
2021-05-30,1320,1370,1307,1348,19608423,865,5,14773543,4834880,821,8,16572333,3036090,-1798790,1798790
2021-05-31,1304,1362,1284,1284,11390345,358,6,5852674,5537671,557,6,7953164,3437181,-2100490,2100490
2021-06-01,1265,1311,1247,1256,6358243,274,5,4413919,1944324,506,2,6029813,328430,-1615894,1615894
2021-06-02,1256,1317,1256,1300,7025297,282,6,4535906,2489391,575,3,6271451,753846,-1735545,1735545
2021-06-07,1284,1326,1278,1307,7585439,340,9,5903796,1681643,639,4,5860580,1724859,43216,-43216
2021-06-08,1291,1339,1289,1306,13353994,657,8,8077266,5276728,614,4,11862381,1491613,-3785115,3785115
2021-06-09,1287,1313,1276,1302,5597723,210,7,3976786,1620937,401,2,5565623,32100,-1588837,1588837
2021-06-12,1263,1300,1256,1269,4735719,230,5,3493750,1241969,425,4,4047644,688075,-553894,553894
2021-06-13,1238,1280,1238,1273,5004909,239,4,3862876,1142033,386,3,4903377,101532,-1040501,1040501
2021-06-14,1240,1306,1240,1284,9713300,305,5,8338399,1374901,513,2,8626262,1087038,-287863,287863
2021-06-15,1265,1293,1238,1241,4921112,276,5,3825135,1095977,436,2,4171112,750000,-345977,345977
2021-06-16,1247,1267,1232,1243,5660221,215,8,4655674,1004547,449,2,3903298,1756923,752376,-752376
2021-06-19,1293,1322,1284,1322,15429961,123,4,14819961,610000,437,7,7034660,8395301,7785301,-7785301
2021-06-20,1379,1379,1320,1348,21824563,658,4,15171447,6653116,794,14,16195936,5628627,-1024489,1024489
2021-06-21,1329,1377,1311,1373,22289627,404,3,6395729,15893898,576,6,8725003,13564624,-2329274,2329274
2021-06-22,1357,1427,1357,1427,15976782,368,4,11593277,4383505,751,6,12215835,3760947,-622558,622558
2021-06-23,1394,1480,1394,1480,48803683,851,4,30954262,17849421,872,15,22345333,26458350,8608929,-8608929
2021-06-26,1500,1526,1450,1458,19007104,968,7,13858964,5148140,774,6,17264684,1742420,-3405720,3405720
2021-06-27,1430,1494,1430,1478,12870949,437,9,8006767,4864182,809,4,12666629,204320,-4659862,4659862
2021-06-28,1445,1520,1445,1487,9052344,402,4,8532033,520311,653,3,8671344,381000,-139311,139311
2021-06-29,1467,1504,1467,1471,8274345,389,4,7234347,1039998,572,3,7240365,1033980,-6018,6018
2021-06-30,1478,1494,1458,1465,18973648,495,9,10739872,8233776,613,3,10227803,8745845,512069,-512069
2021-07-03,1443,1498,1441,1445,12826576,413,5,8355476,4471100,773,5,11975996,850580,-3620520,3620520
2021-07-04,1428,1480,1425,1478,16586854,367,4,9974511,6612343,651,9,9513633,7073221,460878,-460878
2021-07-05,1467,1517,1467,1515,13042906,388,6,7264752,5778154,571,3,7306420,5736486,-41668,41668
2021-07-06,1522,1568,1507,1568,41478550,643,6,35933577,5544973,773,17,11355894,30122656,24577683,-24577683
2021-07-07,1595,1605,1528,1577,21102240,730,5,16399210,4703030,759,8,16940564,4161676,-541354,541354
2021-07-10,1546,1577,1528,1559,13658802,418,9,9216390,4442412,665,3,12896802,762000,-3680412,3680412
2021-07-11,1540,1627,1540,1627,29607811,629,3,24120828,5486983,907,11,15542617,14065194,8578211,-8578211
2021-07-12,1632,1680,1632,1665,33387569,851,5,20966535,12421034,965,14,20744009,12643560,222526,-222526
2021-07-13,1665,1700,1625,1641,32536564,1025,3,27103217,5433347,976,11,22367851,10168713,4735366,-4735366
2021-07-18,1628,1628,1552,1600,13494379,308,5,7610653,5883726,341,3,13097927,396452,-5487274,5487274
2021-07-19,1567,1620,1548,1589,22988770,752,8,12580792,10407978,1004,7,22278504,710266,-9697712,9697712
2021-07-26,1661,1661,1643,1661,37321903,485,2,32521903,4800000,1090,10,18101902,19220001,14420001,-14420001
2021-07-27,1678,1719,1610,1626,25523555,645,9,20121259,5402296,690,8,20548572,4974983,-427313,427313
2021-07-28,1610,1674,1602,1653,24317420,518,7,13640522,10676898,729,10,19993974,4323446,-6353452,6353452
2021-07-31,1620,1725,1620,1725,33673680,561,4,30018462,3655218,932,15,20303414,13370266,9715048,-9715048
2021-08-01,1752,1797,1711,1746,34039727,852,6,27824386,6215341,1042,12,23531247,10508480,4293139,-4293139
2021-08-02,1742,1791,1721,1769,17529561,427,5,7098594,10430967,713,7,13180109,4349452,-6081515,6081515
2021-08-03,1756,1845,1729,1843,15085806,443,5,9174785,5911021,791,9,12254806,2831000,-3080021,3080021
2021-08-04,1814,1874,1793,1853,27567931,871,6,21436774,6131157,1060,12,19409749,8158182,2027025,-2027025
2021-08-07,1855,1855,1783,1793,16533995,632,9,8510368,8023627,836,5,14660452,1873543,-6150084,6150084
2021-08-08,1775,1843,1773,1793,14996796,567,9,9314867,5681929,896,4,11778131,3218665,-2463264,2463264
2021-08-09,1793,1795,1769,1787,29429623,703,11,16606989,12822634,777,4,14465371,14964252,2141618,-2141618
2021-08-10,1791,1849,1775,1849,17925362,513,5,11069461,6855901,788,6,16055362,1870000,-4985901,4985901
2021-08-11,1837,1900,1837,1900,42603817,742,10,25507774,17096043,1260,8,21369133,21234684,4138641,-4138641
2021-08-14,1878,1923,1857,1896,32017105,953,12,14504015,17513090,872,8,14457779,17559326,46236,-46236
2021-08-15,1886,1964,1872,1942,16962101,723,6,15319164,1642937,750,6,11562029,5400072,3757135,-3757135
2021-08-22,1958,2012,1931,2012,60086281,1094,8,53371281,6715000,1387,18,25330437,34755844,28040844,-28040844
2021-08-23,2053,2094,1979,2030,18845857,1269,4,18396857,449000,1113,5,15314132,3531725,3082725,-3082725
2021-08-24,2010,2146,2010,2144,38939892,1023,14,19299746,19640146,1254,13,26012384,12927508,-6712638,6712638
2021-08-25,2144,2164,2051,2111,20401224,1079,15,15089060,5312164,1028,3,16834225,3566999,-1745165,1745165
2021-08-28,2072,2191,2065,2191,88601473,984,21,33620522,54980951,1453,15,34670076,53931397,-1049554,1049554
2021-08-29,2222,2245,2063,2098,36716155,1308,11,26850711,9865444,1291,12,30032406,6683749,-3181695,3181695
2021-08-30,2063,2092,2047,2047,43546862,578,11,7080382,36466480,779,4,41868931,1677931,-34788549,34788549
2021-08-31,1950,2047,1950,1950,25891713,932,16,13695124,12209274,1162,5,22570536,3333862,-8875412,8875412
2021-09-01,1938,2061,1913,2037,17910490,718,4,12502328,5408162,837,10,13802526,4107964,-1300198,1300198
2021-09-04,2059,2061,1981,1999,18381793,926,8,14745793,3636000,824,5,12402333,5979460,2343460,-2343460
2021-09-05,1989,2020,1966,1977,17004176,657,5,8235572,8768604,845,2,11894507,5109669,-3658935,3658935
2021-09-06,1968,2024,1919,1936,17238087,637,9,14040877,3197210,1156,8,13226563,4011524,814314,-814314
2021-09-07,1940,1954,1888,1898,8812536,555,5,6551362,2261174,1128,2,7612526,1200010,-1061164,1061164
2021-09-08,1892,1966,1888,1940,17889023,592,6,10718411,7170612,2628,3,17565176,323847,-6846765,6846765
2021-09-11,1898,1964,1855,1867,12884194,661,6,10688978,2195216,1033,4,12848654,35540,-2159676,2159676
2021-09-12,1874,1917,1797,1814,16525205,929,9,10171289,6353916,966,2,15044058,1481147,-4872769,4872769
2021-09-13,1773,1832,1744,1797,14582387,538,8,9660309,4922078,1061,3,13082387,1500000,-3422078,3422078
2021-09-14,1797,1835,1783,1818,11196593,461,4,9671034,1525559,725,7,9051898,2144695,619136,-619136
2021-09-15,1818,1822,1762,1797,6952446,418,4,5003237,1949209,1058,2,6892446,60000,-1889209,1889209
2021-09-18,1764,1793,1709,1709,15176187,626,6,9152602,6023585,488,4,13417664,1758523,-4265062,4265062
2021-09-19,1703,1744,1647,1670,18586589,680,8,15721633,2864956,1611,4,13833282,4753307,1888351,-1888351
2021-09-20,1672,1721,1672,1678,11956316,582,5,10737748,1218568,1504,2,10946166,1010150,-208418,208418
2021-09-21,1663,1709,1628,1649,13977441,464,6,6955604,7021837,1735,1,13477441,500000,-6521837,6521837
2021-09-22,1649,1686,1600,1665,18237982,625,7,13914110,4323872,1394,4,17693626,544356,-3779516,3779516
2021-09-25,1680,1734,1680,1734,23906653,558,5,19833809,4072844,891,9,12942372,10964281,6891437,-6891437
2021-09-26,1750,1773,1690,1727,10797288,718,3,10365364,431924,598,2,10679596,117692,-314232,314232
2021-09-28,1729,1769,1713,1721,5007848,559,4,4576848,431000,477,0,5007848,0,-431000,431000
2021-09-29,1715,1818,1715,1818,26806747,274,5,14046453,12760294,634,5,11857024,14949723,2189429,-2189429
2021-10-02,1876,1896,1853,1896,49940914,1435,7,38843459,11097455,1467,6,34009599,15931315,4833860,-4833860
2021-10-03,1913,1977,1859,1931,35407870,946,5,18376648,17031222,1257,5,29565078,5842792,-11188430,11188430
2021-10-04,1929,1958,1890,1911,7917322,567,6,6782902,1134420,696,4,7203832,713490,-420930,420930
2021-10-06,1898,1938,1876,1898,8462389,558,6,6568532,1893857,668,2,6960696,1501693,-392164,392164
2021-10-09,1968,1968,1804,1808,12585270,623,4,9094674,3490596,559,2,12452879,132391,-3358205,3358205
2021-10-10,1795,1876,1783,1859,9880316,360,7,5837732,4042584,540,2,9749433,130883,-3911701,3911701
2021-10-11,1876,1876,1799,1802,7775462,326,9,4101432,3674030,366,1,5232644,2542818,-1131212,1131212
2021-10-12,1806,1835,1740,1756,15005282,378,11,5883707,9121575,539,4,13449274,1556008,-7565567,7565567
2021-10-13,1696,1764,1688,1764,8898833,234,11,2959260,5939573,493,5,7336208,1562625,-4376948,4376948
2021-10-16,1754,1814,1754,1814,11887892,130,3,11468006,419886,425,6,4625439,7262453,6842567,-6842567
2021-10-17,1853,1853,1750,1791,5573716,301,4,4948001,625715,411,4,5457962,115754,-509961,509961
2021-10-18,1758,1888,1758,1876,20354397,484,6,14485292,5869105,905,3,19377695,976702,-4892403,4892403
2021-10-19,1876,1915,1835,1878,8226394,361,8,6174689,2051705,473,4,6899081,1327313,-724392,724392
2021-10-20,1876,1876,1793,1830,6083412,257,5,4227412,1856000,326,1,5889812,193600,-1662400,1662400
2021-10-23,1822,1822,1762,1762,24097625,419,7,9705299,14392326,478,4,21695225,2402400,-11989926,11989926
2021-10-25,1758,1758,1703,1723,8174645,203,11,2708939,5465706,492,3,8092646,81999,-5383707,5383707
2021-10-26,1705,1758,1705,1731,6922528,222,5,4636215,2286313,406,2,5968421,954107,-1332206,1332206
2021-10-27,1703,1752,1703,1731,12037976,319,7,10184204,1853772,376,6,6034100,6003876,4150104,-4150104
2021-10-30,1764,1764,1670,1701,10796799,209,7,3533390,7263409,570,5,8471634,2325165,-4938244,4938244
2021-10-31,1676,1690,1616,1618,11972883,332,11,3517594,8455289,492,5,11426911,545972,-7909317,7909317
2021-11-01,1622,1707,1622,1690,5767839,239,5,4568284,1199555,366,5,3940004,1827835,628280,-628280
2021-11-02,1682,1705,1657,1663,9188417,366,5,8070513,1117904,265,7,2570449,6617968,5500064,-5500064
2021-11-03,1672,1754,1651,1754,14499708,246,9,7727515,6772193,466,4,8608585,5891123,-881070,881070
2021-11-06,1773,1814,1754,1814,21384442,309,4,15834442,5550000,408,6,11116959,10267483,4717483,-4717483
2021-11-07,1804,1845,1752,1783,11381362,341,6,5716885,5664477,439,5,10746352,635010,-5029467,5029467
2021-11-08,1764,1824,1754,1818,9703093,197,6,3075891,6627202,466,6,8569822,1133271,-5493931,5493931
2021-11-09,1783,1872,1783,1855,13065953,226,6,5204915,7861038,564,9,7716937,5349016,-2512022,2512022
2021-11-10,1880,1880,1824,1876,13808993,370,7,9286326,4522667,455,6,7917786,5891207,1368540,-1368540
2021-11-13,1828,1828,1777,1793,9967883,314,6,5906704,4061179,346,1,5419771,4548112,486933,-486933
2021-11-14,1779,1826,1756,1764,8411262,283,6,3726430,4684832,353,5,2860428,5550834,866002,-866002
2021-11-15,1764,1820,1738,1742,6210346,163,8,2028509,4181837,341,5,5022740,1187606,-2994231,2994231
2021-11-16,1742,1769,1721,1729,5705772,223,6,3125772,2580000,278,2,2177931,3527841,947841,-947841
2021-11-17,1731,1766,1721,1744,8930518,333,9,5483568,3446950,303,4,3110431,5820087,2373137,-2373137
2021-11-20,1717,1740,1682,1688,6162761,252,7,3493098,2669663,319,1,5962761,200000,-2469663,2469663
2021-11-21,1690,1744,1688,1738,14435780,367,17,7046878,7388902,397,8,7197139,7238641,-150261,150261
2021-11-22,1738,1777,1717,1744,7492841,280,6,6109264,1383577,371,4,3573888,3918953,2535376,-2535376
2021-11-23,1721,1742,1709,1711,10759887,173,10,4979588,5780299,338,6,3932367,6827520,1047221,-1047221
2021-11-24,1711,1731,1674,1731,8104872,212,9,4024897,4079975,331,4,6966010,1138862,-2941113,2941113
2021-11-27,1682,1709,1647,1661,6103819,261,7,3182530,2921289,328,3,5411359,692460,-2228829,2228829
2021-11-28,1686,1709,1639,1678,7112504,160,11,3124988,3987516,359,2,5997519,1114985,-2872531,2872531
2021-11-29,1663,1717,1651,1674,13931593,216,12,6923367,7008226,367,5,6211593,7720000,711774,-711774
2021-11-30,1703,1703,1661,1696,6815630,148,5,1919376,4896254,309,4,4505735,2309895,-2586359,2586359
2021-12-01,1696,1696,1651,1674,6299049,125,5,1059454,5239595,257,6,3303412,2995637,-2243958,2243958
2021-12-04,1672,1674,1620,1647,8211389,223,7,4171044,4040345,341,4,4711583,3499806,-540539,540539
2021-12-05,1653,1674,1641,1649,3966677,189,4,2386582,1580095,258,3,3583777,382900,-1197195,1197195
2021-12-06,1649,1690,1647,1670,5506069,113,6,1104979,4401090,325,2,5089228,416841,-3984249,3984249
2021-12-07,1663,1690,1657,1674,4356568,87,6,863372,3493196,292,4,3660124,696444,-2796752,2796752
2021-12-08,1696,1729,1670,1701,8021089,110,8,1543087,6478002,313,2,3723919,4297170,-2180832,2180832
2021-12-11,1684,1709,1680,1694,3194620,87,2,1180242,2014378,277,3,2942120,252500,-1761878,1761878
2021-12-12,1694,1694,1628,1676,5067656,116,5,2184381,2883275,233,4,3358652,1709004,-1174271,1174271
2021-12-13,1649,1678,1600,1606,13684196,181,7,2354119,11330077,302,5,10181307,3502889,-7827188,7827188
2021-12-14,1630,1661,1606,1659,4595937,98,6,777832,3818105,341,3,4222078,373859,-3444246,3444246
2021-12-15,1661,1680,1622,1639,6886482,108,7,1539553,5346929,213,5,2809990,4076492,-1270437,1270437
2021-12-18,1628,1661,1628,1649,3687015,107,6,873761,2813254,221,1,3187015,500000,-2313254,2313254
2021-12-19,1663,1663,1633,1647,4063298,71,6,728460,3334838,266,1,3563298,500000,-2834838,2834838
2021-12-20,1639,1721,1637,1721,11426279,150,10,4128037,7298242,521,6,9688963,1737316,-5560926,5560926
2021-12-21,1694,1756,1694,1721,4819264,149,7,2036505,2782759,214,1,4541264,278000,-2504759,2504759
2021-12-22,1721,1789,1713,1789,9587737,266,7,6284880,3302857,292,4,4194963,5392774,2089917,-2089917
2021-12-25,1789,1820,1756,1766,7168204,209,5,2598273,4569931,447,3,6621855,546349,-4023582,4023582
2021-12-26,1771,1824,1731,1795,6366022,134,5,2569954,3796068,331,4,4721182,1644840,-2151228,2151228
2021-12-27,1785,1830,1771,1789,5198113,137,5,2041706,3156407,273,3,4598873,599240,-2557167,2557167
2021-12-28,1779,1797,1760,1771,6450347,152,8,2189324,4261023,227,2,2824702,3625645,-635378,635378
2021-12-29,1752,1781,1719,1727,3268527,205,3,1960848,1307679,169,3,1343032,1925495,617816,-617816
2022-01-01,1758,1762,1696,1746,5762938,136,5,1493782,4269156,290,3,4899938,863000,-3406156,3406156
2022-01-02,1746,1750,1707,1711,4608351,148,7,1423371,3184980,210,2,2680379,1927972,-1257008,1257008
2022-01-03,1734,1734,1692,1705,3308929,124,6,1458999,1849930,209,1,2838929,470000,-1379930,1379930
2022-01-04,1701,1721,1680,1690,3023737,101,6,816304,2207433,167,0,3023737,0,-2207433,2207433
2022-01-05,1694,1721,1692,1701,2047910,81,6,791292,1256618,186,0,2047910,0,-1256618,1256618
2022-01-08,1688,1725,1668,1715,5107145,192,8,2330164,2776981,270,2,3792732,1314413,-1462568,1462568
2022-01-09,1684,1686,1643,1655,5806793,166,6,1786579,4020214,220,1,3509750,2297043,-1723171,1723171
2022-01-10,1651,1686,1649,1672,4306259,100,7,1014975,3291284,254,3,3309681,996578,-2294706,2294706
2022-01-11,1659,1698,1643,1649,4731683,168,6,2035174,2696509,169,3,1647131,3084552,388043,-388043
2022-01-12,1639,1655,1628,1649,3399358,156,4,1795720,1603638,174,4,2469818,929540,-674098,674098
2022-01-15,1663,1663,1633,1649,4734386,93,7,848674,3885712,253,2,3987433,746953,-3138759,3138759
2022-01-16,1649,1657,1628,1655,5428599,85,8,701804,4726795,230,4,4290292,1138307,-3588488,3588488
2022-01-17,1657,1670,1616,1628,4495359,149,7,892444,3602915,183,4,2987739,1507620,-2095295,2095295
2022-01-18,1618,1639,1560,1579,6679941,224,9,1361292,5318649,242,3,5537077,1142864,-4175785,4175785
2022-01-19,1577,1624,1575,1618,6141178,109,6,1265694,4875484,217,3,4766178,1375000,-3500484,3500484
2022-01-22,1606,1645,1583,1608,5077949,130,4,3380767,1697182,243,8,2475244,2602705,905523,-905523
2022-01-23,1600,1600,1523,1540,16313559,182,8,4196673,12116886,197,6,6660395,9653164,-2463722,2463722
2022-01-24,1546,1546,1472,1505,6790529,99,6,1654488,5136041,236,3,5505529,1285000,-3851041,3851041
2022-01-25,1496,1529,1445,1519,15287715,204,10,3757460,11530255,332,7,11604177,3683538,-7846717,7846717
2022-01-26,1505,1536,1501,1536,8745071,127,1,7360398,1384673,302,7,6532334,2212737,828064,-828064
2022-01-29,1532,1593,1532,1593,8256874,85,4,7601974,654900,216,2,6756874,1500000,845100,-845100
2022-01-30,1649,1649,1554,1608,10923558,252,5,7407930,3515628,209,3,8896089,2027469,-1488159,1488159
2022-01-31,1645,1645,1595,1608,8693808,219,6,4326536,4367272,235,3,5793808,2900000,-1467272,1467272
2022-02-01,1612,1637,1581,1612,6663722,123,3,1149124,5514598,203,1,5660722,1003000,-4511598,4511598
2022-02-02,1597,1612,1575,1604,5092713,100,4,1358165,3734548,182,4,4173141,919572,-2814976,2814976
2022-02-05,1602,1614,1577,1602,2564872,68,2,651637,1913235,219,2,2219872,345000,-1568235,1568235
2022-02-06,1597,1600,1521,1544,9396899,115,5,1196940,8199959,235,6,7918954,1477945,-6722014,6722014
2022-02-07,1544,1597,1521,1567,6110231,64,2,1194011,4916220,293,5,4516320,1593911,-3322309,3322309
2022-02-08,1560,1597,1552,1587,5123425,66,2,1134130,3989295,248,2,4373425,750000,-3239295,3239295
2022-02-09,1569,1608,1567,1589,3299292,93,2,1194765,2104527,337,1,2895437,403855,-1700672,1700672
2022-02-12,1587,1612,1496,1567,5852646,156,5,3289349,2563297,239,2,2477252,3375394,812097,-812097
2022-02-13,1618,1630,1554,1567,10531254,110,3,1640263,8890991,273,5,3368596,7162658,-1728333,1728333
2022-02-14,1639,1639,1587,1597,4378128,57,4,1015944,3362184,199,4,3212188,1165940,-2196244,2196244
2022-02-16,1639,1639,1591,1610,5882671,78,10,1673575,4209096,280,5,4124565,1758106,-2450990,2450990
2022-02-22,1610,1649,1546,1624,7923188,120,3,1109465,6813723,256,8,6530732,1392456,-5421267,5421267
2022-02-23,1628,1649,1614,1626,6668100,128,3,2530152,4137948,299,4,5578100,1090000,-3047948,3047948
2022-02-26,1649,1651,1604,1628,5087570,88,2,832643,4254927,260,7,3906419,1181151,-3073776,3073776
2022-02-27,1628,1668,1612,1633,6313052,80,3,1682214,4630838,238,5,4750095,1562957,-3067881,3067881
2022-02-28,1665,1665,1614,1633,3788794,108,3,1661153,2127641,200,3,3406794,382000,-1745641,1745641
2022-03-02,1643,1670,1606,1633,10173463,95,2,3604766,6568697,290,6,7420171,2753292,-3815405,3815405
2022-03-05,1635,1651,1620,1643,3993624,125,4,1890546,2103078,257,2,3784624,209000,-1894078,1894078
2022-03-06,1643,1680,1622,1670,9299963,165,4,6288579,3011384,363,5,7698963,1601000,-1410384,1410384
2022-03-07,1711,1711,1659,1686,15061510,183,9,8336576,7024934,331,7,8313462,7048048,23114,-23114
2022-03-08,1752,1752,1653,1680,5815028,151,5,1992466,3822562,208,5,2297236,3517792,-304770,304770
2022-03-09,1731,1750,1665,1670,5741883,256,4,4083508,1658375,251,3,3206963,2534920,876545,-876545
2022-03-12,1752,1752,1635,1647,6952818,177,5,3285990,3666828,281,5,3605119,3347699,-319129,319129
2022-03-13,1661,1690,1624,1670,5036435,139,7,1379308,3657127,224,3,4009771,1026664,-2630463,2630463
2022-03-14,1668,1680,1639,1668,2951909,73,5,592702,2359207,207,3,2447664,504245,-1854962,1854962
2022-03-15,1665,1665,1635,1659,6541515,90,5,521027,6020488,169,4,4217335,2324180,-3696308,3696308
2022-03-16,1659,1692,1649,1690,6040738,158,3,3749887,2290851,177,5,2834640,3206098,915247,-915247
2022-03-19,1711,1731,1665,1672,13358540,308,7,9664173,3694367,194,5,4363417,8995123,5300756,-5300756
2022-03-26,1707,1731,1680,1707,6116810,146,7,2684195,3432615,212,2,6010810,106000,-3326615,3326615
2022-03-27,1694,1711,1680,1686,7123120,217,3,5793982,1329138,172,4,2835763,4287357,2958219,-2958219
2022-03-28,1692,1764,1690,1754,7983505,255,7,4964511,3018994,305,5,5976370,2007135,-1011859,1011859
2022-03-29,1742,1752,1688,1692,6824721,231,4,5490162,1334559,178,4,2894787,3929934,2595375,-2595375
2022-03-30,1715,1742,1701,1731,7041207,169,4,4028325,3012882,201,3,4490210,2550997,-461885,461885
2022-04-03,1731,1806,1721,1806,13965169,276,8,10238935,3726234,490,5,8361761,5603408,1877174,-1877174
2022-04-04,1845,1845,1754,1760,5885152,275,5,4484752,1400400,309,5,4708811,1176341,-224059,224059
2022-04-05,1791,1814,1762,1797,4371232,159,2,3048707,1322525,248,0,4371232,0,-1322525,1322525
2022-04-06,1822,1855,1766,1775,8214907,189,2,3934960,4279947,312,7,5928519,2286388,-1993559,1993559
2022-04-09,1806,1812,1766,1799,3410712,139,7,1648980,1761732,258,2,3328323,82389,-1679343,1679343
2022-04-10,1802,1853,1799,1820,8490346,164,6,5351226,3139120,305,5,3850346,4640000,1500880,-1500880
2022-04-11,1820,1855,1814,1855,7880833,151,9,3681255,4199578,336,1,5880833,2000000,-2199578,2199578
2022-04-12,1835,1835,1744,1754,4657393,224,3,3570893,1086500,216,1,2857393,1800000,713500,-713500
2022-04-13,1787,1859,1771,1859,7121376,115,4,1570469,5550907,366,1,7071076,50300,-5500607,5500607
2022-04-16,1855,1855,1812,1839,4801139,174,5,3045274,1755865,286,4,4336578,464561,-1291304,1291304
2022-04-17,1830,1890,1812,1886,10928205,202,7,4262822,6665383,415,4,5643205,5285000,-1380383,1380383
2022-04-18,1888,1960,1870,1960,75895432,472,10,56160483,19734949,738,11,24918449,50976983,31242034,-31242034
2022-04-19,1985,2012,1938,1964,26369494,544,8,18411053,7958441,500,8,21112536,5256958,-2701483,2701483
2022-04-20,1975,2092,1975,2092,117811723,843,20,74505014,44005173,1398,23,64905835,53604352,9599179,-9599179
2022-04-24,2160,2162,2080,2092,25052485,609,13,18098307,6954178,752,9,21069092,3983393,-2970785,2970785
2022-04-25,2107,2203,2078,2146,27706808,382,8,22162419,5544389,743,8,23517697,4189111,-1355278,1355278
2022-04-26,2164,2193,2001,2094,39813074,660,12,21628187,18184887,881,8,29813508,9999566,-8185321,8185321
2022-04-27,2092,2107,2039,2082,22443507,382,12,6412743,16030764,593,5,19093507,3350000,-12680764,12680764
2022-04-30,2063,2111,2055,2067,14004404,246,10,4377312,9627092,468,6,7629052,6375352,-3251740,3251740
2022-05-01,2088,2088,2051,2061,13084993,285,7,6667152,6417841,339,3,11584993,1500000,-4917841,4917841
2022-05-02,2065,2102,2053,2094,9817722,166,5,3755762,6061960,328,6,4916223,4901499,-1160461,1160461
2022-05-07,2080,2119,2072,2082,10171320,254,10,6348177,3823143,440,4,8552077,1619243,-2203900,2203900
2022-05-08,2102,2154,2102,2125,23367484,981,12,11046138,12321346,585,7,19386483,3981001,-8340345,8340345
2022-05-09,2127,2156,2069,2080,10936728,181,7,6601878,4334850,434,9,9040445,1896283,-2438567,2438567
2022-05-10,2080,2144,2078,2102,8877319,178,5,4418414,4458905,333,7,7129502,1747817,-2711088,2711088
2022-05-11,2109,2216,2109,2206,24408058,294,9,12389002,12019056,675,10,13292821,11115237,-903819,903819
2022-05-14,2168,2296,2168,2296,60754669,571,18,41850251,18904418,940,12,17475017,43279652,24375234,-24375234
2022-05-15,2337,2360,2251,2288,17940338,570,7,16238264,1702074,665,3,14927482,3012856,1310782,-1310782
2022-05-16,2302,2410,2245,2333,16207761,364,11,13332986,2874775,891,7,12941524,3266237,391462,-391462
2022-05-17,2333,2391,2298,2344,20229286,265,8,6869787,13359499,646,6,13258786,6970500,-6388999,6388999
2022-05-18,2360,2360,2224,2257,8561164,370,7,6097908,2463256,471,1,8554164,7000,-2456256,2456256
2022-05-21,2278,2278,2181,2226,23226637,359,8,10153559,13073078,432,3,21856637,1370000,-11703078,11703078
2022-05-22,2208,2245,2164,2212,9131984,240,7,2679974,6452010,355,4,7124070,2007914,-4444096,4444096
2022-05-23,2201,2201,2069,2111,16036704,269,9,4976310,11060394,405,4,11230651,4806053,-6254341,6254341
2022-05-24,2111,2131,2074,2121,14028293,181,6,1934830,12093463,291,5,9519993,4508300,-7585163,7585163
2022-05-25,2131,2144,2117,2125,10317237,198,3,3128403,7188834,268,5,6925881,3391356,-3797478,3797478
2022-05-28,2129,2154,2043,2043,8230204,257,7,5241398,2988806,306,1,8220104,10100,-2978706,2978706
2022-05-29,2080,2086,1999,2061,6729427,191,9,1999306,4730121,376,3,6404029,325398,-4404723,4404723
2022-05-30,2065,2094,2053,2059,8240025,159,4,3018938,5221087,269,7,4900799,3339226,-1881861,1881861
2022-05-31,2051,2072,2034,2061,9063284,194,7,2028698,7034586,258,3,4078784,4984500,-2050086,2050086
2022-06-01,2047,2063,2008,2063,3678924,159,6,2452526,1226398,224,1,3378924,300000,-926398,926398
2022-06-06,2051,2051,1958,1989,7228641,163,6,3670010,3558631,318,2,6169306,1059335,-2499296,2499296
2022-06-07,1948,2022,1948,2014,4725038,119,5,1281461,3443577,231,3,3353477,1371561,-2072016,2072016
2022-06-08,1975,2024,1973,2014,1775409,104,6,1351457,423952,204,2,1656563,118846,-305106,305106
2022-06-11,1985,2020,1985,1993,2980175,121,3,1562581,1417594,241,2,2350175,630000,-787594,787594
2022-06-12,2012,2065,1999,2045,5419880,200,3,5038180,381700,301,6,3601950,1817930,1436230,-1436230
2022-06-13,2034,2125,2034,2102,12393633,310,1,12366740,26893,352,7,4037829,8355804,8328911,-8328911
2022-06-14,2090,2123,2074,2107,18393152,852,2,17413396,979756,337,7,8198962,10194190,9214434,-9214434
2022-06-15,2098,2111,2045,2057,4507892,180,3,2756109,1751783,244,5,3755554,752338,-999445,999445
2022-06-18,2082,2082,2006,2041,4396921,179,4,1986110,2410811,191,2,4384074,12847,-2397964,2397964
2022-06-19,2102,2162,2100,2102,19518751,466,2,17841775,1676976,512,13,8211960,11306791,9629815,-9629815
2022-06-20,2121,2154,2061,2072,13029897,209,5,3301619,9728278,322,6,9113802,3916095,-5812183,5812183
2022-06-21,2094,2098,2059,2090,6457201,126,4,4758588,1698613,235,3,5535110,922091,-776522,776522
2022-06-22,2088,2088,2059,2065,3215596,152,3,2057120,1158476,192,1,3205596,10000,-1148476,1148476
2022-06-25,2090,2090,2055,2063,12115385,157,4,7081277,5034108,291,6,10647625,1467760,-3566348,3566348
2022-06-26,2061,2069,2014,2024,3733933,121,3,2008773,1725160,210,3,3148015,585918,-1139242,1139242
2022-06-27,2049,2057,2020,2041,5057315,133,6,1609213,3448102,252,1,4957315,100000,-3348102,3348102
2022-06-28,2049,2078,2024,2049,2880054,156,2,2350002,530052,225,1,2872700,7354,-522698,522698
2022-06-29,2049,2059,2020,2041,8449640,233,3,8016440,433200,199,1,3649640,4800000,4366800,-4366800
2022-07-02,2041,2059,2012,2026,4075750,205,2,3767849,307901,232,0,4075750,0,-307901,307901
2022-07-03,2032,2045,2016,2041,7327830,419,5,5256533,2071297,212,1,7252830,75000,-1996297,1996297
2022-07-04,2034,2061,2032,2032,5677712,578,7,5229642,448070,249,3,4860768,816944,368874,-368874
2022-07-05,2043,2059,2018,2020,6291233,210,5,3181776,3109457,189,1,1619522,4671711,1562254,-1562254
2022-07-06,2037,2037,1997,2006,3839395,194,4,2059775,1779620,210,2,2462653,1376742,-402878,402878
2022-07-09,2028,2037,2001,2010,4519401,154,4,2453921,2065480,224,3,4139374,380027,-1685453,1685453
2022-07-11,2020,2051,2004,2010,4528872,122,5,3000600,1528272,272,2,4417175,111697,-1416575,1416575
2022-07-12,2020,2049,1999,2004,5119089,184,6,3677461,1441628,204,5,4272920,846169,-595459,595459
2022-07-13,2123,2123,2034,2074,17647480,230,6,6612151,11035329,407,2,16729506,917974,-10117355,10117355
2022-07-23,2092,2092,2080,2082,3462637,53,3,2106694,1355943,62,1,3262637,200000,-1155943,1155943
2022-07-24,2092,2140,2008,2068,13772370,317,10,10482313,3290057,369,3,10821433,2950937,-339120,339120
2022-07-25,2070,2070,1979,1979,6295109,177,8,3529348,2765761,225,2,6195109,100000,-2665761,2665761
2022-07-26,2024,2051,2010,2020,11417157,108,8,3175633,8241524,287,4,8417758,2999399,-5242125,5242125
2022-07-27,2032,2051,2020,2046,4546591,79,6,3064065,1482526,212,3,4145891,400700,-1081826,1081826
2022-07-30,2044,2082,2008,2008,5012539,102,4,2554477,2458062,191,2,4281939,730600,-1727462,1727462
2022-07-31,2032,2039,1981,1996,5767689,75,10,2423439,3344250,231,3,5469765,297924,-3046326,3046326
2022-08-01,2017,2032,1979,1991,4312426,95,9,2335060,1977366,148,3,3366632,945794,-1031572,1031572
2022-08-02,2012,2044,1996,2000,3318886,73,7,888460,2430426,157,3,3017911,300975,-2129451,2129451
2022-08-03,2012,2032,2010,2022,3484932,57,6,1528765,1956167,148,3,1995897,1489035,-467132,467132
2022-08-06,2015,2082,2012,2056,4014847,118,1,3993327,21520,170,2,3494981,519866,498346,-498346
2022-08-09,2053,2080,2029,2044,7014451,113,3,4798791,2215660,147,9,2846551,4167900,1952240,-1952240
2022-08-10,2080,2162,2080,2162,10008669,43,2,8408669,1600000,262,4,4140968,5867701,4267701,-4267701
2022-08-13,2275,2275,2275,2275,13277617,70,9,11477617,1800000,205,4,5159925,8117692,6317692,-6317692
2022-08-14,2409,2409,2409,2409,23391705,142,6,20974252,2417453,586,6,8385298,15006407,12588954,-12588954
2022-08-15,2450,2501,2351,2368,88409766,1377,19,47614366,40795400,1102,23,79694545,8715221,-32080179,32080179
2022-08-16,2364,2383,2289,2289,67604405,740,17,26114853,41489552,462,17,31206193,36398212,-5091340,5091340
2022-08-17,2214,2330,2212,2282,13565055,388,7,10213315,3351740,560,4,11825974,1739081,-1612659,1612659
2022-08-20,2275,2275,2212,2226,7055276,194,8,3859121,3196155,278,0,7055276,0,-3196155,3196155
2022-08-21,2238,2366,2222,2306,13464321,305,6,11958346,1505975,414,4,12890088,574233,-931742,931742
2022-08-22,2313,2371,2311,2356,6208815,183,6,5392540,816275,380,1,6183815,25000,-791275,791275
2022-08-23,2332,2428,2332,2404,8563409,172,6,4952631,3610778,408,6,8062594,500815,-3109963,3109963
2022-08-24,2385,2433,2385,2409,8663307,182,12,5091280,3572027,291,3,7477923,1185384,-2386643,2386643
2022-08-27,2400,2440,2397,2407,8099877,158,12,3663552,4436325,337,5,6626877,1473000,-2963325,2963325
2022-08-28,2414,2419,2378,2409,10716846,91,10,2440911,8275935,307,4,10104846,612000,-7663935,7663935
2022-08-29,2404,2568,2395,2498,58108243,865,15,51559016,6549227,790,20,28976633,29131610,22582383,-22582383
2022-08-30,2517,2537,2448,2462,7240798,268,4,6070721,1170077,356,0,7240798,0,-1170077,1170077
2022-08-31,2493,2546,2436,2477,4477380,169,6,2971425,1505955,295,4,3641581,835799,-670156,670156
2022-09-03,2465,2477,2378,2395,14891359,210,11,6102370,8788989,270,4,12384689,2506670,-6282319,6282319
2022-09-04,2409,2416,2359,2366,7037810,210,8,4673180,2364630,241,0,7037810,0,-2364630,2364630
2022-09-05,2404,2404,2354,2364,6624066,136,5,2039473,4584593,210,0,6624066,0,-4584593,4584593
2022-09-06,2385,2416,2356,2395,4509393,106,4,3367659,1141734,248,6,4086443,422950,-718784,718784
2022-09-07,2378,2409,2368,2380,4530696,68,7,1618132,2912564,198,5,2798912,1731784,-1180780,1180780
2022-09-10,2388,2400,2337,2378,4178468,66,5,1700685,2477783,228,3,4157338,21130,-2456653,2456653
2022-09-11,2383,2402,2335,2337,7633209,106,7,1672025,5961184,181,4,4197626,3435583,-2525601,2525601
2022-09-12,2376,2380,2337,2356,4814895,89,5,1974564,2840331,168,3,3674895,1140000,-1700331,1700331
2022-09-13,2332,2356,2289,2335,9253430,175,10,4195383,5058047,206,6,5515937,3737493,-1320554,1320554
2022-09-14,2344,2385,2330,2337,6480833,160,3,4791183,1689650,158,4,4229138,2251695,562045,-562045
2022-09-18,2337,2342,2275,2315,6405032,135,8,2969843,3435189,227,2,6166438,238594,-3196595,3196595
2022-09-19,2308,2325,2282,2313,2085535,71,2,1595535,490000,157,0,2085535,0,-490000,490000
2022-09-20,2318,2318,2277,2291,3516805,81,8,1648344,1868461,150,1,2739251,777554,-1090907,1090907
2022-09-21,2308,2308,2260,2275,5634549,97,5,2360378,3274171,168,4,5204827,429722,-2844449,2844449
2022-09-24,2260,2260,2195,2212,7678673,117,8,2548761,5129912,188,3,6065025,1613648,-3516264,3516264
2022-09-26,2212,2270,2210,2226,1753563,103,5,1336697,416866,142,1,1691563,62000,-354866,354866
2022-09-28,2294,2320,2248,2255,1117843,88,2,857843,260000,109,0,1117843,0,-260000,260000
2022-10-01,2241,2241,2135,2138,7781564,153,8,3587844,4193720,175,1,6881564,900000,-3293720,3293720
2022-10-02,2193,2195,2128,2176,4674587,64,7,1692722,2981865,190,1,4589715,84872,-2896993,2896993
2022-10-03,2183,2195,2162,2181,4665083,50,4,3135348,1529735,158,0,4665083,0,-1529735,1529735
2022-10-04,2178,2207,2147,2166,2533022,61,2,2225237,307785,133,0,2533022,0,-307785,307785
2022-10-08,2174,2188,2140,2150,4663348,98,4,3585116,1078232,131,1,3559653,1103695,25463,-25463
2022-10-09,2140,2150,2092,2116,5203157,59,4,1227987,3975170,142,2,3845570,1357587,-2617583,2617583
2022-10-10,2142,2154,2118,2125,2812878,68,4,1014406,1798472,141,0,2812878,0,-1798472,1798472
2022-10-11,2142,2174,2123,2138,1855596,80,3,741935,1113661,128,1,1416743,438853,-674808,674808
2022-10-12,2142,2234,2140,2186,4055909,75,6,3158179,897730,160,5,2398847,1657062,759332,-759332
2022-10-15,2164,2166,2097,2125,2034621,101,3,1358371,676250,108,3,1629417,405204,-271046,271046
2022-10-16,2145,2145,2087,2089,2538707,103,4,1445270,1093437,133,1,2435355,103352,-990085,990085
2022-10-17,2130,2130,2061,2073,4292263,166,4,1801960,2490303,121,2,3786098,506165,-1984138,1984138
2022-10-18,2116,2138,2056,2065,3007177,150,3,2291466,715711,131,1,3004307,2870,-712841,712841
2022-10-19,2044,2092,1991,1998,8479673,340,7,6202565,2277108,129,9,5578630,2901043,623935,-623935
2022-10-22,2008,2029,1996,2012,3515161,104,8,1134491,2380670,170,4,2395728,1119433,-1261237,1261237
2022-10-23,2020,2020,1976,1981,3624878,100,6,1096783,2528095,161,6,2535625,1089253,-1438842,1438842
2022-10-24,2008,2008,1895,1921,4750366,202,5,1702591,3047775,139,8,2603910,2146456,-901319,901319
2022-10-25,1892,1969,1880,1887,5487620,166,6,2002620,3485000,225,8,2699216,2788404,-696596,696596
2022-10-26,1887,1914,1813,1813,7635628,302,7,4474313,3161315,183,6,5496835,2138793,-1022522,1022522
2022-10-29,1878,1887,1731,1887,18115289,95,5,804727,17310562,321,11,11285815,6829474,-10481088,10481088
2022-10-30,1887,1916,1859,1904,12812540,95,5,2190667,10621873,217,12,4426745,8385795,-2236078,2236078
2022-10-31,1851,1996,1851,1921,6037683,122,7,1897008,4140675,223,4,5207264,830419,-3310256,3310256
2022-11-01,1926,2053,1926,2053,12984981,61,0,12984981,0,248,5,3081263,9903718,9903718,-9903718
2022-11-02,2128,2178,2068,2138,20909100,388,3,19382636,1526464,467,11,15592860,5316240,3789776,-3789776
2022-11-05,2128,2231,2094,2178,15143103,235,4,10137511,6150880,333,6,8286346,8002045,1851165,-1851165
2022-11-06,2178,2284,2178,2243,6637624,174,3,5376783,1260841,325,7,4437706,2199918,939077,-939077
2022-11-07,2171,2327,2171,2291,9421629,203,7,7308082,2113547,305,5,6222863,3198766,1085219,-1085219
2022-11-08,2294,2349,2200,2224,8506860,225,6,4144828,4362032,330,9,6204487,2302373,-2059659,2059659
2022-11-09,2183,2318,2183,2270,8444712,177,5,4776378,3668334,249,6,7382712,1062000,-2606334,2606334
2022-11-12,2248,2270,2164,2200,6798549,190,7,3306521,3492028,206,5,4478214,2320335,-1171693,1171693
2022-11-13,2236,2248,2183,2246,4502138,108,4,1941588,2560550,217,6,3382182,1119956,-1440594,1440594
2022-11-14,2222,2236,2152,2205,4102535,98,7,1037543,3064992,196,4,3490237,612298,-2452694,2452694
2022-11-15,2125,2226,2125,2195,4028169,90,3,1887131,2141038,178,3,3335481,692688,-1448350,1448350
2022-11-16,2174,2241,2174,2186,2878275,79,3,1186270,1692005,154,5,2352571,525704,-1166301,1166301
2022-11-19,2260,2260,2116,2147,3672816,106,4,1930316,1742500,162,0,3672816,0,-1742500,1742500
2022-11-20,2162,2241,2162,2236,10616848,185,7,7207930,3408918,223,6,4075744,6541104,3132186,-3132186
2022-11-21,2364,2364,2354,2364,50228245,867,21,8109954,2092632,707,27,5743006,4459580,2366948,-2366948
2022-11-23,2364,2364,2364,2364,69590610,223,11,54290610,15300000,177,7,2525269,67065341,51765341,-51765341
2022-11-26,2477,2493,2380,2400,58253256,775,13,46282102,11971154,660,19,37723791,20529465,8558311,-8558311
2022-11-27,2376,2477,2368,2438,15818865,257,6,9330879,6487986,473,5,11718108,4100757,-2387229,2387229
2022-11-28,2407,2457,2407,2426,11022865,163,10,4487453,6535412,342,6,8317348,2705517,-3829895,3829895
2022-11-29,2450,2570,2412,2525,31105942,450,8,28951185,2154757,546,14,21315157,9790785,7636028,-7636028
2022-11-30,2565,2671,2505,2657,115064560,1179,20,90981163,24083397,1346,29,58958060,56106500,32023103,-32023103
2022-12-03,2671,2741,2599,2604,19568776,456,8,13106064,6462712,715,12,14985208,4583568,-1879144,1879144
2022-12-04,2741,2741,2568,2594,18484941,488,5,16269717,2215224,417,9,14738247,3746694,1531470,-1531470
2022-12-05,2587,2597,2496,2525,20139733,459,8,10918753,9220980,463,13,10376083,9763650,542670,-542670
2022-12-06,2573,2573,2426,2501,18444173,412,12,13979119,4465054,376,4,12542247,5901926,1436872,-1436872
2022-12-07,2481,2652,2479,2642,44006416,516,14,25415437,18590979,937,19,21936483,22069933,3478954,-3478954
2022-12-10,2652,2652,2556,2575,8397493,201,8,3629029,4768464,332,2,7344837,1052656,-3715808,3715808
2022-12-11,2537,2669,2537,2638,7006067,187,8,4194347,2811720,384,7,5926237,1079830,-1731890,1731890
2022-12-12,2621,2799,2621,2799,64793030,631,19,48699154,16093876,997,29,20788164,44004866,27910990,-27910990
2022-12-13,2799,2957,2799,2912,23069535,495,9,18194993,4874542,699,12,17968538,5100997,226455,-226455
2022-12-14,2897,2950,2801,2854,24600602,474,14,9725770,14874832,685,9,20602345,3998257,-10876575,10876575
2022-12-17,2868,2921,2813,2864,21316410,343,11,12818826,8497584,506,11,16702510,4613900,-3883684,3883684
2022-12-18,2859,2957,2837,2880,13943226,450,12,8208030,5735196,543,8,9499658,4443568,-1291628,1291628
2022-12-19,2861,2885,2782,2782,23170818,431,13,9996476,13174342,439,10,16437634,6733184,-6441158,6441158
2022-12-20,2779,2921,2705,2907,62709753,468,25,20740107,41969646,584,16,34993577,27716176,-14253470,14253470
2022-12-21,2943,3008,2941,3008,101697569,1001,26,73388010,28309559,1114,23,38739116,62958453,34648894,-34648894
2022-12-24,3111,3193,3078,3121,41616041,711,17,23479065,18136976,807,18,28203013,13413028,-4723948,4723948
2022-12-25,3082,3121,2969,2977,64696211,1488,19,39151997,25544214,891,17,33566938,31129273,5585059,-5585059
2022-12-26,2957,3001,2895,2926,45833392,888,23,27020469,18812923,521,13,22863374,22970018,4157095,-4157095
2022-12-28,2955,3143,2955,3143,100964291,836,26,69884604,31079687,1370,32,45661652,55302639,24222952,-24222952
2022-12-31,2957,3116,2912,2912,51228926,1196,13,40869482,10359444,621,14,34312484,16916442,6556998,-6556998
2023-01-01,2888,2972,2731,2782,37704053,1007,20,22258742,15445311,718,15,24046507,13657546,-1787765,1787765
2023-01-02,2789,2859,2724,2753,25837575,829,13,17605623,8231952,448,14,16041481,9796094,1564142,-1564142
2023-01-03,2772,2787,2618,2662,49613479,1292,19,31927416,17686063,724,11,30952472,18661007,974944,-974944
2023-01-08,2765,2772,2621,2652,31717560,818,6,28942989,2774571,300,10,14984843,16732717,13958146,-13958146
2023-01-09,2664,2715,2597,2618,50263394,1346,20,36527144,13736250,672,14,31440623,18822771,5086521,-5086521
2023-01-10,2645,2674,2558,2570,50085619,1544,19,41155592,8930027,576,8,35337437,14748182,5818155,-5818155
2023-01-11,2568,2642,2556,2573,25264288,1060,5,23443301,1820987,559,6,24445520,818768,-1002219,1002219
2023-01-14,2563,2727,2534,2698,25519955,1002,7,23423858,2096097,666,12,17860610,7659345,5563248,-5563248
2023-01-16,2700,2753,2669,2698,27304493,924,7,23270697,4033796,736,12,23659146,3645347,-388449,388449
2023-01-17,2727,2729,2662,2664,32927566,796,12,28740835,4186731,817,4,27812717,5114849,928118,-928118
2023-01-18,2700,2700,2616,2647,23427729,810,10,20201725,3226004,638,2,22027729,1400000,-1826004,1826004
2023-01-21,2633,2645,2549,2563,20593939,648,7,17611418,2982521,540,2,20125152,468787,-2513734,2513734
2023-01-22,2575,2640,2544,2592,15952782,572,6,10311420,5641362,460,7,13873914,2078868,-3562494,3562494
2023-01-23,2621,2654,2573,2582,17869799,471,9,9946297,7923502,551,6,15625972,2243827,-5679675,5679675
2023-01-24,2642,2642,2537,2587,13184179,437,7,7387090,5797089,356,4,13073663,110516,-5686573,5686573
2023-01-25,2611,2611,2460,2553,15157919,403,5,8483868,6674051,485,5,12840809,2317110,-4356941,4356941
2023-01-28,2515,2549,2428,2479,6901819,304,6,4920301,1981518,387,5,6183353,718466,-1263052,1263052
2023-01-29,2501,2501,2320,2368,11800961,535,11,7324455,4476506,534,5,10276583,1524378,-2952128,2952128
2023-01-30,2378,2419,2284,2392,8257865,397,3,7703095,554770,400,1,6790771,1467094,912324,-912324
2023-01-31,2392,2424,2356,2385,5659238,279,3,3279439,2379799,306,2,5348042,311196,-2068603,2068603
2023-02-01,2356,2426,2318,2356,10540837,301,5,6982435,3558402,242,7,7387162,3153675,-404727,404727
2023-02-05,2320,2368,2243,2265,7144510,425,5,5975668,1168842,294,2,6323189,821321,-347521,347521
2023-02-06,2248,2308,2210,2260,5222489,326,7,4956064,266425,271,3,5172457,50032,-216393,216393
2023-02-07,2238,2361,2238,2303,6289511,310,6,5542695,746816,282,2,6067725,221786,-525030,525030
2023-02-08,2299,2354,2299,2308,6747831,281,4,4126229,2621602,270,6,3932399,2815432,193830,-193830
2023-02-12,2275,2318,2246,2296,5726580,250,7,3862101,1864479,260,2,3974783,1751797,-112682,112682
2023-02-13,2253,2332,2241,2272,8659512,280,9,4531071,4128441,244,4,4819380,3840132,-288309,288309
2023-03-01,2433,2433,2433,2433,10972719,69,3,10372719,600000,159,4,2253450,8719269,8119269,-8119269
2023-03-04,2602,2602,2594,2602,170322318,1977,18,137037477,33284841,1279,31,46882249,123440069,90155228,-90155228
2023-03-05,2602,2640,2513,2517,31578575,1130,9,24574268,7004307,1015,5,30633170,945405,-6058902,6058902
2023-03-06,2489,2563,2465,2522,15729776,538,9,9560659,6169117,556,2,15197276,532500,-5636617,5636617
2023-03-07,2493,2599,2493,2553,8134845,355,2,7260788,874057,319,4,6880388,1254457,380400,-380400
2023-03-11,2558,2558,2491,2498,20452708,449,3,13690826,6761882,438,6,17462129,2990579,-3771303,3771303
2023-03-12,2477,2698,2436,2683,76643709,670,14,37833652,38810057,1293,13,66564507,10079202,-28730855,28730855
2023-03-13,2698,2777,2604,2621,18392638,635,2,16738828,1653810,941,4,17053919,1338719,-315091,315091
2023-03-14,2666,2777,2594,2693,50912806,522,11,24019118,26893688,1365,9,32207305,18705501,-8188187,8188187
2023-03-15,2659,2722,2657,2669,17983843,877,3,16585479,1398364,527,7,14891183,3092660,1694296,-1694296
2023-03-18,2657,2873,2657,2758,64968239,835,15,33875416,31092823,987,16,49146827,15821412,-15271411,15271411
2023-03-25,2799,2873,2755,2758,25169384,657,6,18282043,6887341,513,4,17641576,7527808,640467,-640467
2023-03-26,2707,2808,2691,2695,22513496,722,8,15852967,6660529,643,4,19010105,3503391,-3157138,3157138
2023-03-27,2676,2779,2652,2770,18580834,671,9,11925330,6655504,578,6,13801475,4779359,-1876145,1876145
2023-03-28,2760,2816,2731,2772,25345469,683,4,21845979,3499490,513,10,16479930,8865539,5366049,-5366049
2023-03-29,2755,2945,2755,2885,40820691,919,11,32093604,8727087,720,13,16215543,24605148,15878061,-15878061
2023-04-03,2885,3046,2801,2991,17948653,611,5,16258177,1690476,665,10,13925124,4023529,2333053,-2333053
2023-04-04,3042,3042,2905,2945,23269895,678,5,18887797,4382098,760,9,20380366,2889529,-1492569,1492569
2023-04-05,2969,3102,2888,3080,29215053,675,9,20942026,8273027,803,11,19413326,9801727,1528700,-1528700
2023-04-08,3078,3248,3044,3121,32526258,858,9,25907223,6619035,955,16,23820537,8705721,2086686,-2086686
2023-04-09,3128,3244,3097,3114,27444834,718,6,13374767,14070067,898,6,24859811,2585023,-11485044,11485044
2023-04-10,3116,3198,2965,3005,37237649,753,9,16782906,20454743,1077,10,29929977,7307672,-13147071,13147071
2023-04-11,3005,3066,2979,3027,16002313,577,6,10205248,5797065,616,5,14745232,1257081,-4539984,4539984
2023-04-15,3073,3217,3073,3215,64485894,1723,15,48902004,15583890,856,7,30179515,34306379,18722489,-18722489
2023-04-16,3251,3294,3143,3162,37363395,1079,18,27881796,9481599,743,6,26474845,10888550,1406951,-1406951
2023-04-17,3126,3412,3126,3340,79907924,1167,12,47082330,32825594,1681,19,47224213,32683711,-141883,141883
2023-04-19,3462,3510,3342,3373,40668918,791,13,34278021,6390897,866,11,28596066,12072852,5681955,-5681955
2023-04-24,3366,3429,3345,3405,29164759,616,9,18456897,10707862,934,5,22179455,6985304,-3722558,3722558
2023-04-25,3414,3628,3414,3621,85347054,1313,18,68099762,17247292,1412,20,38489959,46857095,29609803,-29609803
2023-04-26,3628,3785,3525,3640,41513348,1309,14,34122139,7391209,1199,11,26180158,15333190,7941981,-7941981
2023-04-29,3756,3804,3686,3703,41330866,1026,9,38340769,2990097,1101,7,32188982,9141884,6151787,-6151787
2023-04-30,3739,3873,3667,3799,37622362,1936,11,30211874,7410488,1217,7,23843721,13778641,6368153,-6368153
2023-05-01,3847,3847,3667,3708,18871870,1141,9,15699045,3172825,1031,5,16992542,1879328,-1293497,1293497
2023-05-02,3703,3794,3667,3684,44995377,1336,13,33604198,11391179,1149,14,28827232,16168145,4776966,-4776966
2023-05-03,3703,3715,3498,3607,35153482,1077,13,17641999,17511483,1240,10,27857820,7295662,-10215821,10215821
2023-05-06,3667,3787,3667,3681,26703315,1172,5,23403315,3300000,945,12,19413446,7289869,3989869,-3989869
2023-05-07,3727,3727,3465,3465,25895499,697,12,10737499,15158000,379,1,25076315,819184,-14338816,14338816
2023-05-08,3241,3263,3241,3241,18362185,392,9,11904185,6458000,843,1,17362185,1000000,-5458000,5458000
2023-05-09,3015,3282,3015,3222,48905272,813,12,30410675,18494597,1263,7,29661214,19244058,749461,-749461
2023-05-10,3270,3270,2943,2957,41393886,852,13,20719578,20674308,760,3,39756699,1637187,-19037121,19037121
2023-05-13,2957,3042,2794,2883,31200190,776,8,20357190,10843000,707,6,14822367,16377823,5534823,-5534823
2023-05-14,2883,3032,2871,3032,36434455,548,7,29717262,6717193,588,11,13265473,23168982,16451789,-16451789
2023-05-15,3054,3097,2924,3025,10438858,490,7,8453246,1985612,443,1,10338858,100000,-1885612,1885612
2023-05-17,3063,3205,3008,3133,11439366,387,5,10600798,838568,421,5,9104259,2335107,1496539,-1496539
2023-05-20,3183,3183,2998,3042,16652350,410,5,9195461,7456889,447,0,16652350,0,-7456889,7456889
2023-05-21,3005,3145,2989,3126,10092010,250,6,4057796,6034214,430,2,8934010,1158000,-4876214,4876214
2023-05-22,3128,3186,3075,3097,12449742,397,9,7038116,5411626,385,5,10153058,2296684,-3114942,3114942
2023-05-23,3138,3169,3078,3097,9130103,375,5,6710335,2419768,394,4,7343656,1786447,-633321,633321
2023-05-24,3159,3159,3063,3078,10507339,311,7,8091851,2415488,381,3,10235083,272256,-2143232,2143232
2023-05-27,3070,3078,2953,2972,14974080,394,6,7454424,7519656,413,2,13772080,1202000,-6317656,6317656
2023-05-28,2962,2991,2842,2885,21723943,534,8,9673926,12050017,434,2,20711954,1011989,-11038028,11038028
2023-05-29,2890,2957,2878,2905,5160463,242,8,4073605,1086858,289,2,4450463,710000,-376858,376858
2023-05-30,2909,2948,2907,2907,14012708,279,7,5303949,8708759,266,5,5779930,8232778,-475981,475981
2023-05-31,2909,2955,2880,2900,9780714,221,7,3370761,6409953,234,3,7140725,2639989,-3769964,3769964
2023-06-03,2861,2938,2861,2914,4438757,218,2,3169857,1268900,293,2,4004023,434734,-834166,834166
2023-06-06,2933,2938,2902,2919,4698677,194,2,4098677,600000,303,1,4663760,34917,-565083,565083
2023-06-07,2912,2945,2905,2929,5240804,214,2,4141304,1099500,320,0,5240804,0,-1099500,1099500
2023-06-10,2905,2905,2710,2777,6407517,350,5,4621480,1786037,279,0,6407517,0,-1786037,1786037
2023-06-11,2743,2852,2743,2811,6794798,269,6,3464653,3330145,581,3,6323205,471593,-2858552,2858552
2023-06-12,2794,2907,2621,2662,8919332,484,5,7566984,1352348,294,2,8255120,664212,-688136,688136
2023-06-13,2695,2731,2671,2705,7357736,328,4,5528788,1828948,251,4,5872138,1485598,-343350,343350
2023-06-14,2736,2755,2705,2729,12162365,403,2,12048365,114000,217,4,7382365,4780000,4666000,-4666000
2023-06-17,2729,2777,2710,2746,10151708,314,2,9434908,716800,325,5,6779932,3371776,2654976,-2654976
2023-06-18,2710,2763,2671,2691,10086122,330,5,4375037,5711085,226,2,8433827,1652295,-4058790,4058790
2023-06-19,2669,2753,2669,2710,6548584,203,7,3772717,2775867,280,3,5748246,800338,-1975529,1975529
2023-06-20,2700,2751,2674,2724,6016318,181,5,3547092,2469226,220,4,3124620,2891698,422472,-422472
2023-06-21,2717,2775,2693,2722,8189904,274,3,6461394,1728510,245,3,7389647,800257,-928253,928253
2023-06-24,2763,2765,2717,2741,5483994,237,1,5361142,122852,284,5,3958457,1525537,1402685,-1402685
2023-06-25,2765,2806,2753,2772,6596243,136,1,2780522,260880,180,2,2401232,640170,379290,-379290
2023-06-26,2767,2813,2758,2799,4947201,241,3,3650256,1296945,278,5,2983022,1964179,667234,-667234
2023-06-27,2789,2808,2724,2727,5728172,256,5,3552318,2175854,212,5,3921558,1806614,-369240,369240
2023-06-28,2722,2741,2712,2717,5600378,251,5,3251650,2348728,159,4,2276280,3324098,975370,-975370
2023-07-01,2698,2763,2698,2763,6438792,162,5,1315560,5123232,226,1,4938792,1500000,-3623232,3623232
2023-07-02,2731,2856,2731,2837,10219491,180,9,3733734,6485757,314,5,5033258,5186233,-1299524,1299524
2023-07-03,2856,3003,2811,3003,63281835,689,11,23789225,39492610,585,15,11938323,51343512,11850902,-11850902
2023-07-04,3032,3070,2984,3015,24379761,717,8,13060381,11319380,442,11,15085086,9294675,-2024705,2024705
2023-07-05,3027,3049,3008,3042,15767605,355,13,7960662,7806943,372,9,7614511,8153094,346151,-346151
2023-07-08,3054,3075,3018,3027,7498256,290,8,3902774,3595482,369,3,7156271,341985,-3253497,3253497
2023-07-09,3046,3046,2945,3013,11378787,192,9,3763048,7615739,307,6,8157891,3220896,-4394843,4394843
2023-07-10,2948,3018,2948,2950,11342076,222,5,3298406,8043670,326,4,9702708,1639368,-6404302,6404302
2023-07-11,2933,2981,2854,2854,14678006,329,11,5041176,9636830,323,4,13057137,1620869,-8015961,8015961
2023-07-12,2885,2890,2741,2861,18148915,505,10,8133005,10015910,343,6,8205876,9943039,-72871,72871
2023-08-08,2875,2889,2797,2809,16606667,394,9,9791045,6815622,352,2,16478782,127885,-6687737,6687737
2023-08-09,2857,2866,2812,2857,11168817,253,8,6796194,4372623,295,5,7446504,3722313,-650310,650310
2023-08-12,2833,2833,2750,2762,6870704,227,4,1967341,4903363,266,2,6645502,225202,-4678161,4678161
2023-08-13,2744,2792,2744,2765,3915623,184,6,2823713,1091910,170,1,3747760,167863,-924047,924047
2023-08-14,2783,2800,2759,2768,6071768,186,8,2154396,3917372,187,4,5169002,902766,-3014606,3014606
2023-08-15,2762,2771,2729,2756,5638462,142,6,1272233,4366229,173,1,4440208,1198254,-3167975,3167975
2023-08-16,2797,2797,2750,2750,1961163,86,2,1748813,212350,125,1,1921662,39501,-172849,172849
2023-08-19,2744,2768,2723,2723,4382074,110,5,1421470,2960604,217,3,3995875,386199,-2574405,2574405
2023-08-20,2786,2786,2738,2762,11141175,127,5,4398063,6743112,170,4,8540693,2600482,-4142630,4142630
2023-08-21,2756,2818,2729,2747,4722639,109,3,3259247,1463392,164,2,4655018,67621,-1395771,1395771
2023-08-22,2729,2756,2708,2729,2587003,105,3,633956,1953047,138,1,2575856,11147,-1941900,1941900
2023-08-23,2729,2803,2729,2783,1778412,95,3,560308,1218104,119,1,1778412,0,-1218104,1218104
2023-08-26,2786,2880,2753,2851,4248809,166,4,3840954,407855,205,3,4156186,92623,-315232,315232
2023-08-27,2845,2955,2842,2889,5468414,189,5,4226688,1241726,213,5,5261594,206820,-1034906,1034906
2023-08-28,2883,2940,2875,2916,8190516,177,4,7052026,1138490,211,1,8125516,65000,-1073490,1073490
2023-08-29,2916,2958,2869,2886,3205370,137,4,2070551,1134819,195,0,3205370,0,-1134819,1134819
2023-08-30,2875,2955,2866,2913,4494617,121,4,1326413,3168204,207,1,4492587,2030,-3166174,3166174
2023-09-02,2895,2967,2892,2922,9324860,135,5,1793417,7531443,229,4,6009182,3315678,-4215765,4215765
2023-09-03,2910,2955,2886,2892,4459200,162,4,1863586,2595614,114,3,3425819,1033381,-1562233,1562233
2023-09-04,2886,2949,2886,2907,10625313,189,8,3635448,6989865,150,3,3838042,6787271,-202594,202594
2023-09-05,2937,2996,2907,2949,14083399,260,12,8521985,5561414,197,4,4318829,9764570,4203156,-4203156
2023-09-09,2910,2996,2910,2940,6325307,228,3,4698397,1626910,219,4,3944198,2381109,754199,-754199
2023-09-10,2928,2952,2898,2916,6189507,185,6,2663353,3526154,134,2,2411490,3778017,251863,-251863
2023-09-11,2919,2964,2910,2919,3970813,120,3,1693169,2277644,137,3,2247605,1723208,-554436,554436
2023-09-12,2937,2999,2925,2928,4484191,131,4,2698915,1785276,177,2,3696283,787908,-997368,997368
2023-09-13,2946,2967,2901,2937,4555300,171,5,2412499,2142801,133,4,2865684,1689616,-453185,453185
2023-09-17,2967,2984,2931,2964,7939864,147,8,3651611,4288253,161,1,2925649,5014215,725962,-725962
2023-09-18,2934,2975,2934,2937,4515323,188,3,3940923,574400,150,3,3450379,1064944,490544,-490544
2023-09-19,2934,2964,2934,2940,5375334,195,5,4069220,1306114,129,3,4169281,1206053,-100061,100061
2023-09-20,2943,2955,2934,2946,9570411,161,4,8737749,832662,119,3,6878570,2691841,1859179,-1859179
2023-09-23,2949,3017,2934,3017,7738647,184,5,6653176,1085471,236,4,5385098,2353549,1268078,-1268078
2023-09-25,2969,3094,2969,3082,12478455,257,3,12240885,237570,332,6,8744447,3734008,3496438,-3496438
2023-09-26,3109,3136,3044,3094,9588981,256,3,8730281,858700,281,5,6259097,3329884,2471184,-2471184
2023-09-27,3094,3130,3035,3058,13470327,330,6,9371096,4099231,226,8,3349218,10121109,6021878,-6021878
2023-09-30,3032,3109,2999,3005,4625091,139,4,1896285,2728806,213,1,4388938,236153,-2492653,2492653
2023-10-01,2958,3056,2958,3011,6771191,114,6,3722901,3048290,234,2,4102023,2669168,-379122,379122
2023-10-02,2972,3041,2972,3002,8183513,140,7,1302417,6881096,134,4,2619243,5564270,-1316826,1316826
2023-10-04,2969,3056,2969,2996,4767324,88,4,1325688,3441636,128,1,4767321,3,-3441633,3441633
2023-10-07,2984,3008,2904,2907,16059881,208,6,4256084,11803797,152,5,4288176,11771705,-32092,32092
2023-10-08,2964,2964,2762,2783,12448645,301,5,3803681,8644964,216,4,6586910,5861735,-2783229,2783229
2023-10-09,2685,2845,2685,2783,5671379,155,4,1814087,3857292,137,4,2038712,3632667,-224625,224625
2023-10-10,2818,2818,2744,2794,6830998,190,4,4341191,2489807,93,2,3297724,3533274,1043467,-1043467
2023-10-11,2780,2818,2753,2774,5797315,244,4,3888542,1908773,111,2,3446896,2350419,441646,-441646
2023-10-14,2789,2789,2688,2700,8115568,191,9,2247945,5867623,138,3,3156637,4958931,-908692,908692
2023-10-15,2714,2759,2694,2729,8407939,170,6,2711088,5696851,132,3,2824450,5583489,-113362,113362
2023-10-16,2691,2783,2691,2765,3707468,113,3,2589641,1117827,121,2,2166712,1540756,422929,-422929
2023-10-17,2768,2792,2750,2771,2522133,90,3,1997019,525114,104,3,1885884,636249,111135,-111135
2023-10-18,2738,2738,2697,2738,9625431,191,8,3674299,5951132,110,4,3240200,6385231,434099,-434099
2023-10-21,2708,2756,2708,2741,8050484,131,5,5539702,2510782,121,3,1597924,6452560,3941778,-3941778
2023-10-22,2756,2768,2726,2732,2321194,90,3,1619795,701399,106,3,1293135,1028059,326660,-326660
2023-10-23,2762,2762,2705,2732,3691016,134,5,2054268,1636748,82,0,3691016,0,-1636748,1636748
2023-10-24,2756,2756,2685,2720,3624757,132,4,2536563,1088194,119,1,3579537,45220,-1042974,1042974
2023-10-25,2720,2741,2708,2732,1236061,89,1,1077884,158177,85,0,1236061,0,-158177,158177
2023-10-28,2714,2714,2625,2637,7955695,231,5,6100556,1855139,220,2,6757666,1198029,-657110,657110
2023-10-29,2625,2711,2616,2705,4044369,122,2,3170459,873910,143,3,2043551,2000818,1126908,-1126908
2023-10-30,2705,2723,2676,2691,6013502,178,2,4677195,1336307,337,2,4413502,1600000,263693,-263693
2023-10-31,2694,2708,2682,2697,2784214,77,1,1558804,1225410,162,0,2784214,0,-1225410,1225410
2023-11-01,2676,2711,2646,2705,4965246,88,3,867598,4097648,158,1,4565246,400000,-3697648,3697648
2023-11-04,2679,2777,2679,2759,3415962,82,2,2215962,1200000,160,1,3337039,78923,-1121077,1121077
2023-11-05,2774,2842,2732,2821,4856948,121,0,4856948,0,196,3,3661074,1195874,1195874,-1195874
2023-11-06,2842,2842,2777,2783,2617274,115,2,1613274,1004000,124,4,2350999,266275,-737725,737725
2023-11-07,2774,2863,2774,2821,4410374,123,3,3183305,1227069,140,2,3373830,1036544,-190525,190525
2023-11-08,2800,2839,2777,2824,3195787,108,2,3054197,141590,109,4,1837717,1358070,1216480,-1216480
2023-11-11,2860,2958,2860,2907,12687332,303,6,10676100,2011232,232,6,5481077,7206255,5195023,-5195023
2023-11-12,2878,2952,2878,2931,2829499,110,3,2652092,177407,152,1,2403399,426100,248693,-248693
2023-11-13,2937,2978,2922,2972,4213197,138,2,3633197,580000,194,5,3463490,749707,169707,-169707
2023-11-14,2972,2978,2922,2934,2395854,119,5,1975648,420206,137,4,2324867,70987,-349219,349219
2023-11-15,2916,2946,2907,2928,3660067,107,2,3382887,277180,120,2,2655280,1004787,727607,-727607
2023-11-18,2961,3041,2961,3002,7140290,126,6,5005921,2134369,201,6,3663373,3476917,1342548,-1342548
2023-11-19,3038,3136,3011,3067,8977097,144,3,8231839,745258,257,6,4781561,4195536,3450278,-3450278
2023-11-20,3053,3070,3002,3011,4050265,117,4,3300088,750177,206,3,3304276,745989,-4188,4188
2023-11-21,3038,3076,2993,3029,5536389,109,5,1530631,4005758,199,4,4365243,1171146,-2834612,2834612
2023-11-22,3073,3073,3014,3014,4280074,73,5,2821343,1458731,123,3,2678218,1601856,143125,-143125
2023-11-25,2996,3032,2969,2972,2455967,78,8,1304320,1151647,149,1,2405967,50000,-1101647,1101647
2023-11-26,3017,3038,2993,3026,7700970,86,8,4587236,3113734,162,3,3741628,3959342,845608,-845608
2023-11-27,3050,3053,2996,3035,5580052,75,6,2181852,3398200,154,3,2405037,3175015,-223185,223185
2023-11-28,3008,3058,3008,3058,11385277,87,4,6182635,5202642,168,4,2531227,8854050,3651408,-3651408
2023-11-29,3029,3145,3029,3115,12996964,168,2,9235597,3761367,198,6,1713141,11283823,7522456,-7522456
2023-12-02,3142,3189,3115,3142,4756269,152,6,3691279,1064990,225,2,4101801,654468,-410522,410522
2023-12-03,3195,3340,3130,3320,12699722,248,6,9843636,2856086,369,5,10078450,2621272,-234814,234814
2023-12-04,3337,3391,3263,3308,12997086,205,5,7113209,5883877,320,9,9198778,3798308,-2085569,2085569
2023-12-05,3245,3420,3213,3352,10243008,137,10,6585881,3657127,279,6,6961459,3281549,-375578,375578
2023-12-06,3334,3397,3334,3379,5177727,81,8,744197,4433530,225,2,4253681,924046,-3509484,3509484
2023-12-09,3337,3394,3334,3352,7150745,85,8,2990644,4160101,206,3,5882956,1267789,-2892312,2892312
2023-12-10,3334,3382,3320,3334,5598665,95,6,2561991,3036674,167,0,5598665,0,-3036674,3036674
2023-12-11,3349,3367,3299,3317,8519850,108,5,2633141,5886709,227,3,6849931,1669919,-4216790,4216790
2023-12-12,3293,3367,3275,3305,2818984,76,4,1357644,1461340,171,3,2613353,205631,-1255709,1255709
2023-12-13,3278,3346,3278,3317,2755017,74,5,1120615,1634402,97,1,2355017,400000,-1234402,1234402
2023-12-16,3305,3331,3263,3320,5907139,110,9,3517718,2389421,170,3,3950212,1956927,-432494,432494
2023-12-18,3352,3376,3323,3337,10119884,178,5,7370127,2749757,180,5,6090968,4028916,1279159,-1279159
2023-12-19,3379,3379,3305,3308,7405937,105,7,1257666,6148271,131,3,6249686,1156251,-4992020,4992020
2023-12-20,3311,3331,3234,3236,8131327,178,9,2688842,5442485,125,3,6405389,1725938,-3716547,3716547
2023-12-23,3263,3269,3201,3228,3243599,185,9,2505328,738271,125,0,3243599,0,-738271,738271
2023-12-24,3204,3278,3195,3225,7519420,111,4,2387030,5132390,175,2,7518921,499,-5131891,5131891
2023-12-25,3207,3257,3207,3236,2931777,69,2,1364852,1566925,136,1,2711337,220440,-1346485,1346485
2023-12-26,3219,3245,3168,3213,4520861,80,2,1511063,3009798,153,2,4387100,133761,-2876037,2876037
2023-12-27,3180,3248,3177,3219,8297581,68,4,735762,7561819,208,2,3431723,4865858,-2695961,2695961
2023-12-30,3242,3290,3204,3231,3645671,102,4,3151205,494466,175,3,1746948,1898723,1404257,-1404257
2023-12-31,3195,3257,3195,3216,4651587,99,4,1500328,3151259,122,4,1801191,2850396,-300863,300863
2024-01-01,3192,3234,3192,3204,3395606,84,4,654016,2741590,140,2,2933573,462033,-2279557,2279557
2024-01-02,3189,3198,3162,3168,1597274,126,3,1048502,548772,115,1,1497274,100000,-448772,448772
2024-01-03,3165,3231,3162,3204,1998126,72,5,418010,1580116,146,2,1896763,101363,-1478753,1478753
2024-01-06,3242,3293,3150,3275,5952956,121,2,5484434,468522,218,4,3716101,2236855,1768333,-1768333
2024-01-07,3296,3296,3236,3242,2515463,79,3,1496841,1018622,117,3,1785880,729583,-289039,289039
2024-01-08,3287,3287,3228,3242,3409446,72,3,1678673,1730773,137,3,3005668,403778,-1326995,1326995
2024-01-09,3245,3254,3234,3248,1579149,58,2,873349,705800,129,2,1533525,45624,-660176,660176
2024-01-10,3260,3275,3251,3263,2890500,65,3,1684330,1206170,179,4,2167141,723359,-482811,482811
2024-01-13,3248,3278,3192,3251,4924079,89,2,2099014,2827065,191,5,3552693,1373386,-1453679,1453679
2024-01-14,3213,3302,3213,3284,11625974,99,5,2718036,8907938,215,8,4803607,6822367,-2085571,2085571
2024-01-15,3281,3284,3213,3263,4020421,59,4,1554614,2465807,132,2,3100329,920092,-1545715,1545715
2024-01-16,3242,3269,3239,3263,2750333,37,4,790494,1959839,147,3,2495976,254357,-1705482,1705482
2024-01-17,3207,3269,3207,3251,2192403,78,3,1002109,1190294,131,3,1344926,847477,-342817,342817
2024-01-20,3269,3272,3210,3219,5185904,87,3,1893904,3292000,158,2,4109891,1076013,-2215987,2215987
2024-01-21,3145,3245,3145,3234,2798003,117,3,1685658,1112345,157,2,2329778,468225,-644120,644120
2024-01-22,3207,3242,3109,3186,11592592,189,4,2894001,8645691,159,4,6915189,4624503,-4021188,4021188
2024-01-23,3147,3189,3088,3124,14987571,140,5,1429712,13557859,171,5,7909141,7078430,-6479429,6479429
2024-01-24,3139,3174,3109,3145,5340701,127,5,3478751,1861950,125,4,2939082,2401619,539669,-539669
2024-01-27,3150,3180,3100,3136,14492429,145,4,4458743,10033686,124,6,5918747,8573682,-1460004,1460004
2024-01-28,3145,3192,3115,3145,5145430,86,3,3528497,1616933,125,7,2621893,2523537,906604,-906604
2024-01-29,3118,3139,3109,3130,1265169,65,5,742681,522488,118,1,1249288,15881,-506607,506607
2024-01-30,3097,3136,3056,3067,5715901,183,4,1979984,3735917,153,2,4525491,1190410,-2545507,2545507
2024-01-31,3044,3109,3044,3088,3450286,106,4,1146391,2303895,109,2,2854489,595797,-1708098,1708098
2024-02-03,3103,3174,3100,3115,2609382,124,1,2501162,108220,132,4,2025493,583889,475669,-475669
2024-02-04,3165,3168,3100,3118,2442028,96,4,2108668,333360,92,4,1733284,708744,375384,-375384
2024-02-05,3115,3159,3041,3097,5524033,226,4,4500557,1023476,117,4,4594857,929176,-94300,94300
2024-02-06,3100,3103,3056,3056,2410154,116,5,1170388,1239766,96,5,1654133,756021,-483745,483745
2024-02-07,3050,3115,3050,3112,2818152,59,2,1059819,1758333,131,3,2178636,639516,-1118817,1118817
2024-02-10,3115,3115,3076,3076,2127865,92,2,1118372,1009493,94,3,1452228,675637,-333856,333856
2024-02-12,3073,3121,3061,3109,3617791,63,4,1374915,2242876,142,3,2208985,1408806,-834070,834070
2024-02-13,3112,3112,3044,3047,2506376,130,3,956557,1549819,87,4,945467,1560909,11090,-11090
2024-02-14,3041,3088,3026,3029,4054257,133,4,898390,3155867,110,4,2814908,1239349,-1916518,1916518
2024-02-17,3026,3056,2967,2993,6549579,184,4,1693980,4855599,108,2,6492990,56589,-4799010,4799010
2024-02-18,3029,3058,3008,3041,3278637,112,5,944286,2383436,95,7,2239415,1088307,-1295129,1295129
2024-02-19,3053,3056,3014,3041,4942791,87,5,2426451,2516340,109,3,3694083,1248708,-1267632,1267632
2024-02-20,3035,3067,3014,3017,5567534,100,5,949820,5004124,75,6,2576779,3377165,-1626959,1626959
2024-02-21,3061,3061,3011,3026,3660049,75,4,794784,3090725,90,3,2182542,1702967,-1387758,1387758
2024-02-24,3014,3047,3002,3011,1977398,108,3,1200548,776850,106,5,1267851,709547,-67303,67303
2024-02-26,2993,3026,2978,2984,2006811,75,4,484616,1522195,74,3,1536193,470618,-1051577,1051577
2024-02-27,3014,3044,2990,3035,2692057,70,4,791997,1900060,133,5,2087071,604986,-1295074,1295074
2024-02-28,3044,3056,3014,3017,10347305,184,4,5761715,4585590,102,5,844677,9502628,4917038,-4917038
2024-03-02,3050,3156,3011,3147,10530309,189,7,6864500,3665809,187,6,6099506,4430803,764994,-764994
2024-03-03,3171,3281,3103,3281,48576289,248,9,38334984,10241305,298,12,18470160,30106129,19864824,-19864824
2024-03-04,3296,3506,3290,3435,75837263,580,14,41393452,34443811,749,21,35146534,40690729,6246918,-6246918
2024-03-05,3397,3693,3397,3625,55731255,484,11,38162647,17568608,759,27,26545641,29185614,11617006,-11617006
2024-03-06,3649,3782,3625,3779,38333881,359,11,18676355,19657526,610,14,21570760,16763121,-2894405,2894405
2024-03-09,3750,3806,3690,3738,30656145,287,12,14384812,16271333,410,8,9138845,21517300,5245967,-5245967
2024-03-10,3738,3776,3646,3655,20361908,173,4,8378385,11983523,362,11,9854111,10507797,-1475726,1475726
2024-03-11,3723,3762,3634,3693,19932304,160,6,13129218,6803086,279,10,10166038,9766266,2963180,-2963180
2024-03-12,3693,3972,3625,3972,184499874,799,40,126044078,58455796,787,41,43043425,141456449,83000653,-83000653
2024-03-16,4043,4076,3922,4064,77434532,843,23,61094716,16339816,695,28,47477399,29957133,13617317,-13617317
2024-03-17,4058,4079,3963,3990,34097732,490,16,18674534,15423198,504,11,25214473,8883259,-6539939,6539939
2024-03-18,4005,4023,3972,3981,19222433,275,9,5694591,13527842,340,5,12746314,6476119,-7051723,7051723
2024-03-24,4020,4073,3934,3981,33080499,515,10,24861534,8218965,427,6,20519791,12560708,4341743,-4341743
2024-03-25,3978,3978,3925,3945,27882112,334,12,19815263,8066849,357,8,19159185,8722927,656078,-656078
2024-03-26,3945,4002,3916,3969,10973358,268,10,9747391,1225967,240,9,5049729,5923629,4697662,-4697662
2024-03-27,3969,3990,3910,3966,20449623,322,14,15272926,5176697,202,7,9546485,10903138,5726441,-5726441
2024-03-30,3984,3984,3919,3937,7560739,391,4,6492171,1068568,196,7,3775262,3785477,2716909,-2716909
2024-04-02,3922,3957,3800,3889,20029597,288,6,4766010,15263587,296,11,11286262,8743335,-6520252,6520252
2024-04-03,3925,3960,3842,3901,18583581,267,7,4416053,14167528,270,9,7312915,11270666,-2896862,2896862
2024-04-06,3865,3874,3782,3794,24059085,223,7,10771725,13287360,390,9,16989821,7069264,-6218096,6218096
2024-04-07,3803,3824,3741,3782,16255350,244,11,5838127,10417223,229,5,9459766,6795584,-3621639,3621639
2024-04-08,3824,3839,3773,3818,10399149,210,12,6275952,4123197,180,6,8152506,2246643,-1876554,1876554
2024-04-09,3836,3916,3797,3862,11092076,219,6,9931781,1160295,240,8,6383592,4708484,3548189,-3548189
2024-04-13,3874,3877,3708,3708,14104035,175,11,4085253,10018782,334,8,12377495,1726540,-8292242,8292242
2024-04-14,3744,3744,3744,3744,445401,36,2,114108,331293,6,0,445401,0,-331293,331293
2024-04-15,3744,3812,3744,3812,10620981,91,3,5070981,5550000,178,7,8935878,1685103,-3864897,3864897
2024-04-16,3767,3836,3767,3776,23677464,148,7,3114665,20562799,191,4,21154504,2522960,-18039839,18039839
2024-04-17,3744,3806,3744,3806,12211527,105,4,4047527,8164000,158,3,2211527,10000000,1836000,-1836000
2024-04-20,3800,3975,3800,3916,22367518,301,5,18063711,4303807,228,6,7505861,14861657,10557850,-10557850
2024-04-21,3925,3975,3889,3913,13611165,229,8,6219174,7391991,225,7,5104828,8506337,1114346,-1114346
2024-04-22,3856,3972,3827,3856,14378274,277,8,5901629,8476645,252,8,10092770,4285504,-4191141,4191141
2024-04-23,3868,3904,3812,3812,8241385,173,7,4878458,3362927,140,8,4434388,3806997,444070,-444070
2024-04-24,3871,3871,3773,3779,7064435,279,5,5856015,1208420,152,4,3161302,3903133,2694713,-2694713
2024-04-27,3821,3856,3788,3818,4541373,158,4,3084734,1456639,183,5,4263895,277478,-1179161,1179161
2024-04-28,3791,3812,3753,3765,4115031,136,5,3066797,1048234,146,3,3776578,338453,-709781,709781
2024-04-29,3812,3848,3732,3797,7905642,87,4,2132264,5773378,176,9,5934275,1971367,-3802011,3802011
2024-04-30,3827,3827,3765,3788,5835222,79,7,1754754,4080468,133,5,4789210,1046012,-3034456,3034456
2024-05-01,3794,3836,3767,3824,6171045,80,4,1182504,4988541,140,7,3962036,2209009,-2779532,2779532
2024-05-05,3800,3940,3788,3812,13459173,139,5,4716283,8742890,210,7,3468628,9990545,1247655,-1247655
2024-05-06,3892,3916,3785,3791,8672515,94,4,2144631,6527884,156,6,5050648,3621867,-2906017,2906017
2024-05-07,3842,3886,3779,3815,5517810,95,5,1419777,4098033,133,12,2573202,2944608,-1153425,1153425
2024-05-08,3821,3856,3791,3791,4365951,85,4,1505100,2860851,135,9,2159833,2206118,-654733,654733
2024-05-11,3862,3862,3779,3788,7581923,102,5,3068216,4513707,177,9,5641374,1940549,-2573158,2573158
2024-05-12,3845,3856,3762,3782,6176617,96,5,3070583,3106034,145,7,5167896,1008721,-2097313,2097313
2024-05-13,3821,3824,3673,3708,9553678,176,5,5301334,4252344,164,4,8973422,580256,-3672088,3672088
2024-05-14,3735,3791,3696,3711,4419729,110,4,1641972,2777757,135,6,2830759,1588970,-1188787,1188787
2024-05-15,3735,3821,3693,3765,5392699,102,4,1805640,3587059,156,5,4362029,1030670,-2556389,2556389
2024-05-18,3806,3806,3678,3678,3229348,128,5,2029928,1199420,103,4,2825053,404295,-795125,795125
2024-05-19,3788,3788,3548,3607,7859032,169,7,2298255,5560777,150,5,7010623,848409,-4712368,4712368
2024-05-21,3640,3705,3628,3684,2443331,60,6,1043669,1399662,94,6,1944289,499042,-900620,900620
2024-05-25,3652,3652,3578,3578,3032617,118,3,1946560,1086057,91,1,3031867,750,-1085307,1085307
2024-05-26,3619,3619,3560,3560,10724918,59,4,2944067,7647155,46,2,10591222,0,-7647155,7647155
2024-05-27,3498,3536,3498,3536,7415636,136,8,3656187,3759449,107,11,5524542,1891094,-1868355,1868355
2024-05-28,3515,3584,3515,3581,4212023,95,2,2781815,1430208,114,5,2122438,2089585,659377,-659377
2024-05-29,3610,3613,3589,3613,2205845,7,1,677465,1528380,80,5,1032249,1173596,-354784,354784
2024-06-01,3631,3631,3557,3581,6494107,136,2,6393249,100858,148,6,3248227,3245880,3145022,-3145022
2024-06-02,3652,3652,3566,3604,2128076,66,4,1745303,382773,83,5,1514324,613752,230979,-230979
2024-06-05,3649,3661,3604,3661,7763029,116,3,7215513,547516,190,4,3938209,3824820,3277304,-3277304
2024-06-08,3693,3699,3598,3622,3260956,96,2,2346029,914927,149,2,2879109,381847,-533080,533080
2024-06-09,3622,3696,3613,3673,3503360,82,5,2075533,1427827,129,4,2217155,1286205,-141622,141622
2024-06-10,3622,3714,3622,3708,3586249,77,2,2342296,1243953,117,1,2515567,1070682,-173271,173271
2024-06-11,3720,3741,3696,3723,5685798,89,2,4107269,1578529,119,6,2668562,3017236,1438707,-1438707
2024-06-12,3693,3762,3678,3759,4891967,77,5,1500570,3391397,117,6,1944309,2947658,-443739,443739
2024-06-15,3773,3773,3673,3678,6908879,85,5,2794954,4113925,127,6,5380416,1528463,-2585462,2585462
2024-06-16,3634,3750,3625,3673,3134743,64,4,1095484,2039259,94,1,2966743,168000,-1871259,1871259
2024-06-18,3759,3759,3756,3759,26036224,388,2,23736224,2300000,150,8,3111282,22924942,20624942,-20624942
2024-06-19,3833,3833,3812,3833,9134383,171,1,8934383,200000,136,5,2658116,6476267,6276267,-6276267
2024-06-22,3904,3904,3898,3904,37349709,566,4,29742029,7607680,199,19,6651982,30697727,23090047,-23090047
2024-06-23,3963,3981,3910,3975,22846256,419,4,13692687,9153569,345,14,13235670,9610586,457017,-457017
2024-06-24,4040,4040,3960,4005,16563566,327,4,8313566,8250000,237,6,11297147,5266419,-2983581,2983581
2024-06-26,4037,4037,3963,3993,15893748,346,6,11181763,4711985,242,4,8764567,7129181,2417196,-2417196
2024-06-29,4034,4043,3963,3966,9700263,297,3,9150719,549544,223,6,5576413,4123850,3574306,-3574306
2024-06-30,3996,4002,3830,3913,14285210,227,4,3164061,11121149,246,4,12037912,2247298,-8873851,8873851
2024-07-01,3969,3999,3913,3948,12209922,236,3,8908240,3301682,155,6,6993289,5216633,1914951,-1914951
2024-07-02,3987,3993,3928,3948,11925334,290,6,7796268,4129066,127,6,6691448,5233886,1104820,-1104820
2024-07-03,3975,4058,3937,4017,22119541,167,11,6743860,15375681,212,10,10380190,11739351,-3636330,3636330
2024-07-06,4230,4230,4224,4230,61144837,342,13,22241269,38903568,280,8,15147285,45997552,7093984,-7093984
2024-07-07,4417,4417,4180,4233,17070008,346,7,10263782,6806226,339,10,13752596,3317412,-3488814,3488814
2024-07-08,4233,4266,4174,4224,11518316,263,4,5111506,6406810,265,12,8820339,2697977,-3708833,3708833
2024-07-09,4224,4325,4198,4266,22589778,416,7,16231307,6358471,338,11,14567994,8021784,1663313,-1663313
2024-08-04,4510,4555,4465,4508,198413962,878,5,117513207,80900755,549,26,122130814,76283148,-4617607,4617607
2024-08-05,4548,4563,4476,4527,33755659,445,6,15080373,18675286,322,8,27834333,5921326,-12753960,12753960
2024-08-06,4543,4571,4521,4547,15126052,306,3,10336402,4789650,152,7,9151666,5974386,1184736,-1184736
2024-08-10,4578,4581,4578,4581,12980434,123,2,5507138,7473296,94,4,7995765,4984669,-2488627,2488627
2024-08-11,4610,4610,4610,4610,36815880,242,0,36815880,0,76,6,8432941,28382939,28382939,-28382939
2024-08-12,4656,4656,4656,4656,36153395,211,0,36153395,0,81,7,1370070,34783325,34783325,-34783325
2024-08-13,4702,4702,4656,4702,57340589,600,3,54879535,2461054,274,9,41088469,16252120,13791066,-13791066
2024-08-14,4748,4748,4748,4748,4413531,21,0,4413531,0,57,0,4413531,0,0,0
2024-08-17,4805,4805,4805,4805,70719187,328,4,68304519,2414668,52,1,1119187,69600000,67185332,-67185332
2024-08-18,4901,4901,4899,4901,29972327,388,0,29972327,0,149,4,25873202,4099125,4099125,-4099125
2024-08-19,4999,4999,4950,4999,77499623,855,5,70697943,6801680,304,13,45861360,31638263,24836583,-24836583
2024-08-20,5000,5097,4999,5097,24469808,332,2,24337253,132555,203,9,11014880,13454928,13322373,-13322373
2024-08-21,5184,5191,5160,5191,43481656,416,2,33481656,10000000,163,10,13207709,30273947,20273947,-20273947
2024-08-24,5290,5290,5290,5290,31477448,389,2,26885704,4591744,111,6,9988627,21488821,16897077,-16897077
2024-08-26,5390,5390,5390,5390,10956561,134,0,10956561,0,71,1,3556561,7400000,7400000,-7400000
2024-08-27,5440,5440,5440,5440,20127728,131,0,20127728,0,54,2,917728,19210000,19210000,-19210000
2024-08-28,5540,5540,5540,5540,42924324,337,2,41724324,1200000,79,3,2706361,40217963,39017963,-39017963
2024-09-01,5760,5760,5650,5760,95610188,1021,3,77371942,18238246,547,7,70425219,25184969,6946723,-6946723
2024-09-03,5820,5840,5640,5640,34639300,618,3,24443286,10196014,304,3,31942993,2696307,-7499707,7499707
2024-09-07,5540,5540,5540,5540,6389152,201,2,4194052,2195100,35,0,6389152,0,-2195100,2195100
2024-09-08,5500,5500,5500,5500,2195066,112,1,1804866,390200,15,0,2195066,0,-390200,390200
2024-09-09,5480,5480,5480,5480,3217703,180,2,1827503,1390200,21,1,3017703,200000,-1190200,1190200
2024-09-10,5450,5450,5450,5450,4517523,106,2,3127323,1390200,35,0,4517523,0,-1390200,1390200
2024-09-11,5410,5410,5410,5410,18481530,167,6,1668604,16812926,114,6,17281530,1200000,-15612926,15612926
2024-09-14,5260,5260,5260,5260,10140511,175,4,5390563,4749948,58,7,8740511,1400000,-3349948,3349948
2024-09-15,5180,5180,5180,5180,11304587,106,2,1129061,10175526,58,11,8820497,2484090,-7691436,7691436
2024-09-16,5100,5100,5100,5100,13834436,150,3,1636886,12197550,66,11,11164345,2670091,-9527459,9527459
2024-09-17,5000,5140,5000,5120,315949077,2253,12,248926278,67022799,1138,26,181340859,134608218,67585419,-67585419
2024-09-18,5130,5170,5060,5170,75296401,800,3,73665401,1631000,469,14,34938602,40357799,38726799,-38726799
2024-09-22,5270,5270,5020,5040,59787134,1033,7,46556589,13230545,595,5,57443195,2343939,-10886606,10886606
2024-09-23,5060,5230,5020,5150,44194607,545,4,36781035,7413572,471,10,40684647,3509960,-3903612,3903612
2024-09-24,5180,5190,5090,5140,46038095,721,5,36902841,9135254,431,3,43116202,2921893,-6213361,6213361
2024-09-25,5120,5150,5040,5040,47976775,634,4,39670425,8306350,390,5,44627335,3349440,-4956910,4956910
2024-09-28,5020,5020,5020,5020,2299806,135,2,1779480,520326,13,0,2299806,0,-520326,520326
2024-09-29,5010,5010,5010,5010,10571276,187,4,4873276,5698000,45,2,9113341,1457935,-4240065,4240065
2024-09-30,4980,5000,4980,4980,29596265,446,7,20198715,9397550,133,3,27436632,2159633,-7237917,7237917
2024-10-01,4940,4940,4940,4940,3213634,122,3,1723434,1490200,15,1,3013634,200000,-1290200,1290200
2024-10-02,4930,4930,4930,4930,1268502,100,1,1170952,97550,9,0,1268502,0,-97550,97550
2024-10-05,4921,4921,4921,4921,828268,91,2,630718,197550,6,0,828268,0,-197550,197550
2024-10-06,4919,4919,4919,4919,1838596,82,1,838596,1000000,11,0,1838596,0,-1000000,1000000
2024-10-07,4915,5013,4915,5010,109491778,635,8,74368317,35123461,697,5,105182824,4308954,-30814507,30814507
2024-10-08,4996,4996,4996,4996,8408180,132,1,8407270,910,117,2,4228404,4179776,4178866,-4178866
2024-10-09,5016,5016,5016,5016,12120561,66,0,12120561,0,86,2,10158400,1962161,1962161,-1962161
2024-10-12,5146,5146,5146,5146,16824228,75,1,16024228,800000,175,4,7744909,9079319,8279319,-8279319
2024-10-13,5275,5275,5150,5260,102178003,736,7,74670003,27508000,596,8,64804244,37373759,9865759,-9865759
2024-10-14,5265,5265,5109,5109,27087753,486,6,20686753,6401000,266,1,26087753,1000000,-5401000,5401000
2024-10-15,4966,5096,4966,4966,29083792,601,3,24852635,4231157,332,2,27027650,2056142,-2175015,2175015
2024-10-16,5124,5124,5050,5124,33748863,317,3,25048863,8700000,394,7,30617796,3131067,-5568933,5568933
2024-10-19,5170,5230,4970,5010,26099657,340,6,12305906,13793751,324,4,20631308,5468349,-8325402,8325402
2024-10-20,4930,4970,4890,4890,25345415,396,4,13894415,11451000,146,1,24879755,465660,-10985340,10985340
2024-10-21,4790,5030,4770,4820,20649500,423,3,14547763,6101737,297,1,20625671,23829,-6077908,6077908
2024-10-22,4850,5050,4800,4840,25322564,412,3,15585523,9737041,249,5,18147539,7175025,-2562016,2562016
2024-10-23,4960,4980,4780,4810,54182112,573,6,22664201,31517911,365,3,46408115,7773997,-23743914,23743914
2024-10-26,4974,4974,4974,4974,6558257,12,0,6558257,0,125,1,4607257,1951000,1951000,-1951000
2024-10-27,5023,5023,5023,5023,11904564,46,0,11904564,0,69,1,9953564,1951000,1951000,-1951000
2024-10-28,5111,5111,5111,5111,36045759,218,3,29634976,6410783,209,1,34094759,1951000,-4459783,4459783
2024-10-29,5170,5230,5000,5030,33702103,530,6,22319303,10582800,333,6,26627185,6274918,-4307882,4307882
2024-10-30,5076,5241,5037,5241,56433804,239,6,28002941,28430863,491,5,43227397,13206407,-15224456,15224456
2024-11-02,5360,5360,5240,5270,33470068,422,2,23386285,10083783,449,3,27870068,5600000,-4483783,4483783
2024-11-03,5300,5330,5180,5180,40470319,258,7,25076684,15393635,261,2,37209751,3260568,-12133067,12133067
2024-11-04,5160,5300,5090,5210,12328232,230,2,8310820,4017412,247,3,7552318,4775914,758502,-758502
2024-11-05,5340,5350,5200,5280,12887883,202,2,9227457,3660426,233,3,8991534,3896349,235923,-235923
2024-11-06,5240,5330,5140,5310,16189279,262,4,12423869,3765410,222,3,13343329,2845950,-919460,919460
2024-11-09,5270,5380,5270,5380,15711287,94,2,13083374,2627913,189,2,11760287,3951000,1323087,-1323087
2024-11-10,5500,5500,5500,5500,19967079,81,2,15167079,4800000,116,5,9183532,10783547,5983547,-5983547
2024-11-11,5660,5660,5490,5560,38912272,528,6,32288682,6623590,422,3,37872273,1039999,-5583591,5583591
2024-11-12,5610,5770,5490,5560,25245592,357,6,14750832,10494760,341,2,24970363,275229,-10219531,10219531
2024-11-13,5580,5670,5530,5580,24524910,326,5,21709316,2815594,223,5,22352360,2172550,-643044,643044
2024-11-16,5670,5770,5630,5770,44507493,533,4,39498117,5009376,331,8,23601224,20906269,15896893,-15896893
2024-11-17,5830,5890,5700,5780,32719497,353,4,27535774,5183723,411,3,30299497,2420000,-2763723,2763723
2024-11-18,5780,5950,5750,5940,33729774,420,6,29436337,4293437,353,10,17761576,15968198,11674761,-11674761
2024-11-19,6040,6050,5780,5790,32143306,486,4,23337361,8805945,283,7,24731923,7411383,-1394562,1394562
2024-11-20,5820,5950,5770,5840,20049859,257,5,11793197,8256662,249,5,17206513,2843346,-5413316,5413316
2024-11-23,5830,5900,5810,5880,21799278,403,2,18809183,2990095,232,6,18325460,3473818,483723,-483723
2024-11-24,5990,6020,5880,6020,44760137,358,7,30273465,14486672,359,12,31939900,12820237,-1666435,1666435
2024-11-25,6050,6180,6050,6180,27697281,350,1,27497281,200000,272,8,14041523,13655758,13455758,-13455758
2024-11-26,6360,6360,6000,6020,48950353,683,7,40415253,8535100,465,11,41995630,6954723,-1580377,1580377
2024-11-27,6140,6220,6040,6150,20097511,410,5,16949353,3148158,276,5,19443534,653977,-2494181,2494181
2024-11-30,6110,6190,5970,6000,33143002,425,6,22322852,10820150,392,7,30896110,2246892,-8573258,8573258
2024-12-01,6000,6200,5970,6100,21119553,183,4,9444963,11674590,244,7,18456553,2663000,-9011590,9011590
2024-12-02,6150,6230,6110,6230,56985807,307,9,27827169,29158638,308,8,42234807,14751000,-14407638,14407638
2024-12-03,6360,6410,6250,6380,61565476,357,5,25871731,35693745,510,9,48265673,13299803,-22393942,22393942
2024-12-04,6390,6580,6380,6580,44173839,238,4,14061611,30112228,410,15,25010458,19163381,-10948847,10948847
2024-12-07,6710,6760,6440,6600,43765407,405,4,16429277,27336130,482,6,36580968,7184439,-20151691,20151691
2024-12-08,6560,6690,6430,6490,27932645,445,4,20926975,7005670,284,6,20770697,7161948,156278,-156278
2024-12-09,6640,6720,6640,6690,55386470,464,3,37904297,17482173,304,13,31242384,24144086,6661913,-6661913
2024-12-10,6730,6840,6580,6690,39315487,489,4,31044127,8271360,344,9,20024374,19291113,11019753,-11019753
2024-12-11,6730,6850,6590,6850,41646987,327,6,20547426,21099561,409,8,18966254,22680733,1581172,-1581172
2024-12-14,6960,6970,6900,6970,18441984,115,3,13941946,4500038,228,6,6840732,11601252,7101214,-7101214
2024-12-15,7170,7170,6970,7080,77041675,827,8,57552427,19489248,417,9,31429189,45612486,26123238,-26123238
2024-12-16,6970,7200,6920,6920,55608996,860,4,48451431,7157565,490,6,40913714,14695282,7537717,-7537717
2024-12-17,7030,7070,6820,6820,25231693,475,6,16814727,8416966,240,4,17246582,7985111,-431855,431855
2024-12-18,6760,7060,6660,7060,48152349,328,1,43226270,4926079,693,6,42402278,5750071,823992,-823992
2024-12-21,7130,7130,7090,7130,11228591,182,0,11228591,0,207,7,3869014,7359577,7359577,-7359577
2024-12-22,7260,7270,6970,7150,21813906,534,4,19861949,1951957,352,8,15434275,6379631,4427674,-4427674
2024-12-23,7170,7290,7060,7240,22129097,474,3,18351593,3777504,307,5,10078642,12050455,8272951,-8272951
2024-12-24,7180,7290,7110,7150,17144956,510,4,16306204,838752,357,5,14451379,2693577,1854825,-1854825
2024-12-25,7120,7250,6970,6970,29934851,762,5,27858039,2076812,388,1,29929815,5036,-2071776,2071776
2024-12-28,6970,7000,6790,6790,27147311,688,5,22309991,4837320,349,5,23865132,3282179,-1555141,1555141
2024-12-29,6720,6850,6650,6650,32826140,700,6,21765258,11060882,305,2,26558871,6267269,-4793613,4793613
2024-12-30,6610,6640,6470,6550,17280404,543,5,13978437,3301967,439,1,17253524,26880,-3275087,3275087
2024-12-31,6490,6700,6490,6650,14331645,334,5,10868279,3463366,405,9,12740178,1591467,-1871899,1871899
2025-01-01,6730,6790,6620,6640,21147554,416,9,19622245,1525309,534,4,7131857,14015697,12490388,-12490388
2025-01-04,6820,6880,6690,6880,25407421,609,6,17254481,8152940,332,6,13685717,11721704,3568764,-3568764
2025-01-05,7070,7070,6880,7030,24813788,365,2,19595396,5218392,438,6,19758387,5055401,-162991,162991
2025-01-06,7070,7150,6880,7140,12920883,301,5,9233534,3687349,330,3,12835476,85407,-3601942,3601942
2025-01-07,7060,7290,7060,7250,27926975,394,5,13522319,14404656,442,10,16551960,11375015,-3029641,3029641
2025-01-08,7280,7390,7210,7260,23103181,630,5,20236472,2866709,397,6,19857888,3245293,378584,-378584
2025-01-11,7250,7330,7070,7070,28452205,699,4,16644205,11808000,347,3,25356951,3095254,-8712746,8712746
2025-01-12,7060,7070,6910,6910,20492518,637,3,10531616,9960902,327,3,16292518,4200000,-5760902,5760902
2025-01-13,6920,7100,6870,6950,10447432,471,6,9177819,1269613,297,3,8766961,1680471,410858,-410858
2025-01-15,7000,7070,6860,6870,10468950,467,2,7918050,2550900,232,3,10168950,300000,-2250900,2250900
2025-01-18,6920,6940,6720,6720,18640475,559,2,8216012,10424463,207,7,13178650,5461825,-4962638,4962638
2025-01-19,6640,6850,6640,6720,7805192,338,2,7289190,516002,218,2,6663198,1141994,625992,-625992
2025-01-20,6890,6900,6610,6620,17224066,356,2,9257489,7966577,244,2,17108582,115484,-7851093,7851093
2025-01-21,6750,6890,6560,6860,14993725,468,3,11528433,3465292,314,3,12713725,2280000,-1185292,1185292
2025-01-22,6950,6970,6810,6970,20386147,386,4,12735448,7650699,316,5,10251592,10134555,2483856,-2483856
2025-01-25,7060,7150,6990,7020,15555135,358,3,10535135,5020000,357,4,13610001,1945134,-3074866,3074866
2025-01-26,7020,7100,6870,6890,11993947,327,5,7365950,4627997,227,4,10052027,1941920,-2686077,2686077
2025-01-27,6860,7000,6770,6770,23708900,499,5,9709135,13999765,220,6,17247260,6461640,-7538125,7538125
2025-01-29,6820,6910,6710,6730,7555544,364,4,6722569,832975,169,1,7305544,250000,-582975,582975
2025-02-01,6810,6810,6610,6650,11868853,369,3,8025712,3843141,229,1,11648853,220000,-3623141,3623141
2025-02-02,6800,6800,6680,6710,8700010,263,4,6358796,2341214,181,5,6231798,2468212,126998,-126998
2025-02-03,6810,6810,6680,6730,6794666,218,2,4192839,2601827,197,3,5794666,1000000,-1601827,1601827
2025-02-04,6740,6910,6710,6910,19913161,200,1,16913161,3000000,319,6,9986015,9927146,6927146,-6927146
2025-02-05,6950,6950,6790,6900,6234350,246,2,4549783,1684567,250,2,6063600,170750,-1513817,1513817
2025-02-09,6820,6970,6690,6690,27573593,604,2,21419598,6153995,343,7,16007070,11566523,5412528,-5412528
2025-02-11,6660,6700,6580,6580,20601502,422,4,13250502,7351000,304,0,20601502,0,-7351000,7351000
2025-02-15,6590,6590,6400,6400,25490947,372,3,15852447,9638500,263,2,24989371,501576,-9136924,9136924
2025-02-16,6360,6360,6230,6300,18459741,441,2,15481871,2977870,323,1,16511615,1948126,-1029744,1029744
2025-02-17,6300,6450,6290,6330,9911551,313,1,9906045,5506,193,5,4976791,4934760,4929254,-4929254
2025-02-18,6310,6440,6290,6370,10934243,374,1,10757543,176700,165,3,4495086,6439157,6262457,-6262457
2025-02-19,6370,6450,6360,6370,4873236,225,1,4823046,50190,159,1,4326047,547189,496999,-496999
2025-02-22,6320,6430,6230,6260,11386967,318,2,6661568,4725399,219,4,6832759,4554208,-171191,171191
2025-02-23,6290,6480,6290,6460,5234781,231,0,5234781,0,238,1,5134781,100000,100000,-100000
2025-02-24,6500,6530,6450,6530,15739806,237,1,15539806,200000,194,5,12148141,3591665,3391665,-3391665
2025-02-25,6600,6690,6600,6630,18610272,409,2,18508281,101991,272,4,12037615,6572657,6470666,-6470666
2025-02-26,6690,6870,6550,6870,26705836,304,2,19646956,7058880,447,6,16028392,10677444,3618564,-3618564
2025-03-01,7030,7030,6830,6970,20210203,325,1,14010203,6200000,291,6,8965329,11244874,5044874,-5044874
2025-03-02,6980,7180,6940,7000,13141712,395,3,11467312,1674400,282,6,7537840,5603872,3929472,-3929472
2025-03-03,6890,6900,6820,6830,21286053,419,3,15935053,5351000,263,1,20986053,300000,-5051000,5051000
2025-03-04,6950,6950,6680,6700,9613806,293,0,9613806,0,164,3,7622774,1991032,1991032,-1991032
2025-03-05,6670,6900,6630,6760,29103012,310,4,9321742,19781270,162,4,5281294,23821718,4040448,-4040448
2025-03-08,6630,6660,6530,6540,12351422,336,1,10935672,1415750,203,0,12351422,0,-1415750,1415750
2025-03-09,6570,6640,6410,6540,16812342,225,2,3634456,13177886,309,5,12313776,4498566,-8679320,8679320
2025-03-10,6600,6700,6480,6510,6062362,253,3,5466133,596229,189,2,5095600,966762,370533,-370533
2025-03-11,6630,6630,6370,6400,8839609,279,1,7366709,1472900,166,1,7709609,1130000,-342900,342900
2025-03-12,6540,6670,6390,6530,9943912,247,3,7672028,2271884,152,2,8721218,1222694,-1049190,1049190
2025-03-15,6670,6670,6660,6670,18109742,293,4,17189742,920000,141,6,5113652,12996090,12076090,-12076090
2025-03-16,6850,6850,6640,6640,7481712,299,4,5823742,1657970,187,2,5889668,1592044,-65926,65926
2025-03-17,6690,6720,6520,6580,8550600,244,1,5683594,2867006,168,2,8226892,323708,-2543298,2543298
2025-03-18,6500,6600,6470,6590,13088004,245,3,7898992,5189012,226,1,11805660,1282344,-3906668,3906668
2025-03-25,6740,6760,6700,6760,9137464,156,3,6187464,2950000,114,2,4186464,4951000,2001000,-2001000
2025-03-26,6840,6850,6680,6780,9806694,289,2,8412831,1393863,148,6,6633688,3173006,1779143,-1779143
2025-03-29,6820,6930,6640,6710,14514074,323,3,9802889,4711185,192,3,13092662,1421412,-3289773,3289773
2025-03-30,6710,6930,6690,6930,20529848,304,1,10529848,10000000,276,6,13378930,7150918,-2849082,2849082
2025-04-05,7010,7090,6840,6840,13951203,381,1,10382445,3568758,207,4,7762977,6188226,2619468,-2619468
2025-04-06,6850,7010,6730,6730,20157667,454,4,12780163,7377504,192,4,12242807,7914860,537356,-537356
2025-04-07,6760,6880,6630,6700,12902228,274,3,5545910,7356318,162,5,6282607,6619621,-736697,736697
2025-04-08,6920,6920,6910,6920,17617278,130,2,13686843,3930435,102,2,11851578,5765700,1835265,-1835265
