Date,Open,High,Low,Close,Volume,person_buyer_count,company_buyer_count,person_buy_volume,company_buy_volume,person_seller_count,company_seller_count,person_sell_volume,company_sell_volume,person_owner_change,company_owner_change
2015-06-23,160,161,159,161,2339206,93,3,1639206,700000,48,3,1323404,1015802,315802,-315802
2015-06-24,160,160,158,159,1296222,56,2,696222,600000,50,1,1295222,1000,-599000,599000
2015-06-27,161,161,158,159,839303,46,1,619303,220000,50,4,578928,260375,40375,-40375
2015-06-28,158,158,155,155,1382032,56,3,554032,828000,27,3,506425,875607,47607,-47607
2015-06-29,157,158,155,156,514735,45,2,305432,209303,28,4,333881,180854,-28449,28449
2015-06-30,156,160,155,157,3598242,129,2,2088236,1510006,55,6,1134725,2463517,953511,-953511
2015-07-01,160,160,155,156,1212862,96,2,902862,310000,38,4,1004281,208581,-101419,101419
2015-07-04,161,162,157,158,3261289,112,1,2961289,300000,79,3,2357789,903500,603500,-603500
2015-07-05,161,161,156,157,4098847,108,3,2413499,1685348,40,5,2136239,1962608,277260,-277260
2015-07-06,159,159,155,156,1650080,97,3,1149180,500900,50,5,1134510,515570,14670,-14670
2015-07-07,156,160,156,160,3895058,181,2,3255058,640000,101,4,2837080,1057978,417978,-417978
2015-07-11,157,162,155,162,2282129,55,2,1297480,984649,114,1,2219107,63022,-921627,921627
2015-07-12,162,163,159,160,5739549,118,3,4211573,615000,59,5,1097078,3729495,3114495,-3114495
2015-07-13,164,167,163,166,6954644,200,2,5922644,1032000,114,6,4050557,2904087,1872087,-1872087
2015-07-14,170,170,162,169,3671977,156,1,3501977,170000,123,4,2385432,1286545,1116545,-1116545
2015-07-15,170,170,160,160,4951511,141,3,3751511,1200000,107,3,2941179,2010332,810332,-810332
2015-07-20,165,165,159,161,1056579,49,0,1056579,0,64,0,1056579,0,0,0
2015-07-21,160,164,160,162,1155953,51,1,905953,250000,85,1,1075953,80000,-170000,170000
2015-07-22,160,161,158,158,1020074,74,1,920074,100000,44,2,866466,153608,53608,-53608
2015-07-25,158,158,153,153,4534155,134,5,2481377,2052778,60,2,3910279,623876,-1428902,1428902
2015-07-26,151,155,150,154,2303838,120,2,1728914,574924,61,3,1728714,575124,200,-200
2015-07-27,153,153,151,151,852387,82,0,852387,0,40,2,611362,241025,241025,-241025
2015-07-28,154,154,151,153,1168361,49,2,557564,610797,38,3,758385,409976,-200821,200821
2015-07-29,153,154,151,151,1972968,138,2,1903068,69900,43,2,840678,1132290,1062390,-1062390
2015-08-01,152,155,150,151,1118023,72,1,682430,50000,20,0,732430,0,-50000,50000
2015-08-02,152,152,150,150,1174456,102,2,674456,500000,42,0,1174456,0,-500000,500000
2015-08-03,150,151,149,150,1140576,108,1,1040576,100000,45,0,1140576,0,-100000,100000
2015-08-04,151,155,150,150,902679,55,2,300790,601889,52,1,729341,173338,-428551,428551
2015-08-05,153,155,149,151,11361262,96,3,870242,10491020,44,3,1244250,10117012,-374008,374008
2015-08-08,151,153,149,149,1868216,71,3,548074,1320142,82,1,1798216,70000,-1250142,1250142
2015-08-09,151,154,149,154,2476696,59,2,426696,2050000,92,3,1545278,931418,-1118582,1118582
2015-08-10,150,153,150,150,13239459,35,1,304115,12935344,28,4,188648,13050811,115467,-115467
2015-08-12,151,151,148,148,1119790,78,2,1007872,111918,29,3,908352,211438,99520,-99520
2015-08-15,148,151,148,148,783145,54,2,481425,301720,58,1,763145,20000,-281720,281720
2015-08-16,148,153,147,153,2253135,35,5,310652,1942483,81,4,1541444,711691,-1230792,1230792
2015-08-17,147,151,147,148,513315,30,1,453315,60000,28,3,347973,165342,105342,-105342
2015-08-18,148,151,147,151,20902149,9,3,44730,190862,14,2,184475,51117,-139745,139745
2015-08-19,150,154,148,151,2686985,43,4,652791,2034194,74,3,2033435,653550,-1380644,1380644
2015-08-22,149,154,149,151,23729496,51,3,722405,23007091,72,3,1584496,22145000,-862091,862091
2015-08-23,150,151,149,150,415858,39,1,342217,73641,33,0,415858,0,-73641,73641
2015-08-24,150,150,148,149,648009,40,1,188658,459351,39,1,448009,200000,-259351,259351
2015-08-25,150,150,145,146,1321462,93,2,852885,468577,50,2,1155462,166000,-302577,302577
2015-08-26,149,149,145,146,1511905,64,3,1126365,385540,34,5,523402,988503,602963,-602963
2015-08-29,146,148,144,146,1235634,79,2,717933,517701,35,3,941346,294288,-223413,223413
2015-08-30,147,147,144,145,504827,58,0,504827,0,28,3,370204,134623,134623,-134623
2015-08-31,145,145,140,143,5231304,110,1,1831304,3400000,37,2,5062760,168544,-3231456,3231456
2015-09-01,142,144,136,143,1797805,54,4,470022,1327783,59,3,1141912,655893,-671890,671890
2015-09-02,144,145,141,145,2312961,38,1,1102961,1210000,75,2,1684029,628932,-581068,581068
2015-09-05,144,147,144,145,579134,61,1,559134,20000,34,2,320757,258377,238377,-238377
2015-09-06,145,146,143,146,1878623,37,1,738016,1140607,59,3,516360,1362263,221656,-221656
2015-09-07,145,145,142,143,1219642,65,1,919642,300000,41,4,427099,792543,492543,-492543
2015-09-08,143,145,142,143,1159139,34,1,650139,509000,35,5,381754,777385,268385,-268385
2015-09-09,143,143,143,143,394815,50,0,394815,0,28,0,394815,0,0,0
2015-09-12,145,145,140,140,632321,89,0,632321,0,26,5,385773,246548,246548,-246548
2015-09-13,139,139,136,136,2481602,149,2,1971602,510000,24,5,1458963,1022639,512639,-512639
2015-09-14,138,141,136,137,2514041,61,4,433514,2080527,59,6,1575357,938684,-1141843,1141843
2015-09-15,136,136,134,135,2765102,76,2,854314,1910788,31,2,2304798,460304,-1450484,1450484
2015-09-16,138,138,130,132,3733436,167,1,2274533,1458903,50,1,3545900,187536,-1271367,1271367
2015-09-19,131,138,129,138,3261506,78,5,1030408,2231098,81,2,2115177,1146329,-1084769,1084769
2015-09-20,131,131,127,127,2014708,95,1,895037,1119671,31,3,1287482,727226,-392445,392445
2015-09-21,130,132,127,132,6628035,35,5,308035,6320000,61,3,4332802,2295233,-4024767,4024767
2015-09-22,131,133,130,132,7747361,104,2,1147361,6600000,28,5,1987366,5759995,-840005,840005
2015-09-23,132,135,128,134,2024385,50,4,583385,1441000,68,6,1141051,883334,-557666,557666
2015-09-26,133,137,131,136,2015680,43,3,348459,1667221,92,3,1655272,360408,-1306813,1306813
2015-09-27,136,136,133,133,1497270,64,2,488695,1008575,37,2,588629,908641,-99934,99934
2015-09-28,136,138,134,138,1456274,28,2,252426,1203848,76,1,1214915,241359,-962489,962489
2015-09-29,137,139,135,138,1980674,32,3,1347014,633660,84,1,980674,1000000,366340,-366340
2015-09-30,139,139,136,139,1262514,33,2,469520,792994,71,2,862514,400000,-392994,392994
2015-10-03,136,139,136,138,948147,35,4,204261,743886,60,1,708147,240000,-503886,503886
2015-10-04,138,138,136,137,1930787,27,3,976787,954000,47,2,615290,1315497,361497,-361497
2015-10-05,138,138,137,137,1503828,50,2,1276396,227432,41,2,563533,940295,712863,-712863
2015-10-06,137,138,136,137,3560083,32,4,407360,3152723,34,3,678997,2881086,-271637,271637
2015-10-07,138,138,137,137,717616,31,2,600616,117000,36,1,651166,66450,-50550,50550
2015-10-10,137,138,137,137,458565,22,2,381083,77482,23,2,297242,161323,83841,-83841
2015-10-11,137,138,136,138,60608359,30,3,133069,60475290,37,2,397319,60211040,-264250,264250
2015-10-12,137,139,136,138,49336512,38,4,331259,49005253,42,3,683411,48653101,-352152,352152
2015-10-13,137,138,137,138,774337,38,1,755590,18747,21,2,297996,476341,457594,-457594
2015-10-14,138,142,138,141,1786958,73,2,1731958,55000,56,3,385129,1401829,1346829,-1346829
2015-10-17,142,145,140,144,4716616,185,5,3745714,970902,61,4,3116139,1600477,629575,-629575
2015-10-18,146,146,142,142,13384695,132,2,2789453,10595242,77,4,2059917,11324778,729536,-729536
2015-10-19,144,144,142,143,2140278,86,2,1678036,462242,34,2,382910,1757368,1295126,-1295126
2015-10-20,143,147,141,146,2725502,72,3,1479311,1246191,80,2,1793124,932378,-313813,313813
2015-10-21,146,149,144,145,5035136,114,2,3179636,1855500,114,2,1353285,3681851,1826351,-1826351
2015-10-25,145,146,143,146,3384765,80,3,934878,2449887,57,4,1157678,2227087,-222800,222800
2015-10-26,146,146,144,145,9233010,110,4,2127910,7105100,58,3,708605,8524405,1419305,-1419305
2015-10-27,145,151,145,148,18703340,206,6,4296418,14406922,170,10,5439440,13263900,-1143022,1143022
2015-11-04,155,155,149,150,2503985,102,0,2503985,0,19,1,495516,2008469,2008469,-2008469
2015-11-07,149,157,147,152,2924576,101,3,1340386,1584190,110,1,2312346,612230,-971960,971960
2015-11-08,152,154,149,150,1652780,94,2,790440,862340,58,3,1489572,163208,-699132,699132
2015-11-09,152,152,149,151,4441611,103,5,1090611,3351000,53,2,2790611,1651000,-1700000,1700000
2015-11-10,150,151,150,150,2495281,94,4,993357,1501924,52,1,874661,1620620,118696,-118696
2015-11-11,150,151,149,150,3590865,80,2,429360,3161505,51,3,1562476,2028389,-1133116,1133116
2015-11-14,150,150,148,149,2768564,92,2,763425,2005139,51,4,540350,2228214,223075,-223075
2015-11-15,147,151,147,149,2991913,82,3,791913,2200000,56,3,937856,2054057,-145943,145943
2015-11-16,150,150,147,148,3158776,74,4,1018526,2140250,29,2,374120,2784656,644406,-644406
2015-11-17,147,148,146,148,2482100,76,3,562650,1919450,33,2,745066,1737034,-182416,182416
2015-11-18,146,147,144,146,2787564,95,3,891764,1895800,28,2,394793,2392771,496971,-496971
2015-11-21,147,148,145,147,2894372,56,5,385979,2504793,29,2,487772,2403000,-101793,101793
2015-11-22,146,149,146,147,859023,49,1,524014,335009,51,2,681187,177836,-157173,157173
2015-11-23,147,148,145,148,14475849,91,4,1453091,13022444,49,3,2347373,12128162,-894282,894282
2015-11-24,146,148,144,144,16334943,173,3,2368121,13966822,57,6,6659586,9675357,-4291465,4291465
2015-11-25,144,144,140,141,6741623,237,3,5050377,1691246,39,4,6058223,683400,-1007846,1007846
2015-11-28,140,140,137,137,4170000,169,2,2532321,1633000,33,3,2950953,1214368,-418632,418632
2015-11-29,137,140,136,137,6768111,86,6,702013,6066098,59,2,771348,5996763,-69335,69335
2015-11-30,140,141,137,139,4084473,68,4,1002473,3082000,51,2,2218458,1866015,-1215985,1215985
2015-12-01,140,141,137,139,3367436,56,4,641515,2731860,26,6,961512,2411863,-319997,319997
2015-12-01,139,139,139,139,5939,56,4,641515,2731860,26,6,961512,2411863,-319997,319997
2015-12-05,140,143,139,143,4775342,46,3,575242,4200100,58,4,827025,3948317,-251783,251783
2015-12-06,141,142,138,138,992165,76,1,684974,307191,32,3,673438,318727,11536,-11536
2015-12-07,138,142,136,142,11008523,92,1,713375,10295148,46,6,1808523,9200000,-1095148,1095148
2015-12-08,140,144,138,144,5420302,46,1,411024,5009278,118,5,3605664,1814638,-3194640,3194640
2015-12-09,144,144,141,142,947913,41,2,202525,564784,28,1,531597,235712,-329072,329072
2015-12-13,141,146,140,144,11467755,39,1,365227,11102528,70,3,1202765,10264990,-837538,837538
2015-12-14,144,146,141,142,1043559,88,0,1043559,0,35,2,1042753,806,806,-806
2015-12-15,143,147,142,147,1933087,45,1,971572,961515,83,2,1127331,805756,-155759,155759
2015-12-16,145,147,144,144,1174077,37,3,370727,803350,36,2,461164,712913,-90437,90437
2015-12-19,144,144,141,142,309112,40,0,309112,0,29,0,309112,0,0,0
2015-12-20,141,143,138,140,1282235,60,1,1032235,250000,40,1,1093962,188273,-61727,61727
2015-12-21,141,146,139,143,11811119,40,1,451048,11360071,72,2,1464570,10346549,-1013522,1013522
2015-12-22,144,144,140,141,749762,51,1,739762,10000,35,2,374076,375686,365686,-365686
2015-12-23,141,144,141,142,573110,49,1,373110,200000,35,2,381365,191745,-8255,8255
2015-12-26,142,142,140,140,644734,64,0,644734,0,44,2,342816,301918,301918,-301918
2015-12-27,142,142,139,139,2026745,131,1,1776745,250000,39,1,1693115,333630,83630,-83630
2015-12-28,139,140,137,137,792183,119,0,792183,0,24,2,503284,288899,288899,-288899
2015-12-30,138,142,138,139,2007126,111,1,1257126,750000,49,5,854454,1152672,402672,-402672
2016-01-02,142,142,135,136,2213307,195,2,2188807,24500,43,3,2049551,163756,139256,-139256
2016-01-03,136,137,134,136,3054218,237,2,3019502,34716,41,1,2587521,466697,431981,-431981
2016-01-04,137,139,137,137,3220316,98,2,2283930,936386,50,1,1035275,2185041,1248655,-1248655
2016-01-05,137,141,137,141,2601541,76,3,1022210,1579331,93,2,912030,1689511,110180,-110180
2016-01-06,139,142,139,142,2434888,100,3,1584888,850000,103,2,1389706,1045182,195182,-195182
2016-01-09,141,144,140,144,3681015,109,5,1450015,2231000,128,2,1861465,1819550,-411450,411450
2016-01-10,142,144,141,143,2299551,47,1,363041,1936510,75,2,496587,1802964,-133546,133546
2016-01-11,144,144,141,144,1676795,62,2,475195,1201600,68,4,1096083,580712,-620888,620888
2016-01-12,144,144,141,144,3519370,60,1,827973,2691397,102,2,3370781,148589,-2542808,2542808
2016-01-13,143,148,141,148,3124964,68,3,724964,2400000,140,5,2653214,471750,-1928250,1928250
2016-01-16,151,151,150,151,3661559,82,1,3656559,5000,86,2,1773833,1887726,1882726,-1882726
2016-01-17,157,157,146,151,7217717,297,5,6838717,379000,196,5,4946705,2271012,1892012,-1892012
2016-01-18,154,158,149,157,7398099,83,4,2839352,4558747,185,4,4664611,2733488,-1825259,1825259
2016-01-19,156,162,156,160,7952344,170,7,5707153,2245191,194,4,3499831,4452513,2207322,-2207322
2016-01-20,163,168,161,168,5160133,111,4,3201880,1958253,203,6,4185133,975000,-983253,983253
2016-01-23,172,173,168,171,5191578,214,5,4187490,1004088,119,5,3546032,1645546,641458,-641458
2016-01-24,171,175,169,169,6578701,241,7,3710319,2868382,111,5,2686829,3891872,1023490,-1023490
2016-01-25,169,179,169,179,10866816,152,8,4508609,6358207,227,7,5411995,5454821,-903386,903386
2016-01-26,184,186,180,183,11171741,380,7,8451741,2720000,126,8,3071741,8100000,5380000,-5380000
2016-01-27,186,186,178,178,4579488,244,4,3601175,978313,157,5,3711588,867900,-110413,110413
2016-01-30,180,180,174,175,3610192,191,5,2795192,815000,113,3,3286897,323295,-491705,491705
2016-01-31,177,177,170,173,3651576,193,6,2472515,1179061,92,1,3601576,50000,-1129061,1129061
2016-02-01,173,181,173,181,9746925,174,7,3260042,6486883,166,7,2579597,7167328,680445,-680445
2016-02-02,185,187,179,180,6616024,233,4,4035276,2580748,111,7,2645396,3970628,1389880,-1389880
2016-02-03,180,180,177,178,3344915,157,3,2739675,605240,75,3,2969457,375458,-229782,229782
2016-02-06,180,180,175,177,3543396,189,2,3143396,400000,95,3,2223396,1320000,920000,-920000
2016-02-07,176,180,176,177,6133504,216,5,3763966,2369538,129,3,4856568,1276936,-1092602,1092602
2016-02-08,179,179,176,178,8998683,284,4,7279890,1718793,180,3,6124998,2873685,1154892,-1154892
2016-02-09,180,186,180,181,9034863,234,4,8040310,994553,233,6,5493216,3541647,2547094,-2547094
2016-02-10,182,189,180,183,5326879,260,2,5235779,91100,179,3,3841203,1485676,1394576,-1394576
2016-02-13,187,189,177,188,7833287,240,4,5637351,2195936,190,5,4725183,3108104,912168,-912168
2016-02-14,181,186,179,181,5964696,230,3,3238632,2726064,121,10,1632979,4331717,1605653,-1605653
2016-02-15,181,187,181,183,5154847,261,0,5154847,0,120,7,2607033,2547814,2547814,-2547814
2016-02-16,181,183,179,180,4334021,150,4,2594771,1739250,153,1,4284021,50000,-1689250,1689250
2016-02-17,179,185,178,183,3685132,147,2,2485132,1200000,156,5,3040132,645000,-555000,555000
2016-02-20,183,184,173,173,6089011,364,1,5991012,97999,126,3,5675011,414000,316001,-316001
2016-02-21,172,183,171,176,6032275,125,2,1512235,4520040,162,6,4204665,1827610,-2692430,2692430
2016-02-22,175,183,175,176,3532840,130,2,3197990,334850,131,6,2193181,1339659,1004809,-1004809
2016-02-23,181,186,177,183,56929090,116,3,2803090,54126000,236,6,4101905,52827185,-1298815,1298815
2016-02-24,184,186,178,184,104890764,186,2,1981079,102909685,133,11,2437963,102452801,-456884,456884
2016-02-27,184,187,184,186,102676038,150,5,2413334,100262704,118,5,2051038,100625000,362296,-362296
2016-02-28,186,186,183,185,2210500,123,1,2193500,17000,127,6,1654479,556021,539021,-539021
2016-02-29,184,188,181,182,91062795,134,2,4064483,86998312,141,6,1911325,89151470,2153158,-2153158
2016-03-01,186,188,180,186,5714907,156,2,2631579,3083328,198,5,4027994,1686913,-1396415,1396415
2016-03-02,184,187,181,183,92684486,144,3,1790918,90893568,128,3,2009199,90675287,-218281,218281
2016-03-05,184,189,184,187,4293436,203,4,3933135,360301,170,5,2716044,1577392,1217091,-1217091
2016-03-06,187,188,185,186,5067278,208,4,4041278,1026000,157,9,2918098,2149180,1123180,-1123180
2016-03-07,187,187,183,184,4250021,196,2,4249911,110,120,4,2640021,1610000,1609890,-1609890
2016-03-08,186,188,183,183,3675554,176,1,3625554,50000,125,5,1259086,2416468,2366468,-2366468
2016-03-09,184,186,182,186,136724988,362,2,9544755,127180233,101,9,3003524,133721464,6541231,-6541231
2016-03-12,186,195,186,193,32367021,798,8,26165117,6201904,386,11,9313090,23053931,16852027,-16852027
2016-03-16,195,200,195,200,5408168,22,2,214106,5194062,83,4,3607144,1801024,-3393038,3393038
2016-03-26,200,200,194,198,3991015,219,3,3587015,404000,122,2,3774373,216642,-187358,187358
2016-03-27,200,200,194,195,3064310,186,0,3064310,0,96,0,3064310,0,0,0
2016-03-28,194,194,189,190,3584359,274,0,3584359,0,92,2,2874359,710000,710000,-710000
2016-03-29,191,193,188,189,5382822,181,3,1734780,3648042,119,1,2122071,3260751,-387291,387291
2016-03-30,190,193,189,191,6251532,269,2,6191282,60250,111,3,2192926,4058606,3998356,-3998356
2016-04-02,191,195,190,191,2604490,147,4,1919490,685000,99,1,2604489,1,-684999,684999
2016-04-03,192,195,187,190,2280360,157,2,1928435,351925,90,0,2280360,0,-351925,351925
2016-04-04,189,194,187,189,7443295,195,5,2309735,5133560,106,3,3536565,3906730,-1226830,1226830
2016-04-05,192,192,186,187,3547853,239,1,3497853,50000,105,2,2298858,1248995,1198995,-1198995
2016-04-06,188,188,183,185,4060575,248,2,3324170,736405,111,1,4039855,20720,-715685,715685
2016-04-09,185,186,180,181,4503367,308,2,3839772,663595,131,1,4310464,192903,-470692,470692
2016-04-10,182,182,177,177,3150449,260,5,2506248,644201,132,1,3148444,2005,-642196,642196
2016-04-11,180,183,176,176,10627896,246,2,2621896,8006000,122,5,3529222,7098674,-907326,907326
2016-04-12,180,180,175,177,3783474,224,2,3233474,550000,81,2,1033783,2749691,2199691,-2199691
2016-04-13,176,181,173,175,14321619,209,3,1761013,12560606,114,3,4581775,9739844,-2820762,2820762
2016-04-16,176,176,170,171,3765358,242,2,2915358,850000,102,2,2965358,800000,-50000,50000
2016-04-17,170,175,167,174,2698184,132,3,1748184,950000,96,2,1808586,889598,-60402,60402
2016-04-18,177,178,173,176,4398171,217,2,4263171,135000,97,6,2515421,1882750,1747750,-1747750
2016-04-19,178,178,172,173,45469113,160,2,1872700,43596413,72,2,2420219,43048894,-547519,547519
2016-04-20,177,180,172,176,22358155,149,5,1621301,20736854,97,5,2769002,19589153,-1147701,1147701
2016-04-23,179,179,173,174,1468788,111,2,1457788,11000,50,2,1358788,110000,99000,-99000
2016-04-24,174,178,172,175,2278898,153,1,2277898,1000,86,2,1955321,323577,322577,-322577
2016-04-25,177,177,172,173,2717311,162,1,2709697,7614,78,0,2717311,0,-7614,7614
2016-04-26,174,174,172,173,1839138,114,0,1839138,0,49,2,1326138,513000,513000,-513000
2016-04-27,175,175,172,172,2128450,142,1,2078450,50000,86,2,1863450,265000,215000,-215000
2016-04-30,171,174,171,171,1563866,109,1,1556252,7614,76,0,1563866,0,-7614,7614
2016-05-01,172,172,169,169,4311866,241,5,3935366,376500,60,2,2708331,1603535,1227035,-1227035
2016-05-02,170,170,168,169,2848507,226,4,2548507,300000,76,2,2616356,232151,-67849,67849
2016-05-03,169,172,165,166,2526055,196,3,2365455,160600,66,3,1356284,1169771,1009171,-1009171
2016-05-04,170,173,168,170,8985041,117,4,1710041,7275000,90,5,2393138,6591903,-683097,683097
2016-05-07,170,172,166,166,1294910,150,3,1274910,20000,56,1,1287133,7777,-12223,12223
2016-05-08,167,170,165,167,1272860,93,1,1257440,15420,91,3,1210456,62404,46984,-46984
2016-05-09,166,169,165,169,2067115,99,2,885265,1181850,64,2,1231874,835241,-346609,346609
2016-05-10,168,168,161,163,1476350,143,2,1193620,282730,58,1,1222852,253498,-29232,29232
2016-05-11,162,163,160,161,2236601,169,1,2036601,200000,73,3,1688718,547883,347883,-347883
2016-05-14,164,169,161,163,7612130,139,2,1612130,6000000,82,1,2059731,5552399,-447601,447601
2016-05-15,165,170,161,163,14345605,214,3,2738429,11607176,129,4,4439747,9905858,-1701318,1701318
2016-05-17,165,169,165,169,2955318,57,1,985318,1970000,88,2,2215318,740000,-1230000,1230000
2016-05-18,168,169,166,169,2117384,61,1,817384,1300000,58,2,1004854,1112530,-187470,187470
2016-05-21,166,174,165,172,3968098,124,2,1041607,2926491,166,1,3668098,300000,-2626491,2626491
2016-05-23,170,171,167,168,1028421,73,1,728421,300000,52,2,574936,453485,153485,-153485
2016-05-24,171,171,167,170,1722169,74,3,611025,1111144,91,1,1222169,500000,-611144,611144
2016-05-25,168,174,167,168,8115004,115,1,1504684,6610320,76,3,3030537,5084467,-1525853,1525853
2016-05-28,170,173,168,170,2230379,97,2,1870150,360229,77,1,2182397,47982,-312247,312247
2016-05-29,170,172,167,167,920378,86,0,920378,0,44,0,920378,0,0,0
2016-05-30,168,168,166,166,785789,120,0,785789,0,43,0,785789,0,0,0
2016-05-31,166,175,166,170,9588412,49,1,396314,9192098,120,2,2988412,6600000,-2592098,2592098
2016-06-01,170,170,168,170,882303,72,0,882303,0,46,1,582303,300000,300000,-300000
2016-06-05,170,170,167,168,789374,82,0,789374,0,51,0,789374,0,0,0
2016-06-06,168,168,166,166,1224340,136,1,1181671,42669,36,2,1104340,120000,77331,-77331
2016-06-07,166,167,165,165,1357990,97,1,1259196,98794,43,1,1307990,50000,-48794,48794
2016-06-08,168,173,164,173,6104836,81,1,1104836,5000000,156,2,3109955,2994881,-2005119,2005119
2016-06-11,164,166,162,162,1546084,141,2,1542484,3600,45,1,1229638,316446,312846,-312846
2016-06-12,161,163,161,162,765652,80,2,631085,134567,46,2,602080,163572,29005,-29005
2016-06-13,162,168,162,162,849118,30,2,650888,198230,58,1,759118,90000,-108230,108230
2016-06-14,162,164,160,160,2165437,112,2,1800004,365433,54,3,1604525,560912,195479,-195479
2016-06-15,161,164,161,161,1350243,101,3,941793,408450,46,2,1086423,263820,-144630,144630
2016-06-18,161,165,161,161,48006351,86,4,882666,47123685,51,3,1495436,46510915,-612770,612770
2016-06-19,164,164,159,160,678246,84,2,378246,300000,32,0,678246,0,-300000,300000
2016-06-20,162,162,159,160,516236,59,1,414191,102045,53,1,496360,19876,-82169,82169
2016-06-21,161,165,158,162,3233076,79,2,781077,2451999,66,2,1300920,1932156,-519843,519843
2016-06-22,164,164,161,163,736723,66,1,636723,100000,57,0,736723,0,-100000,100000
2016-06-25,161,169,161,164,2738404,31,2,222766,2515638,140,0,2738404,0,-2515638,2515638
2016-06-26,165,166,162,164,954786,66,0,954786,0,43,0,954786,0,0,0
2016-06-28,164,166,163,164,874613,94,0,874613,0,45,2,791093,83520,83520,-83520
2016-06-29,164,164,162,162,530845,53,0,530845,0,49,0,530845,0,0,0
2016-07-02,163,163,161,161,1003168,104,2,827745,175423,36,1,763764,239404,63981,-63981
2016-07-03,161,167,161,162,3303342,57,1,703342,2600000,73,1,1573206,1730136,-869864,869864
2016-07-04,165,165,161,161,1636971,83,1,1610760,26211,39,1,730182,906789,880578,-880578
2016-07-05,163,164,161,161,741772,68,1,641772,100000,31,1,581649,160123,60123,-60123
2016-07-09,161,162,159,160,1011831,101,0,1011831,0,23,1,938831,73000,73000,-73000
2016-07-10,160,161,159,161,724325,88,1,709325,15000,37,1,535365,188960,173960,-173960
2016-07-11,162,166,158,163,8808579,83,4,865188,7943391,91,2,2550079,6258500,-1684891,1684891
2016-07-12,161,168,159,163,9294320,44,2,474533,8819787,110,3,2909890,6384430,-2435357,2435357
2016-07-13,164,174,162,170,6378326,39,2,1078326,5300000,202,3,5112663,1265663,-4034337,4034337
2016-07-16,170,170,163,165,2399585,73,0,2399585,0,55,1,2396585,3000,3000,-3000
2016-07-17,166,168,164,164,1411017,75,0,1411017,0,59,3,869524,541493,541493,-541493
2016-07-18,164,170,162,162,7866781,74,1,1168389,6698392,71,5,1729212,6137569,-560823,560823
2016-07-19,165,165,164,164,587132,63,0,587132,0,29,1,510883,76249,76249,-76249
2016-07-20,163,164,163,163,1447899,120,0,1447899,0,36,3,1080199,367700,367700,-367700
2016-07-23,163,163,162,163,1005224,105,0,1005224,0,34,1,943224,62000,62000,-62000
2016-07-24,162,163,161,162,2454222,124,0,2454222,0,51,1,1104017,1350205,1350205,-1350205
2016-07-25,162,165,162,165,4340646,59,1,2480646,1860000,41,2,721880,3618766,1758766,-1758766
2016-07-26,165,165,163,163,1999810,83,1,1924810,75000,35,4,562216,1437594,1362594,-1362594
2016-07-27,163,172,163,165,7419711,78,2,2389711,5030000,113,8,4132787,3286924,-1743076,1743076
2016-07-31,167,167,164,164,2643805,132,0,2643805,0,53,3,1303773,1340032,1340032,-1340032
2016-08-01,163,169,162,165,23700750,85,3,1721136,21979614,83,6,1734871,21965879,-13735,13735
2016-08-02,166,166,163,164,2375458,79,0,2375458,0,48,10,834421,1541037,1541037,-1541037
2016-08-03,166,166,164,165,2187753,89,1,2743519,5000,41,2,1697829,1050690,1045690,-1045690
2016-08-06,165,167,164,166,5042073,93,2,2582073,2460000,79,11,1362822,3679251,1219251,-1219251
2016-08-07,166,166,165,166,5529137,142,2,4005137,1524000,76,6,1157785,4371352,2847352,-2847352
2016-08-08,165,167,165,165,1830530,92,0,1830530,0,55,2,886659,943871,943871,-943871
2016-08-09,164,169,164,168,1834975,46,2,468422,1366553,143,1,1827362,7613,-1358940,1358940
2016-08-10,169,171,166,169,4312991,71,2,2869991,1443000,163,8,2822991,1490000,47000,-47000
2016-08-13,169,171,167,171,4573671,38,2,523671,4050000,119,8,3063670,1510001,-2539999,2539999
2016-08-14,168,168,166,166,853561,74,0,853561,0,71,4,553561,300000,300000,-300000
2016-08-15,166,168,165,166,871972,74,0,871972,0,33,0,871972,0,0,0
2016-08-16,165,169,165,166,15841125,45,2,560305,15280820,39,3,571139,15269986,-10834,10834
2016-08-17,166,172,165,168,13954936,61,2,1405316,12549620,115,2,3838856,10116080,-2433540,2433540
2016-08-20,167,168,167,167,510182,42,0,510182,0,38,0,510182,0,0,0
2016-08-21,167,179,167,171,7744631,80,2,1855331,5889300,244,3,7009851,734780,-5154520,5154520
2016-08-22,174,183,171,174,22974896,173,2,4374896,18600000,188,6,7858546,15116350,-3483650,3483650
2016-08-23,176,177,172,173,1070108,111,0,1070108,0,61,2,893993,176115,176115,-176115
2016-08-24,174,183,173,175,25435912,211,3,3406537,22029375,107,10,4539235,20896677,-1132698,1132698
2016-08-27,175,179,173,177,6614235,113,4,2576230,4038005,125,4,2610533,4003702,-34303,34303
2016-08-28,176,176,171,172,1141137,95,0,1141137,0,48,1,722416,418721,418721,-418721
2016-08-29,171,172,169,170,1014172,93,1,714172,300000,35,1,1014060,112,-299888,299888
2016-08-30,169,170,167,170,1432678,115,1,1412865,19813,41,0,1432678,0,-19813,19813
2016-08-31,170,170,164,167,2383340,160,2,2273340,110000,25,4,798218,1585122,1475122,-1475122
2016-09-03,167,167,164,164,3503460,107,2,3487248,16212,40,1,1436879,2066581,2050369,-2050369
2016-09-04,165,165,161,162,2995655,153,3,2905655,90000,35,1,1195803,1799852,1709852,-1709852
2016-09-05,162,163,161,162,2974547,128,3,2870753,103794,33,1,498841,2475706,2371912,-2371912
2016-09-06,161,163,161,161,1838045,149,1,1834278,3767,33,3,1078016,760029,756262,-756262
2016-09-07,162,162,160,161,13279489,175,3,2611169,10668320,38,5,937161,12342328,1674008,-1674008
2016-09-10,161,162,160,160,5906688,155,5,2727164,3179524,31,5,387587,5519101,2339577,-2339577
2016-09-11,161,161,159,160,2318346,135,3,1517395,800951,18,3,107981,2210365,1409414,-1409414
2016-09-13,158,160,158,158,1869037,160,1,1719037,150000,29,2,377157,1491880,1341880,-1341880
2016-09-14,158,161,157,157,2905131,194,2,2586181,318950,39,4,787039,2118092,1799142,-1799142
2016-09-17,159,159,155,155,3342118,220,2,3231203,110915,47,5,1876236,1465882,1354967,-1354967
2016-09-18,157,158,156,157,3997032,106,1,1277032,2720000,34,4,451358,3545674,825674,-825674
2016-09-19,156,158,156,158,1844525,75,1,1035982,808543,51,4,629005,1215520,406977,-406977
2016-09-21,160,160,153,158,1399540,114,0,1399540,0,44,2,534689,864851,864851,-864851
2016-09-24,158,164,157,164,3348690,76,2,2248690,1100000,131,4,2889109,459581,-640419,640419
2016-09-25,162,163,161,162,1045628,54,0,1045628,0,65,1,1045600,28,28,-28
2016-09-26,161,164,160,163,3382484,57,2,648524,2733960,87,1,1303802,2078682,-655278,655278
2016-09-27,162,163,160,162,784087,60,1,744087,40000,46,2,369772,414315,374315,-374315
2016-09-28,161,161,159,160,1160238,98,1,1110238,50000,66,1,1110238,50000,0,0
2016-10-01,160,161,156,156,4915813,246,3,4760813,155000,40,2,552341,4363472,4208472,-4208472
2016-10-02,157,160,156,158,802247,66,1,702247,100000,53,1,735785,66462,-33538,33538
2016-10-03,159,163,156,156,2693790,100,1,1675489,1018301,122,3,1670790,1023000,4699,-4699
2016-10-04,159,160,156,157,1196963,94,1,1096963,100000,39,1,796963,400000,300000,-300000
2016-10-05,157,157,156,157,636105,98,1,633355,2750,35,0,636105,0,-2750,2750
2016-10-08,155,158,155,156,1474992,85,0,1474992,0,46,1,896523,578469,578469,-578469
2016-10-09,156,158,155,155,1863896,146,1,1763896,100000,33,3,389231,1474665,1374665,-1374665
2016-10-10,156,157,155,155,3215261,169,1,2715261,500000,41,1,697744,2517517,2017517,-2017517
2016-10-15,155,157,154,154,4014162,240,0,4014162,0,42,1,1581718,2432444,2432444,-2432444
2016-10-16,154,155,150,151,6820396,333,6,5421388,1399008,59,2,945136,5875260,4476252,-4476252
2016-10-17,153,153,151,153,1013336,74,1,1009601,3735,49,2,859816,153520,149785,-149785
2016-10-18,153,155,153,154,2443435,77,1,2250423,193012,56,3,789791,1653644,1460632,-1460632
2016-10-19,153,156,153,156,2475968,83,1,975968,1500000,88,3,1359139,1116829,-383171,383171
2016-10-22,154,157,153,157,1502548,54,0,1502548,0,74,3,1085577,416971,416971,-416971
2016-10-23,158,160,156,157,5241655,177,3,4625356,616299,125,5,1567725,3673930,3057631,-3057631
2016-10-24,160,160,156,156,1868843,117,1,1768843,100000,48,3,934050,934793,834793,-834793
2016-10-25,158,158,155,156,1917385,112,3,1667385,250000,65,1,1582303,335082,85082,-85082
2016-10-26,157,158,155,156,2721305,129,2,2601149,120156,75,2,1904651,816654,696498,-696498
2016-10-29,158,165,158,165,20559397,178,6,15022623,5536774,245,7,6147520,14411877,8875103,-8875103
2016-10-30,166,168,163,163,4457415,156,9,3267164,1190251,166,3,2858109,1599306,409055,-409055
2016-10-31,163,165,161,161,3234559,111,7,2561584,672975,77,1,2302224,932335,259360,-259360
2016-11-01,161,161,159,160,1564914,98,1,1464914,100000,61,2,1352914,212000,112000,-112000
2016-11-02,160,161,159,159,586114,53,2,564614,21500,44,0,586114,0,-21500,21500
2016-11-05,162,164,160,160,5765010,158,2,5565010,200000,91,4,2586032,3178978,2978978,-2978978
2016-11-06,161,161,159,160,1751305,83,0,1751305,0,56,3,1567970,183335,183335,-183335
2016-11-07,161,161,159,161,2635317,108,2,2555463,79854,49,2,1888097,747220,667366,-667366
2016-11-08,161,161,159,160,2849179,124,1,2749179,100000,57,3,2201856,647323,547323,-547323
2016-11-09,152,161,152,160,4381510,218,1,3956510,425000,121,1,4181510,200000,-225000,225000
2016-11-12,160,162,156,157,7491044,306,3,7188344,302700,129,4,6050394,1440650,1137950,-1137950
2016-11-26,163,163,157,158,1472338,88,1,1413338,59000,33,0,1472338,0,-59000,59000
2016-11-27,161,161,157,160,3983966,214,4,3582815,401151,96,3,2361250,1622716,1221565,-1221565
2016-11-29,159,163,159,162,3760171,218,0,3760171,0,80,1,2379499,1380672,1380672,-1380672
2016-12-03,161,168,161,168,8538557,197,4,5058557,3480000,213,5,7752251,786306,-2693694,2693694
2016-12-04,171,172,168,170,20753402,232,3,3805567,16947835,113,4,4080690,16672712,-275123,275123
2016-12-05,170,173,166,167,2867392,180,2,2597392,270000,55,4,1576402,1290990,1020990,-1020990
2016-12-06,170,172,167,169,2503407,127,1,2473407,30000,105,0,2503407,0,-30000,30000
2016-12-07,170,170,167,169,1299478,120,0,1299478,0,66,1,1163916,135562,135562,-135562
2016-12-10,169,170,168,168,1337369,88,0,1337369,0,61,3,1089774,247595,247595,-247595
2016-12-11,169,169,166,167,900642,82,0,900642,0,48,1,870642,30000,30000,-30000
2016-12-12,168,171,166,168,955048,67,1,515048,440000,47,2,850511,104537,-335463,335463
2016-12-13,168,168,166,166,1008524,65,1,961101,47423,33,2,689579,318945,271522,-271522
2016-12-14,168,176,164,169,4359160,75,3,676978,3682182,131,2,3839806,519354,-3162828,3162828
2016-12-18,170,176,167,169,7689690,103,2,1639690,6050000,155,5,4114627,3575063,-2474937,2474937
2016-12-19,173,178,170,171,2652787,70,2,912787,1740000,83,1,1999642,653145,-1086855,1086855
2016-12-20,178,178,169,169,12039389,139,5,5964389,6075000,104,7,4946187,7093202,1018202,-1018202
2016-12-21,173,173,168,170,1453865,85,0,1453865,0,38,1,937008,516857,516857,-516857
2016-12-24,173,173,168,168,1453269,83,0,1453269,0,38,2,585988,867281,867281,-867281
2016-12-25,168,170,166,168,2262582,81,0,2262582,0,54,3,900582,1362000,1362000,-1362000
2016-12-26,169,171,165,165,15910812,118,1,1623524,14287288,42,4,1577130,14333682,46394,-46394
2016-12-27,165,169,165,169,1741271,53,3,797709,943562,55,0,1741271,0,-943562,943562
2016-12-28,168,169,168,168,822052,37,3,343791,478261,56,1,818236,3816,-474445,474445
2016-12-31,169,170,166,167,646858,51,1,606858,40000,42,0,646858,0,-40000,40000
2017-01-01,167,167,164,166,1362791,60,1,1142791,220000,36,0,1362791,0,-220000,220000
2017-01-02,164,167,164,165,581142,53,0,581142,0,36,1,559080,22062,22062,-22062
2017-01-03,165,166,163,164,1487376,86,1,1407376,80000,30,1,1187376,300000,220000,-220000
2017-01-04,163,165,162,162,1148622,105,2,1062075,125900,42,0,1187975,0,-125900,125900
2017-01-07,164,164,159,159,1859959,132,1,1559959,300000,55,0,1859959,0,-300000,300000
2017-01-08,161,161,158,159,1300824,111,0,1300824,0,61,1,1180824,120000,120000,-120000
2017-01-09,159,160,158,158,929844,87,1,829844,100000,36,0,929844,0,-100000,100000
2017-01-11,159,161,157,158,979840,84,0,979840,0,54,0,979840,0,0,0
2017-01-14,158,159,157,158,1557083,132,1,1457083,100000,48,2,1424604,132479,32479,-32479
2017-01-15,159,159,158,159,1783149,90,0,1783149,0,57,2,1683926,99223,99223,-99223
2017-01-16,159,164,159,162,3895259,55,2,546309,3348950,93,2,3027681,867578,-2481372,2481372
2017-01-17,164,169,161,163,8279897,61,1,899897,7380000,130,3,4854829,3425068,-3954932,3954932
2017-01-18,168,168,162,162,3387343,106,0,3387343,0,42,3,1236907,2150436,2150436,-2150436
2017-01-21,166,166,161,162,3127511,103,1,2717511,410000,38,3,1923982,1203529,793529,-793529
2017-01-22,162,166,159,161,3869080,44,1,639080,3230000,43,10,1027879,2841201,-388799,388799
2017-01-23,161,164,160,161,1611005,77,2,1565773,45232,26,2,1278005,333000,287768,-287768
2017-01-24,160,163,160,161,730494,39,0,730494,0,45,1,351388,379106,379106,-379106
2017-01-25,161,162,155,160,2162065,137,0,2162065,0,29,3,1262155,899910,899910,-899910
2017-01-28,158,163,156,156,1332779,82,1,1232779,100000,52,1,751419,581360,481360,-481360
2017-01-29,160,162,155,155,3281677,144,1,3181677,100000,32,3,1621760,1659917,1559917,-1559917
2017-01-30,157,159,157,157,1420315,82,1,1375315,45000,28,3,326562,1093753,1048753,-1048753
2017-01-31,158,162,156,159,12033307,93,2,8322275,3711032,79,7,3086200,8947107,5236075,-5236075
2017-02-01,157,158,156,157,1368288,78,1,1360288,8000,37,1,1268288,100000,92000,-92000
2017-02-04,155,157,155,156,906201,57,0,906201,0,36,2,798110,108091,108091,-108091
2017-02-05,156,157,154,154,2173606,94,2,2118606,55000,62,5,1723416,450190,395190,-395190
2017-02-06,154,159,154,156,2031623,67,2,679123,1352500,59,3,1453028,578595,-773905,773905
2017-02-07,155,159,155,159,5359759,32,1,799759,4560000,88,5,4888747,471012,-4088988,4088988
2017-02-08,158,162,156,158,3949298,41,2,479298,3470000,109,1,3849298,100000,-3370000,3370000
2017-02-11,159,159,155,158,2167271,78,0,2167271,0,20,3,1359656,807615,807615,-807615
2017-02-12,157,157,154,155,1286557,99,1,1279057,7500,26,2,786876,499681,492181,-492181
2017-02-13,158,159,155,156,583979,49,0,583979,0,22,1,244570,339409,339409,-339409
2017-02-14,155,160,153,157,6786302,144,2,2208074,4600000,77,3,4715260,2092814,-2507186,2507186
2017-02-15,154,159,154,155,3057674,104,2,1551874,1505800,42,3,2453875,603799,-902001,902001
2017-02-18,158,158,153,153,6799192,151,1,5049192,1750000,50,1,5145054,1654138,-95862,95862
2017-02-19,155,157,153,153,3345251,144,1,3045251,300000,34,1,2199789,1145462,845462,-845462
2017-02-20,153,159,153,155,6736820,113,2,1784984,4951836,81,5,1753475,4983345,31509,-31509
2017-02-21,155,159,154,155,4471891,90,2,1571391,2900500,52,4,799785,3672106,771606,-771606
2017-02-22,156,157,154,154,9163382,206,3,7426254,1737128,22,5,1093996,8069386,6332258,-6332258
2017-02-25,154,159,154,155,9016167,100,3,1802827,7213340,78,5,2165191,6850976,-362364,362364
2017-02-26,155,155,152,152,3475831,174,0,3475831,0,35,1,1554196,1921635,1921635,-1921635
2017-02-27,156,157,151,152,6670432,184,1,3600019,3070413,55,6,3051807,3618625,548212,-548212
2017-02-28,155,158,152,158,12960884,50,1,1185029,11775855,126,11,6609866,6351018,-5424837,5424837
2017-03-01,155,159,153,155,5272962,51,1,1399379,3873583,90,6,3250324,2022638,-1850945,1850945
2017-03-04,155,160,155,155,10675162,59,1,2315162,8360000,100,10,2591494,8083668,-276332,276332
2017-03-05,155,156,152,154,4464264,128,1,4462913,1351,35,3,650818,3813446,3812095,-3812095
2017-03-06,153,158,153,156,8137421,69,2,586070,7551351,84,6,3116223,5021198,-2530153,2530153
2017-03-07,156,162,153,158,13340486,86,2,2040486,11300000,168,10,7655940,5684546,-5615454,5615454
2017-03-08,157,157,155,155,2487140,84,0,2487140,0,35,3,826655,1660485,1660485,-1660485
2017-03-11,155,162,155,158,14573371,85,2,1146066,13427305,164,6,7381281,7192090,-6235215,6235215
2017-03-12,157,157,155,155,4958509,259,1,4956164,2345,94,2,2646590,2311919,2309574,-2309574
2017-03-13,156,156,151,154,11450346,424,4,11396137,54209,121,8,3425879,8024467,7970258,-7970258
2017-03-18,155,157,155,157,1304353,50,2,1071616,232737,45,0,1304353,0,-232737,232737
2017-03-25,156,156,153,155,2440335,129,1,2420835,19500,61,0,2440335,0,-19500,19500
2017-03-26,155,155,152,153,2314058,176,2,2229178,84880,48,1,1785309,528749,443869,-443869
2017-03-27,154,156,152,154,6380379,99,2,1521175,4859204,94,2,6352235,28144,-4831060,4831060
2017-03-28,153,155,153,153,2985998,102,2,2212758,773240,56,1,1785998,1200000,426760,-426760
2017-03-29,153,155,153,153,2567907,111,3,2252140,315767,52,3,1433460,1134447,818680,-818680
2017-04-03,153,154,152,153,1621787,93,2,1291787,330000,67,1,1421788,199999,-130001,130001
2017-04-04,153,153,150,151,4500941,202,0,4500941,0,63,2,1670941,2830000,2830000,-2830000
2017-04-05,151,153,149,150,2701226,166,4,2602439,98787,79,1,2592406,108820,10033,-10033
2017-04-08,150,151,149,149,2415497,213,0,2415497,0,70,0,2415497,0,0,0
2017-04-09,149,152,148,150,5878020,209,0,5878020,0,136,0,5878020,0,0,0
2017-04-10,149,154,149,152,4954830,144,4,3823469,1131361,140,2,3945034,1009796,-121565,121565
2017-04-12,152,155,151,154,5996893,105,3,2602218,3394675,146,3,4945380,1051513,-2343162,2343162
2017-04-15,154,155,149,149,9136075,226,2,8786571,349504,80,4,5001582,4134493,3784989,-3784989
2017-04-16,152,155,149,152,5734809,131,4,2120103,3614706,128,2,4602034,1132775,-2481931,2481931
2017-04-17,152,152,149,150,3416133,161,3,2936133,480000,62,2,1721735,1694398,1214398,-1214398
2017-04-18,149,155,148,153,10878467,108,2,10228467,650000,223,4,7497790,3380677,2730677,-2730677
2017-04-19,152,155,151,152,9446117,114,3,8896117,550000,107,1,5357008,4089109,3539109,-3539109
2017-04-22,155,155,151,151,4218326,157,2,4018326,200000,69,10,2226840,1991486,1791486,-1791486
2017-04-23,152,153,149,150,4533181,174,1,4483181,50000,61,4,4260413,272768,222768,-222768
2017-04-24,150,151,149,150,2386607,126,2,1926607,460000,46,2,1909830,476777,16777,-16777
2017-04-26,150,151,149,149,3265058,109,3,1965058,1300000,60,2,2885383,379675,-920325,920325
2017-04-29,149,151,149,151,3790650,118,2,2344525,1446125,65,2,3699679,90971,-1355154,1355154
2017-04-30,150,152,149,150,5014569,130,1,4414569,600000,70,3,3728164,1286405,686405,-686405
2017-05-01,150,150,149,150,2911460,90,3,2044185,867275,62,2,2683971,227489,-639786,639786
2017-05-02,151,151,149,149,4630522,88,3,2769522,1861000,75,3,2533102,2097420,236420,-236420
2017-05-03,149,151,149,151,3155280,64,3,824280,2331000,83,1,2865280,290000,-2041000,2041000
2017-05-06,150,155,149,150,8888443,92,2,1799233,7089210,148,8,7517878,1370565,-5718645,5718645
2017-05-07,151,155,149,153,11234516,92,3,1850099,9384417,188,4,10576024,658492,-8725925,8725925
2017-05-08,154,154,150,151,1869834,47,1,869834,1000000,63,1,1803407,66427,-933573,933573
2017-05-09,152,154,149,153,13026990,123,2,6031990,6995000,120,0,13026990,0,-6995000,6995000
2017-05-10,150,155,149,153,7439049,43,2,926189,6512860,169,0,7439049,0,-6512860,6512860
2017-05-13,153,156,150,153,7401699,64,2,1983299,5418400,116,1,7351699,50000,-5368400,5368400
2017-05-14,151,156,151,154,6371519,58,4,995509,5376010,142,2,6265270,106249,-5269761,5269761
2017-05-15,152,156,152,152,4003776,59,4,1322983,2680793,112,0,4003776,0,-2680793,2680793
2017-05-16,152,156,152,153,1842456,45,2,669695,1172761,81,1,1809285,33171,-1139590,1139590
2017-05-17,154,157,154,154,5978438,55,3,878428,5100010,165,3,5881427,97011,-5002999,5002999
2017-05-20,157,160,154,156,4815833,66,2,2315833,2500000,121,2,4606852,208981,-2291019,2291019
2017-05-21,156,160,154,156,2757788,62,1,1357778,1400010,114,4,2175226,582562,-817448,817448
2017-05-22,155,158,155,155,1320216,48,2,817975,502241,44,4,1061088,259128,-243113,243113
2017-05-23,155,156,154,154,1321374,59,3,701159,620215,40,5,945985,375389,-244826,244826
2017-05-24,154,156,152,153,1356944,79,3,1046944,310000,46,3,1147744,209200,-100800,100800
2017-05-27,153,156,152,152,2115511,73,2,1528730,586781,49,4,1830951,284560,-302221,302221
2017-05-28,152,154,151,151,1460365,89,1,1410365,50000,47,0,1460365,0,-50000,50000
2017-05-29,151,158,150,153,11403068,65,2,1401068,10002000,158,7,8029148,3373920,-6628080,6628080
2017-05-30,153,156,152,153,2342125,67,1,1342125,1000000,66,1,2196631,145494,-854506,854506
2017-05-31,155,155,152,152,728698,39,0,728698,0,23,0,728698,0,0,0
2017-06-03,154,154,152,152,1291881,55,0,1291881,0,45,0,1291881,0,0,0
2017-06-06,153,153,150,151,1614016,75,1,1594016,20000,49,1,1564016,50000,30000,-30000
2017-06-07,151,151,149,149,2426352,88,3,1746335,680017,59,1,1906352,520000,-160017,160017
2017-06-10,151,155,151,154,5585326,19,5,136415,5448911,145,4,5434327,150999,-5297912,5297912
2017-06-11,154,155,152,153,11403916,18,3,280247,11123669,91,4,2503916,8900000,-2223669,2223669
2017-06-12,153,153,150,150,1127943,51,2,1007943,120000,43,0,1127943,0,-120000,120000
2017-06-13,150,151,150,151,935137,35,3,807418,127719,33,0,935137,0,-127719,127719
2017-06-14,151,154,150,151,2688142,48,3,778521,1909621,70,3,2428880,259262,-1650359,1650359
2017-06-17,150,152,150,150,872789,27,0,872789,0,34,0,872789,0,0,0
2017-06-18,150,153,149,149,3278892,56,2,1053892,2225000,58,1,3123917,154975,-2070025,2070025
2017-06-19,149,150,148,150,942913,70,0,942913,0,39,0,942913,0,0,0
2017-06-20,150,152,148,148,1808326,62,1,808326,1000000,39,2,863881,944445,-55555,55555
2017-06-21,149,152,146,148,4090324,131,5,2739893,1350431,36,3,1663736,2426588,1076157,-1076157
2017-06-24,149,151,147,148,3064890,22,2,242838,2822052,79,1,2477061,587829,-2234223,2234223
2017-06-25,147,152,147,148,5349293,38,3,549273,4800020,99,1,4349294,999999,-3800021,3800021
2017-06-28,148,151,147,148,1912003,81,4,1306490,605513,48,1,1211992,700011,94498,-94498
2017-07-01,148,151,147,147,4119527,95,2,2093570,2025957,58,1,3759127,360400,-1665557,1665557
2017-07-02,147,147,146,146,2017110,98,2,1892110,125000,36,2,1898986,118124,-6876,6876
2017-07-03,146,150,146,147,3543276,45,2,543266,3000010,60,3,1959043,1584233,-1415777,1415777
2017-07-04,149,150,146,146,1250045,72,3,1125045,125000,32,3,1044373,205672,80672,-80672
2017-07-05,146,149,145,145,4532980,108,2,1482970,3050010,51,5,1604072,2928908,-121102,121102
2017-07-08,147,147,143,144,1949328,99,2,1099328,850000,49,0,1949328,0,-850000,850000
2017-07-09,146,147,144,145,1308783,40,2,761726,547057,44,1,981352,327431,-219626,219626
2017-07-10,144,147,144,146,4492922,77,3,2251649,2241273,72,2,3364826,1128096,-1113177,1113177
2017-07-11,145,146,144,146,2220284,57,1,1765284,455000,41,2,1822284,398000,-57000,57000
2017-07-12,145,147,144,144,2595876,94,2,1184366,1411510,63,1,2083020,512856,-898654,898654
2017-07-15,146,146,143,143,4558358,118,3,3802729,755629,35,1,4528358,30000,-725629,725629
2017-07-16,143,146,142,143,1992799,62,3,904941,1087858,48,1,1855800,136999,-950859,950859
2017-07-17,143,146,143,143,1879835,38,2,854825,1025010,57,2,1577550,302285,-722725,722725
2017-07-18,143,145,143,145,1782382,51,2,1542382,240000,63,0,1782382,0,-240000,240000
2017-07-19,145,152,144,152,7915162,46,4,3761855,4153307,163,2,5657980,2257182,-1896125,1896125
2017-07-22,153,154,151,152,6839002,122,4,4417863,2421139,121,2,4152696,2686306,265167,-265167
2017-07-23,150,152,148,149,1366222,80,1,1363193,3029,47,1,1292150,74072,71043,-71043
2017-07-24,149,149,147,148,1933570,86,2,1368722,564848,41,0,1933570,0,-564848,564848
2017-07-25,146,149,146,146,1478114,73,1,1278114,200000,53,0,1478114,0,-200000,200000
2017-07-26,146,148,146,147,1112465,31,2,602465,510000,38,0,1112465,0,-510000,510000
2017-07-29,146,149,146,147,2283684,49,2,583684,1700000,58,1,2172685,110999,-1589001,1589001
2017-07-30,149,149,146,147,945863,37,1,521290,424573,44,1,874322,71541,-353032,353032
2017-07-31,148,148,146,146,1222890,57,0,1222890,0,42,1,1014985,207905,207905,-207905
2017-08-01,146,146,145,145,670197,47,0,670197,0,35,1,615783,54414,54414,-54414
2017-08-02,147,147,144,144,2376625,109,3,1866847,509778,27,0,2376625,0,-509778,509778
2017-08-06,150,151,145,145,4758016,86,3,1676747,3081269,83,4,2999236,1758780,-1322489,1322489
2017-08-07,145,147,145,145,1262786,68,0,1262786,0,32,1,1232786,30000,30000,-30000
2017-08-08,147,147,144,145,769718,46,0,769718,0,34,1,768118,1600,1600,-1600
2017-08-09,145,146,144,145,3882132,62,0,3882132,0,56,4,1980634,1901498,1901498,-1901498
2017-08-12,146,147,145,145,2554182,68,0,2554182,0,48,5,1344832,1209350,1209350,-1209350
2017-08-13,145,148,144,146,8978889,108,1,7578889,1400000,52,7,2071676,6907213,5507213,-5507213
2017-08-14,147,147,145,147,3286032,85,2,2086032,1200000,42,4,1817493,1468539,268539,-268539
2017-08-15,147,147,145,145,2431842,59,1,2331842,100000,34,4,1266410,1165432,1065432,-1065432
2017-08-16,146,146,145,146,1532195,47,1,606223,925972,40,2,1232195,300000,-625972,625972
2017-08-19,145,145,144,144,3421433,77,1,2621433,800000,36,1,1200872,2220561,1420561,-1420561
2017-08-20,145,147,143,147,4306120,80,2,1456120,2850000,74,2,2521909,1784211,-1065789,1065789
2017-08-21,144,146,144,145,1104461,51,0,1104461,0,20,2,1037893,66568,66568,-66568
2017-08-22,146,146,143,145,3329715,121,2,3019715,310000,37,3,1528583,1801132,1491132,-1491132
2017-08-23,145,145,144,144,1319239,53,0,1319239,0,23,2,370459,948780,948780,-948780
2017-08-26,144,145,143,145,5033038,103,2,4363038,670000,42,4,2169468,2863570,2193570,-2193570
2017-08-27,145,145,144,145,2537209,51,3,1187199,1350010,43,5,1486688,1050521,-299489,299489
2017-08-28,145,145,143,143,3195165,98,2,2768461,426704,38,3,2773201,421964,-4740,4740
2017-08-30,146,146,142,142,4090356,120,3,2470356,1620000,51,4,2456122,1634234,14234,-14234
2017-09-02,143,146,143,143,1166551,55,4,576584,589967,37,3,774066,392485,-197482,197482
2017-09-03,144,144,142,143,2651735,78,1,1886652,765083,41,1,2496735,155000,-610083,610083
2017-09-04,144,145,143,144,1181768,40,1,595656,586112,41,0,1181768,0,-586112,586112
2017-09-05,145,145,143,143,1530678,51,1,1230678,300000,37,1,781816,748862,448862,-448862
2017-09-06,145,145,142,143,3731772,119,3,2981772,750000,34,2,3235782,495990,-254010,254010
2017-09-10,144,144,142,143,3023334,64,1,2687834,335500,41,0,3023334,0,-335500,335500
2017-09-11,142,143,142,143,2320073,40,0,2320073,0,51,2,2016792,303281,303281,-303281
2017-09-12,143,143,142,143,1352851,46,1,1243029,109822,61,3,667160,685691,575869,-575869
2017-09-13,142,144,142,144,2003935,48,0,2003935,0,96,0,2003935,0,0,0
2017-09-16,143,146,142,146,3531389,48,1,2931229,600160,105,3,2966742,564647,-35513,35513
2017-09-17,144,146,144,146,4229366,42,2,3635217,594149,89,4,2201411,2027955,1433806,-1433806
2017-09-18,146,147,145,147,3578824,47,6,2410949,1167875,64,3,1209478,2369346,1201471,-1201471
2017-09-19,147,152,146,152,10353618,87,2,9653618,700000,178,4,5208667,5144951,4444951,-4444951
2017-09-20,153,157,152,156,19118470,168,6,17154928,1963542,222,6,12113133,7005337,5041795,-5041795
2017-09-23,155,158,155,155,3354994,72,2,3325493,29501,122,4,2048131,1306863,1277362,-1277362
2017-09-24,152,153,150,151,2457899,125,1,2446899,11000,62,2,2102713,355186,344186,-344186
2017-09-25,150,151,149,150,3462113,93,5,2204449,1257664,61,3,1870567,1591546,333882,-333882
2017-09-26,151,151,148,150,3137661,64,3,1502224,1635437,53,2,1410676,1726985,91548,-91548
2017-09-27,150,152,149,151,2123552,24,2,868635,1254917,65,1,1923552,200000,-1054917,1054917
2017-10-02,150,155,147,150,4062399,56,3,1179046,2883353,79,2,3262399,800000,-2083353,2083353
2017-10-03,149,154,149,149,2327569,34,2,547319,1780250,62,3,1517569,810000,-970250,970250
2017-10-04,149,151,149,150,1086529,50,2,695822,390707,32,5,698140,388389,-2318,2318
2017-10-07,149,154,149,149,7081469,52,3,1219694,5861775,133,5,5007832,2073637,-3788138,3788138
2017-10-08,149,153,148,149,4026161,38,1,1305161,2721000,97,4,3136761,889400,-1831600,1831600
2017-10-09,150,151,147,148,779089,63,0,779089,0,43,0,779089,0,0,0
2017-10-10,147,150,147,147,1335850,44,1,1217480,118370,29,1,1241887,93963,-24407,24407
2017-10-11,149,149,146,146,2359199,76,1,2226233,132966,35,1,2259199,100000,-32966,32966
2017-10-14,148,150,148,148,3356296,48,2,809901,2546395,49,2,3218058,138238,-2408157,2408157
2017-10-15,148,149,146,148,1249188,54,0,1249188,0,31,1,793596,455592,455592,-455592
2017-10-16,147,151,147,148,1858994,51,1,854994,1004000,56,4,1431352,427642,-576358,576358
2017-10-17,147,152,147,149,4963111,24,2,1063111,3900000,124,5,3284237,1678874,-2221126,2221126
2017-10-18,150,153,147,151,3012948,43,1,912948,2100000,133,2,2729298,283650,-1816350,1816350
2017-10-21,150,154,150,154,5734376,47,8,1328423,4405953,130,8,3623768,2110608,-2295345,2295345
2017-10-22,153,155,152,153,4562050,62,5,2871068,1690982,102,5,3191307,1370743,-320239,320239
2017-10-23,152,157,152,154,6828668,52,16,1085512,5743156,97,6,3160359,3668309,-2074847,2074847
2017-10-24,154,156,154,155,4167940,57,6,2369141,1798799,69,6,2034100,2133840,335041,-335041
2017-10-25,155,157,155,157,4667304,49,5,2233892,2433412,120,6,2448490,2218814,-214598,214598
2017-10-28,156,158,156,157,8015500,73,2,7415500,600000,107,9,2626378,5389122,4789122,-4789122
2017-10-29,157,164,157,163,11721865,204,8,8650249,3071616,218,9,6466833,5255032,2183416,-2183416
2017-10-30,163,165,161,161,7286912,108,7,1937912,5349000,121,6,3881116,3405796,-1943204,1943204
2017-10-31,163,163,158,160,3092660,80,5,2334878,757782,82,3,2658327,434333,-323449,323449
2017-11-01,160,161,159,161,4561197,60,13,1207546,3353651,64,3,2448320,2112877,-1240774,1240774
2017-11-04,160,164,158,161,3944601,45,7,1037741,2906860,91,3,3218871,725730,-2181130,2181130
2017-11-05,161,161,159,160,1287421,55,3,896564,390857,55,3,885450,401971,11114,-11114
2017-11-06,160,164,158,162,2730330,24,4,622126,2108204,65,4,2218990,511340,-1596864,1596864
2017-11-07,160,162,160,162,2500677,20,2,603130,1897547,62,1,1700677,800000,-1097547,1097547
2017-11-08,161,162,161,161,1552447,28,3,693319,859128,32,3,948847,603600,-255528,255528
2017-11-11,161,161,160,160,2632496,32,1,2332496,300000,48,3,1099473,1533023,1233023,-1233023
2017-11-12,160,161,159,160,2335288,26,7,881601,1453687,42,3,909312,1425976,-27711,27711
2017-11-13,159,161,157,157,3222316,79,7,1821841,1433621,53,3,1584378,1671084,237463,-237463
2017-11-14,159,160,157,157,1983084,54,2,1774824,208260,38,1,1772304,210780,2520,-2520
2017-11-15,157,158,157,157,1135429,41,2,885429,250000,28,3,1040532,94897,-155103,155103
2017-11-18,157,158,155,155,3318422,82,4,2016044,1302378,28,1,2959529,358893,-943485,943485
2017-11-20,155,159,155,158,7016915,39,5,1367260,5649655,49,2,5494765,1522150,-4127505,4127505
2017-11-21,159,160,158,158,10180350,85,5,5324959,4947195,64,5,2190791,8081363,3134168,-3134168
2017-11-22,158,161,158,161,6794238,61,5,5112211,1682027,74,2,2105031,4689207,3007180,-3007180
2017-11-25,162,167,161,164,21807614,123,14,9712614,12095000,155,7,5231111,16576503,4481503,-4481503
2017-11-26,167,167,162,164,8583029,69,5,2286580,6296449,86,4,4969787,3613242,-2683207,2683207
2017-11-28,165,171,164,169,11862950,120,6,9589008,2273942,175,7,5249502,6613448,4339506,-4339506
2017-11-29,168,170,166,169,5427462,62,7,3254786,2172676,118,4,2853462,2574000,401324,-401324
2017-12-02,170,170,167,167,3348073,71,6,1448073,1900000,78,2,2585029,763044,-1136956,1136956
2017-12-03,168,168,163,165,5264966,99,5,2364966,2900000,45,4,2871905,2393061,-506939,506939
2017-12-04,163,165,163,164,2749371,49,5,1039793,1709578,42,3,2196004,553367,-1156211,1156211
2017-12-05,163,165,162,164,2301805,63,3,1933177,369900,42,1,1883296,419781,49881,-49881
2017-12-09,164,165,164,164,2784415,51,3,973715,1810700,37,4,1136348,1648067,-162633,162633
2017-12-10,164,164,162,163,2962446,65,4,1462446,1500000,44,1,2481745,480701,-1019299,1019299
2017-12-11,164,165,162,162,4737023,80,12,2854857,1882166,53,2,2543590,2193433,311267,-311267
2017-12-12,165,169,164,168,36474536,176,21,19121036,17353500,115,5,6116960,30357576,13004076,-13004076
2017-12-13,168,175,168,175,36975189,112,9,23187653,13787536,192,8,11643743,25331446,11543910,-11543910
2017-12-16,181,183,179,183,74948759,377,17,46933642,28015117,217,12,25185383,49763376,21748259,-21748259
2017-12-17,188,190,184,185,28333624,305,11,19139866,9193758,371,10,24414189,3919435,-5274323,5274323
2017-12-18,188,189,181,187,12454464,127,8,5387323,7067141,208,6,11028464,1426000,-5641141,5641141
2017-12-19,187,189,185,186,6091313,76,7,3607313,2484000,116,4,4543184,1548129,-935871,935871
2017-12-20,185,189,182,186,13129352,72,7,2846139,3718537,180,5,5773275,791401,-2927136,2927136
2017-12-23,184,189,184,186,6224926,93,10,3789907,2435019,92,6,3639638,2585288,150269,-150269
2017-12-24,185,189,185,186,9780248,81,6,6426952,3353296,138,3,7580248,2200000,-1153296,1153296
2017-12-25,188,196,185,196,26810626,83,3,6802725,1473491,46,1,8196216,80000,-1393491,1393491
2017-12-26,197,198,192,193,10038699,156,4,8749699,1850000,131,18,4758941,5840758,3990758,-3990758
2017-12-27,193,193,191,191,4006010,84,3,3091558,914452,98,2,3406010,600000,-314452,314452
2017-12-30,190,196,183,186,15452716,119,7,2910976,12561740,161,8,14776061,696655,-11865085,11865085
2017-12-31,190,192,181,185,17505393,129,11,7196474,10308919,256,3,16914220,591173,-9717746,9717746
2018-01-01,187,188,186,186,14135658,88,10,2689017,11446641,79,1,13935658,200000,-11246641,11246641
2018-01-02,189,190,187,190,5781956,36,3,1668291,4113665,102,3,4750956,1031000,-3082665,3082665
2018-01-03,190,190,186,187,5543458,48,3,1165076,1606653,70,2,2612013,159716,-1446937,1446937
2018-01-06,187,189,185,186,1677612,61,2,1406446,271166,40,2,1277612,400000,128834,-128834
2018-01-07,187,189,185,186,2696903,45,5,917809,1779094,48,5,2040628,656275,-1122819,1122819
2018-01-08,187,187,184,186,2221352,50,2,1618352,603000,65,4,1568120,653232,50232,-50232
2018-01-09,187,187,182,183,2163626,73,1,1663626,500000,40,5,1761842,401784,-98216,98216
2018-01-10,182,183,182,183,3901475,74,2,3834388,67087,40,5,2596424,1305051,1237964,-1237964
2018-01-13,184,187,179,182,3468558,136,2,2452919,1015639,51,2,3068558,400000,-615639,615639
2018-01-14,179,183,177,181,7139553,138,3,6909553,230000,84,4,5319831,1819722,1589722,-1589722
2018-01-15,179,185,179,184,10327141,121,5,6309799,4017342,100,8,5504824,4822317,804975,-804975
2018-01-16,184,187,183,186,9415402,103,7,5534714,3880688,91,7,3878963,5536439,1655751,-1655751
2018-01-17,186,189,183,183,9635898,145,1,8635898,1000000,85,9,3586905,6048993,5048993,-5048993
2018-01-20,188,188,183,186,9088079,116,8,3674744,5413335,67,6,3056190,6031889,618554,-618554
2018-01-21,187,189,184,187,9144918,84,7,5272094,3872824,118,7,5544973,3599945,-272879,272879
2018-01-22,189,196,187,193,44986756,247,19,28639828,16346928,216,19,6902132,38084624,21737696,-21737696
2018-01-23,193,198,193,198,20523286,246,10,11326286,9197000,180,17,5510311,15012975,5815975,-5815975
2018-01-24,197,204,197,200,20229795,341,10,15285238,4944557,170,17,9838499,10391296,5446739,-5446739
2018-01-27,199,204,199,200,7841497,154,6,3587402,4254095,141,18,4922416,2919081,-1335014,1335014
2018-01-28,201,203,199,200,6421274,132,3,3479380,2941894,109,12,4544338,1876936,-1064958,1064958
2018-01-29,201,201,195,197,6047715,127,2,2424711,3623004,71,4,3250035,2797680,-825324,825324
2018-01-30,197,199,193,194,3274439,108,2,2574443,699996,81,1,2600461,673978,-26018,26018
2018-01-31,193,198,190,196,7436607,115,4,2418875,5017732,125,5,6469187,967420,-4050312,4050312
2018-02-03,196,197,191,196,8440460,60,2,1157233,7283227,100,10,5341439,3099021,-4184206,4184206
2018-02-04,196,197,192,194,3174207,61,1,1246221,1927986,61,4,2568262,605945,-1322041,1322041
2018-02-05,193,196,192,192,4661768,95,6,2242768,2419000,78,13,3150111,1511657,-907343,907343
2018-02-06,192,197,191,192,3543204,61,4,1728204,1815000,101,5,2636720,906484,-908516,908516
2018-02-07,194,194,192,192,3708737,109,3,2308737,1400000,57,4,2627379,1081358,-318642,318642
2018-02-10,193,197,190,190,8972976,94,4,1432504,7540472,80,8,5272993,3699983,-3840489,3840489
2018-02-12,194,194,190,190,2531892,63,1,1741710,790182,55,2,2210799,321093,-469089,469089
2018-02-13,191,192,190,191,2565935,79,5,1903223,662712,54,1,1392643,1173292,510580,-510580
2018-02-14,193,193,190,192,2594019,71,2,1993019,601000,59,2,2420880,173139,-427861,427861
2018-02-17,191,192,187,187,4055202,139,1,3638865,416337,47,1,1815993,2239209,1822872,-1822872
2018-02-18,187,190,186,186,4140200,144,2,3911502,228698,55,2,3999316,140884,-87814,87814
2018-02-19,186,192,186,186,14105149,113,9,2534717,11570432,84,4,3250027,10855122,-715310,715310
2018-02-21,188,192,186,191,7992667,125,8,3751121,4241546,57,5,1807801,6184866,1943320,-1943320
2018-02-24,189,192,186,190,5262557,78,3,3310219,1952338,89,7,3452124,1810433,-141905,141905
2018-02-25,190,193,189,191,26625257,92,6,17319911,9305346,92,10,2974166,23651091,14345745,-14345745
2018-02-26,190,193,189,191,8256550,61,2,2299408,5957142,70,5,4398900,3857650,-2099492,2099492
2018-02-27,191,192,189,189,3656756,103,4,2812548,844208,37,4,2375654,1281102,436894,-436894
2018-02-28,190,193,189,190,3128580,92,4,1662830,1465750,69,7,2007240,1121340,-344410,344410
2018-03-03,190,192,188,189,7133766,79,4,2431766,4702000,85,7,4226138,2907628,-1794372,1794372
2018-03-04,189,192,186,187,66637941,146,4,3335691,63302250,73,4,5643402,60994539,-2307711,2307711
2018-03-05,189,192,185,187,12167172,158,10,5516872,6650300,83,8,6421510,5745662,-904638,904638
2018-03-06,185,190,183,187,16687191,163,6,5890191,10797000,70,5,10184774,6502417,-4294583,4294583
2018-03-07,184,187,183,186,1579016,54,2,1363089,215927,83,2,1261714,317302,101375,-101375
2018-03-10,186,189,185,185,8140656,98,4,3987937,4152719,73,7,4475656,3665000,-487719,487719
2018-03-11,186,186,183,184,5970311,136,7,4514305,1456006,55,5,3469100,2501211,1045205,-1045205
2018-03-12,182,187,181,182,21180648,280,3,15756104,5424544,95,12,5891833,15288815,9864271,-9864271
2018-03-18,182,191,182,188,10532332,73,3,3086053,7446279,117,7,8381741,2150591,-5295688,5295688
2018-03-19,190,193,187,191,8726137,102,3,2199737,6526400,108,13,5047694,3678443,-2847957,2847957
2018-03-25,191,194,190,192,1494499,44,2,804499,690000,43,1,1257042,237457,-452543,452543
2018-03-26,192,194,190,191,3517145,32,3,1311929,2205216,63,1,3295145,222000,-1983216,1983216
2018-03-27,191,194,188,190,5952834,83,4,5086159,866675,95,3,5445880,506954,-359721,359721
2018-03-28,191,193,190,191,2782586,42,2,2374586,408000,66,0,2782586,0,-408000,408000
2018-04-03,192,193,188,188,2496208,89,0,2496208,0,46,1,2396208,100000,100000,-100000
2018-04-04,189,192,187,187,1300709,83,2,1271709,29000,34,1,1299458,1251,-27749,27749
2018-04-07,191,191,185,185,2339247,82,4,1547900,791347,40,2,2315352,23895,-767452,767452
2018-04-08,185,190,183,183,5352608,102,5,2053108,3299500,83,5,5002355,350253,-2949247,2949247
2018-04-09,188,188,183,186,18326955,118,14,8870876,9456079,109,5,8102275,10224680,768601,-768601
2018-04-10,183,185,182,182,4565346,109,3,2232146,2333200,44,2,4365263,200083,-2133117,2133117
2018-04-11,182,186,176,180,20461466,137,4,4307025,16154441,103,4,12661466,7800000,-8354441,8354441
2018-04-15,178,185,178,184,4986925,48,2,406925,4580000,63,4,3289200,1697725,-2882275,2882275
2018-04-16,183,185,174,175,7599514,138,4,5338322,2261192,60,2,7168890,430624,-1830568,1830568
2018-04-17,177,182,175,182,9107055,54,6,1130071,7976984,85,2,7077298,2029757,-5947227,5947227
2018-04-18,180,183,179,182,5795765,25,2,782998,5012767,78,2,5580765,215000,-4797767,4797767
2018-04-21,183,183,177,179,4018734,59,3,2655734,1363000,36,1,555218,3463516,2100516,-2100516
2018-04-22,178,178,174,177,6570113,112,4,4737514,1832599,44,1,5503122,1066991,-765608,765608
2018-04-23,174,177,173,174,1274506,61,2,817682,456824,29,2,874406,400100,-56724,56724
2018-04-24,175,176,172,174,21636018,80,6,6047419,15588599,43,1,6380443,15255575,-333024,333024
2018-04-25,174,177,173,174,1284863,58,3,686205,598658,35,1,1255243,29620,-569038,569038
2018-04-28,175,177,171,172,13766008,80,4,8379008,5387000,68,2,5674565,8091443,2704443,-2704443
2018-04-29,171,174,170,172,15446910,56,4,5852442,9594468,44,3,14451983,994927,-8599541,8599541
2018-04-30,172,173,168,172,6904757,69,11,2053603,4851154,41,3,1114778,5789979,938825,-938825
2018-05-01,172,174,169,174,6596959,51,3,733421,5863538,56,6,4484707,2112252,-3751286,3751286
2018-05-05,173,173,170,172,2714158,43,5,437143,2277015,42,2,2348149,366009,-1911006,1911006
2018-05-06,170,173,169,172,4604515,49,4,439055,4165460,56,4,3409241,1195274,-2970186,2970186
2018-05-07,172,173,169,173,2949146,57,7,1114135,1835011,34,1,2199196,749950,-1085061,1085061
2018-05-08,173,173,172,172,2202341,56,4,1853093,349248,33,2,1192242,1010099,660851,-660851
2018-05-09,173,180,171,174,39562889,39,7,1212526,38350363,165,14,22174517,17388372,-20961991,20961991
2018-05-12,175,178,173,174,10631958,58,7,1675267,8956691,53,1,7312566,3319392,-5637299,5637299
2018-05-13,176,176,173,173,5948581,103,5,1392529,4556052,41,4,3643781,2304800,-2251252,2251252
2018-05-14,176,176,173,175,11484703,102,5,1614772,9869931,50,5,4138800,7345903,-2524028,2524028
2018-05-15,176,176,172,172,4553793,90,6,3105218,1448575,42,2,2333642,2220151,771576,-771576
2018-05-16,174,175,171,172,5607759,71,4,1964868,3642891,53,4,3767197,1840562,-1802329,1802329
2018-05-19,174,174,171,172,8829127,81,4,1726629,7102498,59,3,2491400,6337727,-764771,764771
2018-05-20,172,173,170,172,10327788,96,4,2339208,7988580,57,6,4879555,5448233,-2540347,2540347
2018-05-21,171,173,170,170,4513641,80,4,1746305,2767336,43,2,1928134,2585507,-181829,181829
2018-05-22,172,173,170,172,8541987,62,2,723352,7818635,57,5,2812209,5729778,-2088857,2088857
2018-05-23,171,172,169,172,7082142,103,7,1308679,5773463,47,4,1864320,5217822,-555641,555641
2018-05-26,170,172,170,170,6368487,90,3,2142157,4226330,51,1,3739188,2629299,-1597031,1597031
2018-05-27,170,172,170,170,5286354,52,4,1091292,4195062,61,5,2576118,2710236,-1484826,1484826
2018-05-28,170,171,169,170,4439561,76,4,2249004,2190557,41,6,2332531,2107030,-83527,83527
2018-05-29,170,171,168,169,10950840,104,8,2018049,8932791,47,3,4492165,6458675,-2474116,2474116
2018-05-30,169,170,168,169,14079435,72,8,7992613,6086822,60,6,10873935,3205500,-2881322,2881322
2018-06-02,169,170,168,169,8788751,0,0,0,0,0,0,0,0,0,0
2018-06-03,169,169,168,169,6234493,83,6,3327157,2907336,102,4,4579589,1654904,-1252432,1252432
2018-06-09,169,169,167,169,5261612,107,6,2356865,2904747,74,10,2584891,2676721,-228026,228026
2018-06-10,168,169,167,168,7193646,74,7,2356180,4837616,58,7,6194796,999000,-3838616,3838616
2018-06-11,167,169,167,168,5369106,65,9,1803379,3565727,49,2,4405961,963145,-2602582,2602582
2018-06-12,169,173,168,171,35008865,100,7,13047129,21961736,74,9,7029542,27979323,6017587,-6017587
2018-06-13,171,179,171,179,48985140,248,15,32985278,15999862,134,9,8018568,40966572,24966710,-24966710
2018-06-17,187,187,187,187,16259720,37,4,10493000,5766720,41,4,1239720,15020000,9253280,-9253280
2018-06-18,197,197,193,197,171997637,665,30,135823887,36173750,423,22,45899011,126098626,89924876,-89924876
2018-06-19,196,206,190,206,18855162,120,11,14463887,4391275,237,7,15374441,3480721,-910554,910554
2018-06-20,212,223,206,210,47513711,477,8,34767480,12746231,238,13,28609446,18904265,6158034,-6158034
2018-06-23,212,212,202,206,23615686,261,14,16746414,6869272,264,9,19854729,3760957,-3108315,3108315
2018-06-24,207,218,207,218,58735807,389,14,47654483,10881324,325,12,21774533,36761274,25879950,-25879950
2018-06-25,222,228,222,228,87741373,289,16,45572645,42168728,192,14,12214157,75527216,33358488,-33358488
2018-06-26,228,231,217,223,78683940,374,11,38052940,40631000,479,21,65769754,12914186,-27716814,27716814
2018-06-27,225,225,214,214,79951686,254,13,12953684,66998002,351,12,63222686,16729000,-50269002,50269002
2018-06-30,217,224,214,214,16746612,0,0,0,0,0,0,0,0,0,0
2018-07-01,214,214,207,209,25372176,162,12,7889176,17483000,150,4,13872176,11500000,-5983000,5983000
2018-07-02,205,216,205,210,20119735,138,16,17259236,2860499,119,7,7469906,12649829,9789330,-9789330
2018-07-03,214,222,211,217,27333498,182,13,21073498,6260000,194,11,9556883,17776615,11516615,-11516615
2018-07-04,219,223,213,217,24209538,142,8,14821724,9387814,175,13,8619310,15590228,6202414,-6202414
2018-07-07,219,219,209,209,22361402,120,14,5834874,16526528,106,7,7599043,14762359,-1764169,1764169
2018-07-08,213,213,209,211,7548981,66,7,4245981,3303000,140,3,5191139,2357842,-945158,945158
2018-07-10,209,217,208,209,10638962,88,12,6386531,4252431,126,6,4850516,5788446,1536015,-1536015
2018-07-11,215,215,208,209,20417254,70,9,6036290,14380964,266,16,12355568,8061686,-6319278,6319278
2018-07-14,207,212,203,204,10700707,186,10,7579458,3121249,78,7,5312957,5387750,2266501,-2266501
2018-07-15,203,207,199,203,6999132,126,7,3279383,3719749,76,7,3960018,3039114,-680635,680635
2018-07-16,203,206,199,202,9858716,82,4,2558812,7299904,114,6,6810554,3048162,-4251742,4251742
2018-07-17,198,206,198,199,6829497,80,7,2236754,4592743,72,2,4102697,2726800,-1865943,1865943
2018-07-18,202,204,195,198,6730152,120,4,3508174,3221978,56,3,5355862,1374290,-1847688,1847688
2018-07-21,200,203,196,198,5640204,124,4,2990204,2650000,53,3,2617823,3022381,372381,-372381
2018-07-22,201,201,195,196,5263605,149,6,4909605,354000,50,4,2737308,2526297,2172297,-2172297
2018-07-23,196,199,194,196,2904774,107,3,2404774,500000,68,3,2117988,786786,286786,-286786
2018-07-24,198,198,193,195,5434822,94,3,3480591,1954231,63,2,3496589,1938233,-15998,15998
2018-07-25,195,199,191,193,35127392,181,13,12345407,22781985,89,6,9897051,25230341,2448356,-2448356
2018-07-28,203,203,202,203,126839605,583,27,88385233,38454372,131,15,9837487,117002118,78547746,-78547746
2018-07-29,209,209,201,206,37672732,349,15,24993710,12679022,299,15,26509691,11163041,-1515981,1515981
2018-07-30,208,216,207,216,90720836,448,22,54643944,36076892,254,8,19555887,71164949,35088057,-35088057
2018-07-31,226,226,226,226,62696243,180,9,36686226,26010017,79,5,2350525,60345718,34335701,-34335701
2018-08-01,237,237,237,237,46359723,221,14,39459723,6900000,115,8,16125175,30234548,23334548,-23334548
2018-08-04,237,241,228,236,73183062,536,20,55318451,17864611,631,18,58335641,14847421,-3017190,3017190
2018-08-05,244,248,240,248,161181738,958,31,130041338,31140400,662,27,82333129,78848609,47708209,-47708209
2018-08-06,260,260,254,259,268657318,1549,53,180081445,88575873,457,25,69874823,198782495,110206622,-110206622
2018-08-07,253,267,247,252,76166134,731,24,44338014,31828120,710,16,66150166,10015968,-21812152,21812152
2018-08-08,255,256,244,244,50019456,482,15,27445456,22574000,496,10,47878358,2141098,-20432902,20432902
2018-08-11,244,244,234,236,49109187,500,21,26279468,22829719,403,6,43423187,5686000,-17143719,17143719
2018-08-12,239,248,236,239,23374647,437,12,21307833,2066814,281,16,21287716,2086931,20117,-20117
2018-08-13,241,247,236,239,19152211,217,23,7178583,11973628,193,4,16648459,2503752,-9469876,9469876
2018-08-14,243,249,236,238,33921868,419,25,22970808,10951060,329,13,32414773,1507095,-9443965,9443965
2018-08-15,241,241,236,238,12094464,237,9,10385263,1709201,146,0,12094464,0,-1709201,1709201
2018-08-18,239,246,238,245,28290997,319,18,15054532,13236465,287,16,21534887,6756110,-6480355,6480355
2018-08-19,248,255,248,255,140272547,429,16,69570914,70701633,324,22,31363296,108909251,38207618,-38207618
2018-08-20,257,268,256,265,136023243,1098,22,108009624,28013619,727,31,74190100,61833143,33819524,-33819524
2018-08-21,259,267,258,265,30921226,431,18,25382305,5538921,404,5,27781226,3140000,-2398921,2398921
2018-08-25,267,270,251,251,47069991,633,13,36550400,10519591,340,8,36433169,10636822,117231,-117231
2018-08-26,257,268,254,265,44443993,421,16,35327552,9116441,488,11,35480026,8963967,-152474,152474
2018-08-27,266,276,266,276,160889581,298,18,55014532,26586447,421,21,46036745,35564234,8977787,-8977787
2018-08-28,267,272,261,264,79076778,648,32,49890476,29186302,437,10,68753797,10322981,-18863321,18863321
2018-08-29,265,272,259,260,22214204,374,8,14126566,8087638,205,8,20114204,2100000,-5987638,5987638
2018-09-01,264,264,252,252,25596751,374,18,17584616,8012135,246,5,18991212,6605539,-1406596,1406596
2018-09-02,251,252,244,247,28467476,403,22,19225636,9241840,310,4,28097476,370000,-8871840,8871840
2018-09-03,252,259,246,257,33550258,274,9,23684190,9866068,306,14,27862369,5687889,-4178179,4178179
2018-09-04,260,265,256,257,23385850,305,7,18906703,4479147,208,11,17890818,5495032,1015885,-1015885
2018-09-05,261,261,249,254,19157410,285,9,14490410,4667000,207,15,13411072,5746338,1079338,-1079338
2018-09-08,259,266,256,260,25781797,360,8,17819608,7962189,331,10,20898409,4883388,-3078801,3078801
2018-09-09,263,274,257,274,93174146,447,30,52395187,40778959,590,50,36171088,57003058,16224099,-16224099
2018-09-10,281,285,275,281,83368608,608,17,45279728,38088880,519,25,42948172,40420436,2331556,-2331556
2018-09-11,283,288,273,280,44502038,496,18,25435476,19066562,542,9,34364431,10137607,-8928955,8928955
2018-09-12,293,294,293,294,111433443,518,24,63209212,48224231,359,19,37231235,74202208,25977977,-25977977
2018-09-15,309,309,294,298,123777473,1312,24,107979300,15798173,570,32,49253666,74523807,58725634,-58725634
2018-09-16,297,300,291,297,59013426,795,25,29992246,28971180,478,35,47812093,11151333,-17819847,17819847
2018-09-17,300,305,288,293,67538285,773,17,48711653,18826632,348,18,56349598,11188687,-7637945,7637945
2018-09-18,295,297,288,290,48549824,516,23,26246592,22303232,374,10,35919526,12630298,-9672934,9672934
2018-09-22,295,302,290,292,44322633,642,13,30824321,13498312,490,15,33828100,10494533,-3003779,3003779
2018-09-23,294,309,293,308,94571691,831,23,70189691,24382000,730,31,44408966,50162725,25780725,-25780725
2018-09-24,313,319,305,314,55148772,682,8,38341429,16807343,449,15,27874122,27274650,10467307,-10467307
2018-09-25,318,328,318,328,220612794,1463,38,134454988,86157806,476,29,29747437,190865357,104707551,-104707551
2018-09-26,339,344,333,344,232557061,1639,26,159144059,73413002,564,31,55032778,177524283,104111281,-104111281
2018-09-29,359,359,359,359,14648770,220,4,13943770,705000,109,4,5921145,8727625,8022625,-8022625
2018-09-30,376,391,371,385,204490767,2433,41,148505099,55985668,400,18,34778691,169712076,113726408,-113726408
2018-10-01,364,368,360,360,158883224,2005,36,117745845,41137379,1171,21,139803817,19079407,-22057972,22057972
2018-10-02,344,354,343,343,40854468,415,8,21869468,18985000,239,6,31854468,9000000,-9985000,9985000
2018-10-03,327,335,327,327,131421186,1158,29,79448070,51973116,1439,10,105741406,25679780,-26293336,26293336
2018-10-06,331,340,311,311,107802251,841,24,77499831,30302420,840,25,88776296,19025955,-11276465,11276465
2018-10-07,305,329,302,302,105190778,608,12,52887309,52303469,1009,10,82963578,22227200,-30076269,30076269
2018-10-08,298,318,294,315,46878876,502,8,38550783,8328093,835,7,42637693,4241183,-4086910,4086910
2018-10-09,320,322,315,321,83772081,831,7,69242081,14530000,434,19,30808645,52963436,38433436,-38433436
2018-10-10,314,327,314,320,55641172,532,12,41749612,13891560,474,15,37707502,17933670,4042110,-4042110
2018-10-13,320,326,306,306,63325669,353,8,32498669,30827000,541,5,56348976,6976693,-23850307,23850307
2018-10-14,302,309,300,307,6735489,102,9,5330489,1405000,110,3,5929396,806093,-598907,598907
2018-10-15,312,320,311,320,52017290,674,11,44378770,7638520,448,20,17636073,34381217,26742697,-26742697
2018-10-16,328,331,320,324,35559971,486,5,18665857,16894114,363,14,21540649,14019322,-2874792,2874792
2018-10-17,314,326,310,314,57405720,598,15,28654868,28750852,432,18,49028193,8377527,-20373325,20373325
2018-10-20,323,334,323,334,57198735,277,3,45189645,12009090,340,10,8616144,48582591,36573501,-36573501
2018-10-21,348,350,335,348,114304206,1010,18,92922052,21382154,790,14,67373031,46931175,25549021,-25549021
2018-10-22,351,361,344,352,89549363,813,21,58940145,30609218,678,15,47187281,42362082,11752864,-11752864
2018-10-23,355,366,346,361,93673232,546,19,35524288,58148944,814,19,51930999,41742233,-16406711,16406711
2018-10-24,355,358,341,341,50990806,683,32,35466720,15524086,593,11,32785014,18205792,2681706,-2681706
2018-10-27,335,347,330,330,36307770,516,40,19063595,17214127,462,3,34787787,1489935,-15724192,15724192
2018-10-28,333,342,331,342,39377746,554,18,28504746,10873000,348,7,21750335,17627411,6754411,-6754411
2018-10-29,344,352,342,349,72254842,584,15,43582523,28672319,416,11,25792371,46462471,17790152,-17790152
2018-10-31,347,352,339,339,45397672,507,19,34063751,11333921,306,16,18169887,27227785,15893864,-15893864
2018-11-03,338,349,335,338,21253000,267,9,10208442,11044558,267,3,13245598,8007402,-3037156,3037156
2018-11-04,342,345,330,337,25479900,327,14,11129639,14350261,354,6,20991407,4488493,-9861768,9861768
2018-11-05,339,345,338,341,32014887,301,10,20862615,11152272,289,8,19864006,12150881,998609,-998609
2018-11-06,341,347,338,341,17512727,295,10,9959709,7553018,439,8,12741623,4771104,-2781914,2781914
2018-11-10,334,344,331,332,23500942,373,7,9523562,13977380,352,5,21579186,1921756,-12055624,12055624
2018-11-11,332,337,323,329,27756079,343,17,11716436,16039643,384,3,27436079,320000,-15719643,15719643
2018-11-12,334,337,329,330,24308799,337,15,7569489,16739310,254,5,19902488,4406311,-12332999,12332999
2018-11-13,331,336,329,331,13897700,224,6,6465283,7432417,321,4,12873942,1023758,-6408659,6408659
2018-11-14,328,331,321,324,30979980,252,7,5294832,25685148,364,7,27895960,3084020,-22601128,22601128
2018-11-17,323,331,314,318,21534534,296,14,9270496,12264038,713,7,16280468,5254066,-7009972,7009972
2018-11-18,317,325,306,314,27551352,399,13,12960859,14590493,430,6,22051305,5500047,-9090446,9090446
2018-11-19,315,320,311,312,13011063,271,8,6559095,6451968,242,5,11566146,1444917,-5007051,5007051
2018-11-20,317,317,311,314,7025000,137,6,2446244,4578756,198,4,6684822,340178,-4238578,4238578
2018-11-21,314,314,305,307,24530926,398,10,16084327,8446599,265,8,17497127,7033799,-1412800,1412800
2018-11-24,299,299,293,293,40657604,562,10,19098408,21559196,304,9,26388613,14268991,-7290205,7290205
2018-11-26,288,288,279,279,59456560,515,19,19995560,39461000,352,8,19466296,39990264,529264,-529264
2018-11-27,279,284,279,279,19382886,577,9,15146710,4236176,183,2,16831421,2551465,-1684711,1684711
2018-11-28,281,285,268,277,17176020,464,11,12328628,4847392,252,3,16440780,735240,-4112152,4112152
2018-12-01,273,273,261,266,41134557,495,19,15303774,25830783,404,9,33603139,7531418,-18299365,18299365
2018-12-02,267,275,265,275,19988233,401,9,12897494,7090739,270,7,17177935,2810298,-4280441,4280441
2018-12-03,283,285,282,285,92348502,693,22,78835502,13513000,276,13,20661247,71687255,58174255,-58174255
2018-12-04,286,289,278,285,18065925,404,9,10040735,8025190,306,4,15847665,2218260,-5806930,5806930
2018-12-05,284,289,281,283,16460022,358,5,10481022,5979000,215,6,10062084,6397938,418938,-418938
2018-12-08,285,285,274,275,19887908,465,7,12783230,7104678,218,7,17833673,2054235,-5050443,5050443
2018-12-09,281,283,274,275,14577384,196,9,7658780,6918604,247,5,11749269,2828115,-4090489,4090489
2018-12-10,277,282,275,281,12368806,213,4,4519927,7848879,235,5,11101847,1266959,-6581920,6581920
2018-12-11,280,283,275,278,10056622,173,7,4272745,5783877,129,5,7763180,2293442,-3490435,3490435
2018-12-12,274,281,270,272,11333288,301,5,6667794,4665494,240,5,9220360,2112928,-2552566,2552566
2018-12-15,276,276,269,269,6627491,219,3,4460115,2167376,142,3,5842560,784931,-1382445,1382445
2018-12-16,272,276,266,272,10949626,188,5,3305637,7643989,170,4,8246505,2703121,-4940868,4940868
2018-12-17,266,273,264,266,19067659,239,25,8367746,10699913,203,4,12296968,6770691,-3929222,3929222
2018-12-18,267,271,265,266,8561779,179,7,3008531,5553248,156,4,7969513,592266,-4960982,4960982
2018-12-19,265,265,255,262,11547782,376,9,7250117,4297665,185,3,10654562,893220,-3404445,3404445
2018-12-22,257,258,250,256,8710793,151,6,3653368,5057425,201,6,6571429,2139364,-2918061,2918061
2018-12-23,259,268,259,267,13446189,227,3,9999537,3446652,187,6,11891059,1555130,-1891522,1891522
2018-12-24,265,273,264,265,12885026,214,3,4251958,8633068,163,6,10040479,2844547,-5788521,5788521
2018-12-25,267,267,261,264,10597225,146,6,2585357,8011868,140,4,7270087,3327138,-4684730,4684730
2018-12-26,261,277,261,277,20851143,202,14,8133757,12717386,359,10,14883747,5967396,-6749990,6749990
2018-12-29,278,280,274,277,16368667,274,6,9533667,6835000,168,6,8358236,8010431,1175431,-1175431
2018-12-30,278,280,274,278,13220374,151,7,4786333,8434041,200,4,9068260,4152114,-4281927,4281927
2018-12-31,277,282,277,280,15742310,123,3,9497492,6244818,199,5,6869311,8872999,2628181,-2628181
2019-01-01,280,281,273,273,11273799,223,5,8736117,2537682,134,3,9089215,2184584,-353098,353098
2019-01-02,273,278,272,273,17614415,150,3,2887471,14726944,185,6,11668043,5946372,-8780572,8780572
2019-01-05,276,280,273,278,8525304,120,1,7978606,546698,188,4,5806951,2718353,2171655,-2171655
2019-01-06,277,280,275,280,17012245,106,5,6078577,10933668,169,3,8785945,8226300,-2707368,2707368
2019-01-07,279,281,276,278,13047350,167,10,6969653,6077697,186,4,6919731,6127619,49922,-49922
2019-01-08,280,293,280,285,28022980,320,20,20592726,7430254,370,12,10151584,17871396,10441142,-10441142
2019-01-09,289,291,281,284,7026854,248,4,6682853,344001,200,3,5720252,1306602,962601,-962601
2019-01-12,283,290,279,279,9155943,204,4,6247164,2908779,154,5,6236057,2919886,11107,-11107
2019-01-13,279,283,275,278,6065075,230,4,4844129,1220946,190,4,4940615,1124460,-96486,96486
2019-01-14,277,283,275,276,8067752,206,9,4116548,3951204,172,4,6598115,1469637,-2481567,2481567
2019-01-15,277,281,276,278,8029714,159,10,3746903,4282811,164,5,4359403,3670311,-612500,612500
2019-01-16,281,281,276,276,6578514,202,4,5268514,1310000,128,3,4561317,2017197,707197,-707197
2019-01-19,279,279,276,277,9111469,231,5,7681958,1429511,124,6,6475180,2636289,1206778,-1206778
2019-01-20,281,291,278,279,24919558,262,5,15852288,9067270,298,10,16214953,8704605,-362665,362665
2019-01-21,278,281,273,273,10545774,251,2,10140774,405000,122,4,8483539,2062235,1657235,-1657235
2019-01-22,277,278,275,276,5381014,115,2,4012014,1369000,128,4,3842533,1538481,169481,-169481
2019-01-23,277,282,273,278,7086201,163,5,4202994,2883207,273,7,5497186,1589015,-1294192,1294192
2019-01-26,278,284,275,277,9901947,171,4,5617154,4284793,168,7,7266143,2635804,-1648989,1648989
2019-01-27,277,277,273,275,10871128,181,3,6753134,4117994,116,6,8642223,2228905,-1889089,1889089
2019-01-28,273,279,270,275,11624900,199,6,6666076,4958824,157,6,7040775,4584125,-374699,374699
2019-01-29,272,279,270,272,10172740,128,4,3952740,6220000,137,5,7349700,2823040,-3396960,3396960
2019-01-30,277,279,269,269,13666555,176,4,7696594,5969961,131,5,11483783,2182772,-3787189,3787189
2019-02-02,273,276,271,271,5929714,92,2,5559818,369896,98,1,5768520,161194,-208702,208702
2019-02-03,275,277,268,268,10977298,173,3,6500296,4477002,163,9,7827896,3149402,-1327600,1327600
2019-02-04,272,275,266,270,14453150,190,4,10137194,4315956,113,3,8863725,5589425,1273469,-1273469
2019-02-05,269,274,269,274,25186217,142,4,21105261,4080956,153,4,13035065,12151152,8070196,-8070196
2019-02-06,275,279,274,276,13638952,167,5,8388952,5250000,185,7,6313952,7325000,2075000,-2075000
2019-02-10,275,278,273,276,5313538,116,4,2937840,2375698,111,2,4196314,1117224,-1258474,1258474
2019-02-12,272,275,270,272,4931826,96,2,3155286,1776540,113,3,4123683,808143,-968397,968397
2019-02-13,272,272,268,270,13479470,128,3,2929470,10550000,169,6,3023780,10455690,-94310,94310
2019-02-16,272,276,270,273,9836429,103,5,5792399,4044030,199,5,5612496,4223933,179903,-179903
2019-02-17,273,273,272,272,9429434,96,4,2127928,7301506,132,4,4593747,4835687,-2465819,2465819
2019-02-18,273,273,270,273,11286738,124,6,3054404,8232334,107,4,6459407,4827331,-3405003,3405003
2019-02-19,273,278,272,277,16533811,123,8,9567781,6966030,157,3,12789529,3744282,-3221748,3221748
2019-02-20,275,285,275,282,28625488,234,13,18344781,10280707,239,9,11281124,17344364,7063657,-7063657
2019-02-23,286,295,286,290,41627535,509,32,30951599,10675936,401,11,14640830,26986705,16310769,-16310769
2019-02-24,291,297,287,296,16406912,243,14,11029033,5377879,275,9,7704130,8702782,3324903,-3324903
2019-02-25,296,301,293,293,30674584,368,13,22116789,8557795,278,11,9450547,21224037,12666242,-12666242
2019-02-26,292,302,286,296,23797758,188,24,10884782,12912976,272,10,18056289,5741469,-7171507,7171507
2019-02-27,297,302,296,297,20393608,236,11,10800224,9593384,171,9,5618525,14775083,5181699,-5181699
2019-03-02,297,303,296,297,9894553,203,7,8334418,1560135,163,7,4370600,5523953,3963818,-3963818
2019-03-03,299,300,295,296,8217904,157,10,6235712,1982192,177,7,5979825,2238079,255887,-255887
2019-03-04,299,300,295,297,18957549,195,13,14284433,4673116,178,5,9055066,9902483,5229367,-5229367
2019-03-05,297,297,290,294,12558844,180,7,10331181,2227663,143,4,7448193,5110651,2882988,-2882988
2019-03-06,294,300,293,297,18791262,205,6,16213346,2577916,219,7,7696955,11094307,8516391,-8516391
2019-03-09,300,304,297,301,19577607,295,5,17481093,2096514,219,8,10092839,9484768,7388254,-7388254
2019-03-10,301,304,299,301,17435853,312,8,12882892,4552961,161,7,12743850,4692003,139042,-139042
2019-03-11,301,311,301,309,54298431,431,10,43515663,10584153,417,13,20371881,33727935,23143782,-23143782
2019-03-17,324,331,317,322,68522038,297,12,36728835,31793203,244,7,34436784,34085254,2292051,-2292051
2019-03-18,324,335,320,333,32661147,399,13,19653318,13007829,353,13,23199877,9461270,-3546559,3546559
2019-03-19,334,338,334,336,16638393,317,9,10290887,6347506,201,5,13030070,3608323,-2739183,2739183
2019-03-25,337,338,329,332,10238552,211,6,5645363,4593189,148,5,9468792,769760,-3823429,3823429
2019-03-26,333,335,326,333,13158896,192,9,5760941,7397955,237,3,11808896,1350000,-6047955,6047955
2019-03-27,333,335,331,335,9077895,154,7,3920564,5157331,209,3,8979482,98413,-5058918,5058918
2019-03-30,335,342,335,341,10502959,248,9,6768044,3734915,214,4,8142898,2360061,-1374854,1374854
2019-03-31,341,342,335,337,9169494,241,3,8469494,700000,190,2,8036494,1133000,433000,-433000
2019-04-06,339,340,334,337,9868295,215,6,8398481,1469814,206,3,8913295,955000,-514814,514814
2019-04-07,337,337,331,331,28378862,526,8,21034247,7344615,301,5,24671547,3707315,-3637300,3637300
2019-04-08,331,339,329,339,27857196,283,16,11732544,16124652,347,4,17248257,10608939,-5515713,5515713
2019-04-09,333,341,331,337,24285909,198,12,12762309,11523600,293,4,19272084,5013825,-6509775,6509775
2019-04-10,339,349,335,346,43531812,334,14,30862799,12669013,418,7,22686646,20845166,8176153,-8176153
2019-04-13,345,355,345,352,36502813,291,8,29126243,7376570,425,15,25090977,11411836,4035266,-4035266
2019-04-14,354,361,345,359,28111994,309,15,20208658,7903336,385,7,18696698,9415296,1511960,-1511960
2019-04-15,356,370,356,362,37643993,363,12,22218049,15425944,346,13,20779439,16864554,1438610,-1438610
2019-04-16,363,370,351,352,24870382,231,8,8100129,16770253,336,14,18229765,6640617,-10129636,10129636
2019-04-17,355,359,347,352,21049744,231,11,11568116,9481628,246,4,18650275,2399469,-7082159,7082159
2019-04-20,361,372,359,372,44240966,161,34,22233192,22007774,360,10,14148984,30091982,8084208,-8084208
2019-04-22,389,389,371,375,42184279,475,11,34662726,7521553,448,8,38425193,3759086,-3762467,3762467
2019-04-23,370,379,366,368,24147336,226,15,8191383,15955953,308,10,19095912,5051424,-10904529,10904529
2019-04-24,370,378,366,368,16431288,282,7,10032189,6399099,216,5,12119321,4311967,-2087132,2087132
2019-04-27,370,370,352,365,23347324,423,15,16198114,7149210,264,4,22369215,978109,-6171101,6171101
2019-04-28,360,376,359,372,26052199,217,8,16908896,9143303,408,7,22852966,3199233,-5944070,5944070
2019-04-29,373,388,370,388,97167090,156,38,80179334,16987756,552,10,21279633,75887457,58899701,-58899701
2019-04-30,403,406,389,394,97596977,793,20,58934538,38662439,558,24,53325214,44271763,5609324,-5609324
2019-05-01,398,410,392,403,35841972,393,15,20789508,15052464,378,12,22582122,13259850,-1792614,1792614
2019-05-04,406,414,397,405,63469159,633,18,41791381,21677778,504,14,29542993,33926166,12248388,-12248388
2019-05-05,407,411,389,398,39766604,482,16,25215772,14550832,350,9,29399600,10367004,-4183828,4183828
2019-05-06,382,398,379,379,36460644,306,10,11903777,24556867,241,12,25378490,11082154,-13474713,13474713
2019-05-07,363,374,362,363,51430554,374,13,22100559,29329995,482,8,33332109,18098445,-11231550,11231550
2019-05-08,355,373,355,369,22818270,421,12,12249780,10568490,257,5,17006070,5812200,-4756290,4756290
2019-05-11,376,376,354,359,19062304,300,9,8487165,10575139,221,12,14762240,4300064,-6275075,6275075
2019-05-12,361,369,351,359,26740185,134,11,6263115,20477070,347,9,20880163,5860022,-14617048,14617048
2019-05-13,362,368,356,364,9339754,148,4,7663099,1676655,154,13,5849596,3490158,1813503,-1813503
2019-05-14,361,368,355,355,28659659,359,14,16740586,11919073,183,11,12820348,15839311,3920238,-3920238
2019-05-15,365,365,351,358,18533001,246,9,12125411,6407590,164,5,5079567,13453434,7045844,-7045844
2019-05-18,359,367,352,353,19898735,336,5,18745735,1153000,208,8,14590344,5308391,4155391,-4155391
2019-05-19,361,361,351,356,20704604,239,8,14954736,5749868,170,7,13916842,6787762,1037894,-1037894
2019-05-20,360,366,353,362,17658216,172,34,7783441,9874775,259,6,13176325,4481891,-5392884,5392884
2019-05-21,364,376,357,364,26279879,248,11,9154351,17125528,310,9,16157078,10122801,-7002727,7002727
2019-05-22,368,368,365,366,15742608,153,7,9160626,6581982,190,5,7610569,8132039,1550057,-1550057
2019-05-25,368,370,360,365,13979196,165,6,9862690,4116506,159,5,10651765,3327431,-789075,789075
2019-05-26,361,368,360,364,31301866,290,4,18601866,12700000,234,13,14554890,16746976,4046976,-4046976
2019-05-28,364,373,364,370,65163631,590,26,44903642,20259989,317,11,18129600,47034031,26774042,-26774042
2019-05-29,372,378,368,375,48550546,347,16,12686885,35863661,369,13,29133349,19417197,-16446464,16446464
2019-06-01,370,375,365,368,23984412,290,8,9235005,14749407,210,11,11396470,12587942,-2161465,2161465
2019-06-02,370,372,363,366,28835418,708,12,24877009,3958409,194,42,10305354,18530064,14571655,-14571655
2019-06-03,368,373,368,372,24500064,609,9,19391723,5108341,315,1,21500064,3000000,-2108341,2108341
2019-06-08,371,379,370,378,15342280,335,19,9352488,5989792,363,8,12022784,3319496,-2670296,2670296
2019-06-09,378,383,378,379,27966480,466,13,18210894,9755586,306,23,9596644,18369836,8614250,-8614250
2019-06-10,383,383,370,373,31737074,914,30,21476412,10260662,316,5,19470743,12266331,2005669,-2005669
2019-06-11,374,378,367,375,23579459,483,15,14833824,8745635,315,11,16387459,7192000,-1553635,1553635
2019-06-12,377,379,372,376,45882889,535,15,21877889,24005000,344,12,27597038,18285851,-5719149,5719149
2019-06-15,375,388,371,385,35986893,475,6,34904141,1082752,529,20,20779759,15207134,14124382,-14124382
2019-06-16,388,401,388,395,31500083,438,17,23395170,8104913,621,19,16958891,14541192,6436279,-6436279
2019-06-17,392,401,385,391,16233892,342,4,13680150,2553742,545,5,8456852,7777040,5223298,-5223298
2019-06-18,392,396,386,386,13117793,338,7,10907996,2209797,312,10,10556637,2561156,351359,-351359
2019-06-19,389,389,376,381,13225213,257,5,7067080,6158133,233,8,10802607,2422606,-3735527,3735527
2019-06-22,378,385,373,383,20859420,235,4,10325464,10533956,263,3,15152454,5706966,-4826990,4826990
2019-06-23,379,396,379,391,20980150,207,5,10097944,10882206,480,13,14335794,6644356,-4237850,4237850
2019-06-24,392,403,389,403,49004805,285,47,33958552,15046253,424,16,21465644,27539161,12492908,-12492908
2019-06-25,402,409,395,408,34813816,273,8,21255554,13558262,507,15,22081366,12732450,-825812,825812
2019-06-26,409,416,407,413,48521202,388,12,21786716,26734486,505,11,38768709,9752493,-16981993,16981993
2019-06-30,417,424,413,424,46586640,384,5,31707728,14878912,578,16,26026546,20560094,5681182,-5681182
2019-07-01,424,430,420,429,45931176,463,29,25520434,20410742,437,78,24111215,21819961,1409219,-1409219
2019-07-02,430,430,418,425,32530651,266,22,14008790,18521861,389,20,20829028,11701623,-6820238,6820238
2019-07-03,423,431,419,425,16455889,286,8,10474610,5981279,357,11,9411768,7044121,1062842,-1062842
2019-07-06,425,425,410,415,12282134,259,7,7897765,4384369,254,4,11567634,714500,-3669869,3669869
2019-07-07,408,424,408,420,16123141,171,11,9243301,6879840,290,9,8665552,7457589,577749,-577749
2019-07-08,416,421,413,419,19290284,228,8,13077049,6213235,245,4,16443666,2846618,-3366617,3366617
2019-07-09,415,420,411,418,25139238,120,16,10935095,14204143,400,9,21196611,3942627,-10261516,10261516
2019-07-10,421,432,421,432,30734052,198,33,23549092,7184960,544,15,14004539,16729513,9544553,-9544553
2019-07-13,431,444,431,438,19766746,245,9,14433616,5333130,620,14,11938156,7828590,2495460,-2495460
2019-07-14,439,449,437,444,38613106,456,7,27052511,11560595,331,17,22721826,15891280,4330685,-4330685
2019-07-15,450,450,429,435,30587595,290,35,14666582,15921013,294,9,22358909,8228686,-7692327,7692327
2019-07-16,433,433,414,416,41534397,319,16,25997982,15536415,294,4,40564840,969557,-14566858,14566858
2019-07-17,414,432,414,432,27898875,284,5,15628005,12270870,297,15,17689868,10209007,-2061863,2061863
2019-07-20,423,439,420,424,16292256,294,11,8375887,7916369,214,13,6684413,9607843,1691474,-1691474
2019-07-21,433,450,431,450,246452309,1505,30,175795807,70656502,713,27,42150360,204301949,133645447,-133645447
2019-07-22,457,462,450,451,56894904,827,25,40088994,16805910,453,15,32453890,24441014,7635104,-7635104
2019-07-23,452,457,441,449,31005567,335,14,22122978,8882589,352,8,24413418,6592149,-2290440,2290440
2019-07-24,450,455,444,444,13404365,317,10,9918745,3485620,260,9,7964565,5439800,1954180,-1954180
2019-07-27,446,453,439,442,20700683,286,12,11715569,8985114,242,5,19558081,1142602,-7842512,7842512
2019-07-28,439,448,437,444,27926433,251,13,15915206,12011227,271,13,15039701,12886732,875505,-875505
2019-07-29,448,460,444,453,66058375,500,24,32922995,33135380,383,14,22926302,43132073,9996693,-9996693
2019-07-30,459,475,455,467,57252166,583,18,28602606,28649560,553,22,29567611,27684555,-965005,965005
2019-07-31,473,478,469,478,40883612,535,17,19686631,21196981,384,17,24855372,16028240,-5168741,5168741
2019-08-03,474,481,470,472,14155526,322,5,10770355,3385171,362,6,8230829,5924697,2539526,-2539526
2019-08-04,470,478,467,470,16975056,258,22,9454582,7520474,403,7,13091558,3883498,-3636976,3636976
2019-08-05,470,470,462,467,20438542,325,18,9697963,10740579,338,3,15379542,5059000,-5681579,5681579
2019-08-06,460,470,450,452,22720279,364,8,14885089,7835190,243,3,16790316,5929963,-1905227,1905227
2019-08-07,454,460,444,453,11058049,289,27,7280026,3778023,245,3,8756048,2302001,-1476022,1476022
2019-08-10,444,453,440,444,13899574,356,7,9223404,4676170,361,2,13168251,731323,-3944847,3944847
2019-08-11,451,451,440,451,20122754,472,19,13996938,6125816,233,2,11122754,9000000,2874184,-2874184
2019-08-13,450,453,438,440,16878779,481,8,11902289,4976490,192,3,4820418,12058361,7081871,-7081871
2019-08-14,450,457,446,451,15837831,340,4,10035831,5802000,256,5,12444923,3392908,-2409092,2409092
2019-08-17,453,457,448,451,11986273,240,12,7430169,4556104,314,7,10166497,1819776,-2736328,2736328
2019-08-18,452,457,444,447,10810246,289,5,7879621,2930625,243,6,8086321,2723925,-206700,206700
2019-08-19,445,454,444,450,12429438,204,24,5818964,6610474,311,5,9721305,2708133,-3902341,3902341
2019-08-21,450,455,444,450,21503679,436,9,11970870,9532809,242,8,10891258,10612421,1079612,-1079612
2019-08-24,451,457,445,456,17983512,447,11,12001361,5982151,401,8,16788809,1194703,-4787448,4787448
2019-08-25,455,462,446,459,18480776,369,9,13484412,4996364,370,3,15680776,2800000,-2196364,2196364
2019-08-26,459,478,457,478,60981560,485,12,45726910,15254650,628,14,30631805,30349755,15095105,-15095105
2019-08-27,483,492,478,480,35013007,437,16,15799654,19213353,466,8,28816958,6196049,-13017304,13017304
2019-08-28,480,507,466,503,107355247,577,20,90702002,16653245,738,10,36470376,70884871,54231626,-54231626
2019-08-31,509,514,504,512,97334046,913,12,78015445,19318601,726,19,36562762,60771284,41452683,-41452683
2019-09-01,512,527,505,518,38946891,649,13,15828256,23118635,497,8,26081042,12865849,-10252786,10252786
2019-09-02,521,521,497,514,23851733,457,13,14365909,9485824,520,5,19302697,4549036,-4936788,4936788
2019-09-03,511,515,504,507,16190336,419,11,9903933,6286403,295,35,14086333,2104003,-4182400,4182400
2019-09-04,500,518,500,517,14569422,333,17,7938478,6630944,393,52,12506932,2062490,-4568454,4568454
2019-09-07,515,518,510,517,29665051,491,10,21417592,8201012,341,10,15919284,13699320,5498308,-5498308
2019-09-08,518,528,513,516,36254227,464,11,22621827,13632400,307,30,21672934,14581293,948893,-948893
2019-09-11,515,529,514,524,56386805,347,59,16554384,39832421,349,12,17824297,38562508,-1269913,1269913
2019-09-14,527,548,527,535,38283398,507,9,18799514,19483884,480,17,20359176,17924222,-1559662,1559662
2019-09-15,537,546,527,535,40644272,412,12,8716633,31927639,395,13,17338320,23305952,-8621687,8621687
2019-09-16,537,555,513,537,50703911,482,16,17542052,33161859,317,20,17817208,32886703,-275156,275156
2019-09-17,537,537,516,531,28871379,486,13,18566376,10305003,282,10,21946481,6924898,-3380105,3380105
2019-09-18,518,522,502,518,19169646,305,14,7647892,11521754,372,7,15898042,3271604,-8250150,8250150
2019-09-21,503,517,502,509,28022707,424,23,19695301,8327406,248,8,16106923,11915784,3588378,-3588378
2019-09-22,515,520,504,518,40642171,320,12,16826138,23816033,310,12,9820493,30821678,7005645,-7005645
2019-09-23,524,536,524,536,98850023,497,22,69882354,28967669,487,26,19132060,79717963,50750294,-50750294
2019-09-24,544,544,532,540,54234349,369,10,10744600,43489749,410,9,44212970,10021379,-33468370,33468370
2019-09-25,539,560,539,556,33253697,423,42,16123943,17129754,536,16,19261737,13991960,-3137794,3137794
2019-09-28,556,565,552,559,52413869,695,75,23775362,28638507,362,11,26478799,25935070,-2703437,2703437
2019-09-29,555,559,543,555,24088731,483,15,13332555,10756176,398,3,22152659,1936072,-8820104,8820104
2019-09-30,555,565,552,563,62212148,384,21,28299703,33864190,425,11,18234757,43929136,10064946,-10064946
2019-10-01,561,579,559,563,37850933,339,64,29737013,8113920,335,14,17945882,19905051,11791131,-11791131
2019-10-02,572,572,546,567,25624581,471,70,11514607,14109974,323,8,18678968,6945613,-7164361,7164361
2019-10-05,577,577,552,555,26641444,586,66,17557775,9083669,348,22,14991636,11649808,2566139,-2566139
2019-10-06,555,557,539,557,30060591,384,70,9530084,20530507,336,59,28713045,1347546,-19182961,19182961
2019-10-07,552,568,546,555,29237054,260,12,8451426,20785628,346,7,21190394,8046660,-12738968,12738968
2019-10-08,555,556,530,546,32221411,312,80,10993966,21227445,458,6,22910713,9310698,-11916747,11916747
2019-10-09,549,567,542,561,46356040,253,73,14377314,31978726,601,83,26953320,19402720,-12576006,12576006
2019-10-12,568,585,563,585,77782858,361,67,47811767,29971091,589,14,19391837,58391021,28419930,-28419930
2019-10-13,610,611,594,601,71386917,846,17,50292667,21094250,641,25,35359589,36027328,14933078,-14933078
2019-10-14,604,607,581,601,33473033,414,19,12079486,21393547,343,10,11289462,22183571,790024,-790024
2019-10-15,598,610,564,566,95094388,532,17,18922872,76171516,466,30,77089511,18004877,-58166639,58166639
2019-10-16,561,592,561,576,16980983,367,13,6836488,10144495,253,12,10513121,6467862,-3676633,3676633
2019-10-20,568,590,555,566,31121494,411,10,10875780,20245714,476,88,16170161,14951333,-5294381,5294381
2019-10-21,574,581,555,570,14448614,292,14,7514527,6934087,187,6,12598467,1850147,-5083940,5083940
2019-10-22,577,582,570,572,16756520,448,59,7564997,9191523,263,3,15784282,972238,-8219285,8219285
2019-10-23,566,582,562,570,11049248,265,11,5741676,5307572,221,1,9238248,1811000,-3496572,3496572
2019-10-26,565,579,563,566,11918273,200,8,6429965,5488308,200,18,7456882,4461391,-1026917,1026917
2019-10-28,561,573,561,563,31724694,320,10,9750969,21973725,198,27,10215340,21509354,-464371,464371
2019-10-30,564,585,564,583,15542916,270,9,8319132,7223784,340,10,9967802,5575114,-1648670,1648670
2019-11-02,583,589,568,574,39444724,411,19,11535375,27909349,208,9,7471197,31973527,4064178,-4064178
2019-11-03,574,583,564,572,7450106,211,15,2975743,4474363,220,7,7055133,394973,-4079390,4079390
2019-11-04,573,581,558,564,11486666,268,13,6480560,5006106,182,6,8076065,3410601,-1595505,1595505
2019-11-05,562,574,561,567,12658870,216,9,4334324,8324546,194,5,7455781,5203089,-3121457,3121457
2019-11-09,562,572,558,567,13920337,251,9,4319581,9600756,212,6,9110934,4809403,-4791353,4791353
2019-11-10,561,566,555,565,9845331,188,6,4705331,5140000,195,8,5830593,4014738,-1125262,1125262
2019-11-11,559,572,556,564,8133515,218,13,2917982,5215533,169,5,7493462,640053,-4575480,4575480
2019-11-12,561,564,555,557,12852136,432,7,9748442,3103694,176,16,6496379,6355757,3252063,-3252063
2019-11-13,561,564,553,557,19128593,355,6,10725612,8402981,183,12,13394233,5734360,-2668621,2668621
2019-11-16,557,563,551,555,13169694,242,13,8507986,4661708,211,9,11422909,1746785,-2914923,2914923
2019-11-17,544,560,541,544,14628058,177,15,3824289,10803769,171,7,9804119,4823939,-5979830,5979830
2019-11-18,555,555,539,555,22165083,155,9,18972410,3211179,163,7,13879291,8304298,5093119,-5093119
2019-11-19,555,560,546,555,13156672,202,8,10770544,2386128,121,5,4925760,8230912,5844784,-5844784
2019-11-20,546,564,546,559,12941669,144,8,7840978,5100691,209,7,7504198,5437471,336780,-336780
2019-11-23,563,566,555,563,22530632,184,5,5920645,16609987,195,6,14578737,7951895,-8658092,8658092
2019-11-24,557,564,556,558,9355684,158,4,3908819,5446865,166,5,5199401,4156283,-1290582,1290582
2019-11-25,558,560,550,552,16833439,431,7,7648434,9185005,220,5,15478439,1355000,-7830005,7830005
2019-11-26,553,559,546,557,11779922,236,10,9566511,2213411,218,9,11124190,655732,-1557679,1557679
2019-11-27,552,562,543,553,12582898,420,9,9800794,2782104,186,11,6959941,5622957,2840853,-2840853
2019-11-30,544,555,544,550,14779489,369,6,10292274,4487215,248,2,10077957,4701532,214317,-214317
2019-12-01,554,559,547,555,19671333,437,9,13040113,6631220,289,5,13135404,6535929,-95291,95291
2019-12-02,552,565,552,555,18124283,348,10,10056157,8068126,256,7,11442981,6681302,-1386824,1386824
2019-12-03,558,558,550,555,19543536,346,5,17179304,2364232,214,4,8328479,11215057,8850825,-8850825
2019-12-04,552,556,552,555,30390029,313,15,12199517,18190512,226,6,16007719,14382310,-3808202,3808202
2019-12-07,559,569,557,564,23161057,369,11,11942512,11218545,350,5,13730136,9430921,-1787624,1787624
2019-12-08,564,576,563,564,29986309,483,11,23386928,6599381,298,4,23455799,6530510,-68871,68871
2019-12-09,574,599,572,599,82778479,485,14,55294848,27483631,572,9,31777168,51001311,23517680,-23517680
2019-12-10,603,611,590,600,113174517,1122,21,58400230,54774287,614,22,28941842,84232675,29458388,-29458388
2019-12-11,600,618,593,611,13081143,338,7,10863647,2217496,335,9,9160920,3920223,1702727,-1702727
2019-12-14,611,617,605,609,31707943,528,18,21972951,9734992,384,7,14089546,17618397,7883405,-7883405
2019-12-15,614,617,594,602,29306369,420,12,11055825,18250544,386,11,12027542,17278827,-971717,971717
2019-12-16,606,606,596,602,9748805,231,5,7242306,2506499,294,6,7719648,2029157,-477342,477342
2019-12-17,598,609,598,602,31091039,338,12,7058441,24032598,303,5,8091255,22999784,-1032814,1032814
2019-12-18,609,621,604,620,32489297,368,16,9123671,23365626,414,13,14638233,17851064,-5514562,5514562
2019-12-21,623,623,616,620,17872032,388,6,10432417,7439615,340,6,11158675,6713357,-726258,726258
2019-12-22,628,636,619,627,22204948,336,13,8403159,13801789,327,8,9838133,12366815,-1434974,1434974
2019-12-23,633,647,616,631,34624824,363,18,11736770,22888054,454,12,18446756,16178068,-6709986,6709986
2019-12-24,643,652,629,651,56844503,402,18,14703458,42120494,428,16,21546473,35277479,-6843015,6843015
2019-12-25,651,655,640,655,26098368,357,9,8418847,17679521,412,13,12287806,13810562,-3868959,3868959
2019-12-28,657,680,648,680,92570408,630,15,20981794,71588614,659,21,46367043,46203365,-25385249,25385249
2019-12-29,694,694,676,687,18937100,603,5,15351254,3585846,382,8,13110927,5826173,2240327,-2240327
2019-12-30,685,690,681,689,12233273,459,5,9769358,2448988,387,5,10449184,1769162,-679826,679826
2019-12-31,690,690,671,689,20100824,378,7,15534723,4566101,442,15,12066628,8034196,3468095,-3468095
2020-01-01,685,703,681,693,25602908,432,9,14306051,11296857,361,13,14840774,10762134,-534723,534723
2020-01-04,660,679,660,660,102060742,396,19,6225742,95835000,588,8,78021687,24039055,-71795945,71795945
2020-01-05,638,677,638,657,50408924,422,11,11040964,39367960,509,9,45033924,5375000,-33992960,33992960
2020-01-07,658,677,624,625,64221426,469,15,11639361,52582065,575,9,58821850,5399576,-47182489,47182489
2020-01-08,624,638,624,625,101962207,317,16,16940483,85021724,545,11,93452705,8509502,-76512222,76512222
2020-01-11,636,636,636,636,2857716,9,0,2857716,0,49,3,1247716,1610000,1610000,-1610000
2020-01-12,668,668,668,668,45182647,94,4,35382647,9800000,77,8,6200931,38981716,29181716,-29181716
2020-01-13,701,701,685,701,159886466,910,19,113320095,46566371,372,28,27673466,132213000,85646629,-85646629
2020-01-14,731,731,700,703,37486061,749,12,26322911,11163150,415,10,24536330,12949731,1786581,-1786581
2020-01-15,711,725,694,712,23786486,511,6,18792537,4993949,424,13,14656278,9130208,4136259,-4136259
2020-01-18,724,751,722,751,114538284,1073,11,48065751,66472533,593,23,34351146,80187138,13714605,-13714605
2020-01-19,774,774,748,761,47165810,1202,8,27842097,19323713,374,14,18513698,28652112,9328399,-9328399
2020-01-20,762,765,746,760,19337903,578,3,11198339,8139564,389,7,15516628,3821275,-4318289,4318289
2020-01-21,750,755,721,729,37419326,740,8,15938120,21480494,395,10,28090533,9328081,-12152413,12152413
2020-01-22,742,750,729,740,18064682,510,7,11507467,6557215,285,9,9164198,8900484,2343269,-2343269
2020-01-25,744,746,731,736,26391376,857,9,18313576,8077800,408,11,12674168,13717208,5639408,-5639408
2020-01-26,740,740,722,724,29291731,753,12,19521731,9770000,466,5,23975804,5315927,-4454073,4454073
2020-01-27,722,737,722,733,15081966,536,17,11437321,3644645,430,6,12731246,2350720,-1293925,1293925
2020-01-28,736,754,724,748,60338346,841,13,36533291,23805055,417,14,50697839,9640507,-14164548,14164548
2020-02-01,748,759,737,741,33743908,678,8,18394384,15349524,410,13,13188370,20555538,5206014,-5206014
2020-02-02,740,743,722,742,26010387,553,10,16088915,9921472,399,7,16841332,9169055,-752417,752417
2020-02-03,742,767,742,756,66801587,793,6,53762727,13038860,553,18,15117004,51684583,38645723,-38645723
2020-02-04,761,768,748,758,16154231,483,7,9423260,6730971,506,8,13162124,2992107,-3738864,3738864
2020-02-05,764,780,750,777,32114386,507,13,21753839,10360547,661,11,13988206,18126180,7765633,-7765633
2020-02-08,801,801,785,801,167086488,1140,18,87290462,79796026,669,27,33644016,133442472,53646446,-53646446
2020-02-09,832,832,807,810,55174467,1424,12,37424467,17750000,641,7,45960029,9214438,-8535562,8535562
2020-02-10,816,816,781,811,28144019,749,13,16042624,12101395,627,7,22666161,5477858,-6623537,6623537
2020-02-12,805,835,803,835,48576608,412,6,19135856,29440752,626,14,25517293,23059315,-6381437,6381437
2020-02-15,864,875,850,864,38448777,1269,8,23264532,15184245,580,12,20747491,17701286,2517041,-2517041
2020-02-16,870,903,865,902,48927884,1100,11,21898882,27027900,706,11,27563820,21362962,-5664938,5664938
2020-02-17,925,929,905,907,45486989,1060,6,26599302,18887687,660,8,29438447,16048542,-2839145,2839145
2020-02-18,905,944,880,935,48528305,728,8,11816488,36711817,914,14,35219240,13309065,-23402752,23402752
2020-02-19,935,959,925,959,54988141,840,12,25167533,29820608,731,18,20741377,34246764,4426156,-4426156
2020-02-22,925,1005,925,976,45697607,1724,9,35910178,9787429,666,15,17873760,27823847,18036418,-18036418
2020-02-23,981,1025,979,1025,79643346,1684,15,28451174,51192172,647,18,40082701,39560645,-11631527,11631527
2020-02-24,1051,1051,971,991,74403860,2599,14,46531234,27872626,759,12,28364048,46039812,18167186,-18167186
2020-02-25,992,992,968,975,50454285,2004,17,27981248,22473037,1038,15,30482028,19972257,-2500780,2500780
2020-02-26,998,998,948,952,43460142,1575,13,27746428,15713714,684,3,38880091,4580051,-11133663,11133663
2020-02-29,927,947,920,921,72601422,1709,8,27600961,44630120,857,10,51037890,21193191,-23436929,23436929
2020-03-01,904,961,904,935,38821403,1523,11,33528902,5292501,570,19,23798245,15023158,9730657,-9730657
2020-03-02,970,970,940,951,61219239,1345,16,32404312,28814927,577,10,17006392,44212847,15397920,-15397920
2020-03-03,971,993,954,990,33841608,926,15,21164511,12677097,964,8,24644158,9197450,-3479647,3479647
2020-03-04,990,1020,983,1010,45277669,1201,11,34047432,11230237,1036,14,24643700,20633969,9403732,-9403732
2020-03-07,1009,1009,961,977,25562639,1095,7,20191038,5371601,815,4,16953178,8609461,3237860,-3237860
2020-03-09,926,926,926,926,12598064,684,3,4598064,8000000,10,0,12598064,0,-8000000,8000000
2020-03-10,900,900,900,900,11398503,568,5,4981846,6416657,19,1,11198503,200000,-6216657,6216657
2020-03-11,888,921,877,877,112859860,2071,22,81866193,30993667,987,15,91483274,21376586,-9617081,9617081
2020-03-14,851,870,840,840,26745286,926,7,17751296,8993990,195,4,19950082,6795204,-2198786,2198786
2020-03-15,814,870,802,831,129758717,1352,22,46066375,83692342,914,19,67870484,61888233,-21804109,21804109
2020-03-16,827,846,822,829,27910998,1652,7,22568660,5342338,336,7,18781146,9129852,3787514,-3787514
2020-03-17,846,846,803,831,51833053,1073,9,18822188,33010865,388,7,22013319,29819734,-3191131,3191131
2020-03-18,840,840,805,831,42915748,1874,11,22985437,19930311,391,10,13292295,29623453,9693142,-9693142
2020-03-24,814,831,788,803,27407216,1705,7,24834170,2573046,601,12,17091532,10315684,7742638,-7742638
2020-03-25,805,835,797,827,32847270,1718,7,27263438,5812480,560,10,15398518,17677400,11864920,-11864920
2020-03-28,852,852,837,851,58319519,3791,7,56028173,2291346,635,14,14122370,44197149,41905803,-41905803
2020-03-29,877,886,861,869,33874422,3014,8,30197701,3676721,795,11,21104660,12769762,9093041,-9093041
2020-03-30,894,900,861,898,37913619,1682,11,22046672,15764446,1027,8,26151362,11659756,-4104690,4104690
2020-04-04,925,928,914,928,56947105,2313,8,45275905,11671200,762,14,20477140,36469965,24798765,-24798765
2020-04-05,968,968,918,923,27021457,2052,7,24960367,2061090,1120,8,25302757,1718700,-342390,342390
2020-04-06,923,924,894,916,34899201,1308,14,23870038,11029163,1662,6,27519000,7380201,-3648962,3648962
2020-04-07,925,958,907,945,64138420,1552,13,36515823,27622597,1771,10,50194206,13944214,-13678383,13678383
2020-04-08,961,976,948,976,54397012,1131,9,33840092,20556920,1112,11,27297012,27100000,6543080,-6543080
2020-04-11,1029,1080,1029,1080,84113895,3094,6,75107786,9006109,1780,23,55251090,28862805,19856696,-19856696
2020-04-12,1129,1129,1092,1129,69951692,3355,9,53946692,16005000,1038,15,34466280,35485412,19480412,-19480412
2020-04-13,1183,1183,1110,1120,69840430,4383,9,63143198,6698332,2168,15,59204075,10637455,3939123,-3939123
2020-04-14,1098,1203,1092,1203,94996272,2110,10,33989294,61006978,3656,11,82721091,12275181,-48731797,48731797
2020-04-15,1217,1217,1182,1217,69154924,2926,10,55282372,13872552,1785,20,32823203,36331721,22459169,-22459169
2020-04-18,1275,1275,1272,1275,63176095,3558,6,45160609,18015486,603,9,20573095,42603000,24587514,-24587514
2020-04-19,1339,1339,1293,1296,168577123,8964,22,134358796,34218327,2103,26,81438393,87138730,52920403,-52920403
2020-04-20,1333,1401,1333,1401,105783120,4766,17,87166897,18616223,1597,12,68338245,37444875,18828652,-18828652
2020-04-21,1441,1468,1401,1458,89441933,7078,14,76562683,12879250,1729,15,70812462,18629471,5750221,-5750221
2020-04-22,1476,1515,1470,1514,137098353,9456,11,121351626,15745727,2295,22,104081021,33016332,17270605,-17270605
2020-04-28,1726,1812,1726,1812,260178712,8402,29,210968886,49209826,2833,24,79398844,180779868,131570042,-131570042
2020-04-29,1874,1874,1861,1874,247155254,14376,29,223052022,24103232,1479,17,46332314,200822940,176719708,-176719708
2020-05-02,1967,1967,1950,1967,165059872,9622,15,129771165,35288707,1022,13,30469412,134590460,99301753,-99301753
2020-05-03,2066,2066,2064,2066,389777531,21794,47,316322806,73454725,1418,20,45665531,344112000,270657275,-270657275
2020-05-04,2167,2169,1962,2169,339667906,17067,39,283399543,56268363,3246,39,139179819,200488087,144219724,-144219724
2020-05-05,2269,2274,2058,2058,356609283,21639,40,297719967,58889316,6180,34,294036805,62572478,3683162,-3683162
2020-05-06,2013,2147,2013,2029,275052563,16427,28,214383982,60668581,7054,25,220467239,54585324,-6083257,6083257
2020-05-09,2117,2144,2047,2144,210711176,8693,21,149757838,60953338,3754,20,114054448,96656728,35703390,-35703390
2020-05-10,2248,2248,2036,2094,208297338,18118,31,188925966,19371372,6982,19,180463550,27833788,8462416,-8462416
2020-05-11,2123,2125,2037,2037,52142963,6331,10,39909035,12233928,1449,5,50692963,1450000,-10783928,10783928
2020-05-12,1950,1950,1950,1950,21542806,2387,4,9423652,12119154,44,4,8121534,13421272,1302118,-1302118
2020-05-13,1853,1950,1853,1853,271457731,12381,30,241831246,29626485,8600,29,220618289,50839442,21212957,-21212957
2020-05-16,1777,1777,1777,1777,29751258,2639,3,27551258,2200000,1182,3,28243599,1507659,-692341,692341
2020-05-17,1688,1776,1688,1717,235476285,7624,40,171318238,64181747,7038,16,191668365,43831620,-20350127,20350127
2020-05-18,1791,1793,1708,1793,201627442,8106,20,144162015,33296162,3683,27,112531503,64926674,31630512,-31630512
2020-05-19,1838,1838,1693,1711,119606472,8825,18,112195908,7410564,4412,10,107946839,11659633,4249069,-4249069
2020-05-20,1694,1792,1661,1773,184821498,6992,36,152022753,32798745,9292,17,159294697,25526801,-7271944,7271944
2020-05-23,1747,1747,1655,1694,73498374,4656,24,57264596,16233778,4437,17,67978092,5520282,-10713496,10713496
2020-05-26,1678,1694,1611,1611,60102204,3009,20,44226074,15876130,2599,2,57726080,2376124,-13500006,13500006
2020-05-27,1580,1702,1580,1702,77313296,4267,13,65028342,12284954,4193,14,61264168,16049128,3764174,-3764174
2020-05-30,1753,1753,1753,1753,26587035,1658,0,26587035,0,684,5,6587035,20000000,20000000,-20000000
2020-05-31,1841,1841,1753,1841,258422632,14836,14,232907055,25515577,4865,33,196264094,62158538,36642961,-36642961
2020-06-01,1928,1928,1873,1928,61472859,4347,5,58411291,3061568,1901,14,41169653,20303206,17241638,-17241638
2020-06-02,2023,2023,2023,2023,21598993,772,4,21118993,480000,1171,4,11598993,10000000,9520000,-9520000
2020-06-06,2124,2124,2124,2124,20657821,195,14,16875287,3782534,1220,10,8046161,12611660,8829126,-8829126
2020-06-07,2230,2230,2230,2230,22131135,325,12,20298135,1833000,1260,11,9846264,12284871,10451871,-10451871
2020-06-08,2118,2341,2118,2304,414161779,26288,37,354844804,57121944,9821,39,301442371,110524377,53402433,-53402433
2020-06-09,2324,2446,2221,2446,287485851,21812,33,265961710,21524141,10364,47,237412326,50073525,28549384,-28549384
2020-06-10,2482,2537,2343,2397,204984607,22962,28,180084037,24900570,9580,23,194911036,10073571,-14826999,14826999
2020-06-13,2427,2500,2326,2385,253509887,25591,36,224980517,28529370,14778,15,249214181,4295706,-24233664,24233664
2020-06-14,2401,2401,2273,2297,196961781,20476,40,170817911,26143870,9261,13,173724063,23237718,-2906152,2906152
2020-06-15,2324,2417,2324,2352,208843967,19461,11,206316303,2527664,7922,25,168162859,40681108,38153444,-38153444
2020-06-16,2403,2472,2330,2415,136476596,14559,22,117384375,19092221,7619,12,109434856,27041740,7949519,-7949519
2020-06-20,2488,2488,2417,2443,6975210,1129,1,4975210,2000000,334,1,5836846,1138364,-861636,861636
2020-06-22,2573,2573,2573,2573,63237669,2545,7,52429905,10807764,2735,15,21853798,41383871,30576107,-30576107
2020-06-23,2701,2701,2701,2701,62187862,2555,11,53677862,8510000,4424,8,54737185,7450677,-1059323,1059323
2020-06-24,2679,2834,2675,2834,206496769,10059,35,158393321,48103448,7625,38,137182627,69314142,21210694,-21210694
2020-06-27,2935,2947,2931,2947,68872224,3806,16,50642868,18229356,3876,21,46561636,22310588,4081232,-4081232
2020-06-28,3091,3091,2799,2860,227101044,17840,25,203302844,23798200,8888,22,196503852,30597192,6798992,-6798992
2020-06-29,2846,2984,2834,2955,203536176,14012,39,145372304,58164872,13422,17,185607630,17929546,-40235326,40235326
2020-06-30,3026,3026,3026,3026,83347969,3818,8,69441152,13906817,3841,9,17998618,65349351,51442534,-51442534
2020-07-01,3175,3175,3152,3175,144320912,8665,33,104623025,39697887,6864,20,79309428,65011484,25313597,-25313597
2020-07-04,3293,3333,3018,3063,207274893,24427,42,176628760,30646133,11806,20,197363711,9911182,-20734951,20734951
2020-07-05,3014,3284,3014,3284,149898180,8640,27,107108435,42789745,7014,20,67805135,82093045,39303300,-39303300
2020-07-06,3412,3412,3412,3412,105995515,6491,17,75669856,30325659,2984,14,22445255,83550260,53224601,-53224601
2020-07-07,3581,3581,3427,3581,259838707,20551,37,189470597,70368110,7989,36,158688847,101149860,30781750,-30781750
2020-07-08,3640,3752,3398,3398,220519367,32658,36,189458877,31060490,9950,20,179001654,41517713,10457223,-10457223
2020-07-11,3382,3737,3382,3565,186394134,20539,35,171784834,14609300,9483,19,172048877,14345257,-264043,264043
2020-07-12,3652,3652,3486,3546,151712910,15824,28,117821489,33891421,6409,25,96256803,55456107,21564686,-21564686
2020-07-13,3542,3808,3445,3451,201154687,25861,37,169919784,31234903,12276,30,180917692,20236995,-10997908,10997908
2020-07-14,3477,3672,3327,3404,193363776,19761,34,138970590,54393186,15334,40,176304272,17059504,-37333682,37333682
2020-07-15,3368,3486,3335,3335,156121815,16687,33,131491744,24630071,11670,16,142828409,13293406,-11336665,11336665
2020-07-18,3181,3323,3181,3250,202324160,23661,39,170682877,31641283,14868,24,168483425,33840735,2199452,-2199452
2020-07-19,3331,3382,3331,3382,239324224,13964,33,186535629,52788595,6812,20,61659473,177664751,124876156,-124876156
2020-07-20,3524,3548,3416,3427,295287061,30565,52,242926033,52365940,8967,41,144976267,150315706,97949766,-97949766
2020-07-21,3368,3699,3349,3349,134669336,19815,43,111611276,23058060,7761,9,103037266,31632070,8574010,-8574010
2020-07-22,3290,3345,3201,3228,163016068,15413,31,141373007,21643061,11896,15,138523039,24493029,2849968,-2849968
2020-07-25,3376,3376,3376,3376,39353609,3391,10,28442609,10911000,4351,9,30680610,8672999,-2238001,2238001
2020-07-26,3544,3544,3420,3536,380906857,29457,39,317305343,63601514,10642,53,186006467,194900390,131298876,-131298876
2020-07-27,3510,3707,3356,3707,240601831,24063,35,195169469,43797882,14238,35,172955555,66011796,22213914,-22213914
2020-07-28,3764,3764,3689,3764,330821747,28548,46,295275440,35546307,9266,47,143050040,187771707,152225400,-152225400
2020-07-29,3760,3880,3577,3813,202217510,25038,33,183738010,18479500,15045,37,152665355,49552155,31072655,-31072655
2020-08-01,3930,3930,3882,3930,141819559,13411,21,117114818,24704741,4610,24,90783879,51035680,26330939,-26330939
2020-08-02,4125,4125,4036,4125,233107274,18326,30,188030892,45076382,3761,32,79620627,153486647,108410265,-108410265
2020-08-03,4294,4330,4205,4330,167216451,12886,26,103955473,63260978,7662,40,111848798,55367653,-7893325,7893325
2020-08-04,4286,4528,4280,4528,98488550,8086,27,74242255,24246295,6792,15,72072448,26416102,2169807,-2169807
2020-08-05,4649,4649,4649,4649,88449538,3240,16,54829333,12276378,5230,17,26731711,40374000,28097622,-28097622
2020-08-09,4881,4881,4881,4881,79288941,9335,12,63625874,15663067,4035,23,41033146,38255795,22592728,-22592728
2020-08-10,5123,5123,4639,4639,268299402,44969,39,224116820,44182582,7727,29,199551840,68747562,24564980,-24564980
2020-08-11,4690,4690,4690,4690,10381653,4810,5,7821653,2560000,16,3,6001653,4380000,1820000,-1820000
2020-08-12,4456,4456,4456,4456,15426439,4990,10,10934216,4492223,104,0,15426439,0,-4492223,4492223
2020-08-15,4233,4233,4233,4233,14732650,3514,3,10732650,4000000,187,5,13285650,1447000,-2553000,2553000
2020-08-16,4022,4022,4022,4022,16770617,2530,5,4020617,12750000,273,14,15170617,1600000,-11150000,11150000
2020-08-17,3979,4146,3821,4058,140164004,26019,53,207288057,46027936,14726,49,220492354,32823639,-13204297,13204297
2020-08-17,4038,4137,3932,4079,113151989,26019,53,207288057,46027936,14726,49,220492354,32823639,-13204297,13204297
2020-08-18,3949,3959,3806,3806,41770715,7022,18,24655258,49468758,1525,8,58599016,15525000,-33943758,33943758
2020-08-18,3806,3806,3806,3806,32353301,7022,18,24655258,49468758,1525,8,58599016,15525000,-33943758,33943758
2020-08-19,3630,3630,3630,3630,7679269,2369,10,3950474,15035705,375,7,17786179,1200000,-13835705,13835705
2020-08-19,3630,3630,3630,3630,11306910,2369,10,3950474,15035705,375,7,17786179,1200000,-13835705,13835705
2020-08-22,3449,3743,3449,3449,103410119,8405,23,47752167,55657952,4186,12,92786269,10623850,-45034102,45034102
2020-08-23,3329,3427,3319,3319,130787199,4455,22,26302201,104484998,6742,14,105951611,24835588,-79649410,79649410
2020-08-24,3193,3309,3160,3167,322187658,5574,26,41563658,280624000,15623,48,290422224,31765434,-248858566,248858566
2020-08-25,3317,3319,3230,3319,42044293,2635,5,39543305,2500988,4158,17,35253309,6790984,4289996,-4289996
2020-08-26,3477,3477,3477,3477,33658553,1003,7,30138723,3519830,1441,12,6252396,27406157,23886327,-23886327
2020-08-31,3650,3650,3349,3626,241211962,23254,40,209021756,32277077,13252,28,212139099,29159734,-3117343,3117343
2020-09-01,3506,3626,3392,3392,89524523,7349,17,62341873,27182650,5436,11,75793425,13731098,-13451552,13451552
2020-09-02,3242,3349,3242,3242,90629287,3494,21,24934091,65700820,6125,18,69303078,21331833,-44368987,44368987
2020-09-05,3404,3404,3242,3404,143622152,8319,21,118081768,25540384,11807,29,119474213,24147939,-1392445,1392445
2020-09-06,3546,3546,3286,3307,132979559,11641,34,111611398,21368161,9207,21,123812725,9166834,-12201327,12201327
2020-09-07,3276,3307,3276,3276,21523871,2001,3,9323871,12200000,1580,0,21523871,0,-12200000,12200000
2020-09-08,3112,3112,3112,3112,41991524,1208,5,2891524,39100000,658,4,40641524,1350000,-37750000,37750000
2020-09-09,2957,3205,2957,3132,200349589,13919,34,166665316,33684273,12664,40,165721678,34627911,943638,-943638
2020-09-12,3169,3169,3057,3169,135460979,11565,26,113705282,21755697,5932,26,99623126,35837853,14082156,-14082156
2020-09-13,3152,3248,3006,3069,113917177,10201,29,98996605,14920572,7936,11,102939305,10977872,-3942700,3942700
2020-09-14,2986,3213,2984,3213,99646246,4095,27,88575047,11071199,7740,21,71743485,27902761,16831562,-16831562
2020-09-15,3327,3327,3327,3327,24620136,155,0,24620136,0,1427,9,4899486,19720650,19720650,-19720650
2020-09-16,3492,3492,3370,3492,124629612,4590,19,99193652,25435960,6505,16,96056765,28572847,3136887,-3136887
2020-09-19,3492,3660,3347,3638,168820231,9287,21,148775596,20044635,14227,25,129393848,39426383,19381748,-19381748
2020-09-20,3622,3664,3421,3421,98524221,7502,21,73034189,25490032,8421,9,97099997,1424224,-24065808,24065808
2020-09-21,3301,3388,3284,3323,76755878,5385,34,54613450,22142428,6140,13,67456849,9299029,-12843399,12843399
2020-09-22,3329,3447,3146,3394,76140839,6633,24,65536202,10604637,6825,16,70053513,6087326,-4517311,4517311
2020-09-23,3437,3467,3349,3467,87963338,6594,19,77519144,10444194,7351,9,83964598,3998740,-6445454,6445454
2020-09-26,3565,3615,3447,3524,89696383,8954,19,80689142,9007241,7572,17,80911799,8784584,-222657,222657
2020-09-27,3467,3467,3376,3376,21337154,2130,4,10737154,10600000,777,1,20337154,1000000,-9600000,9600000
2020-09-28,3213,3213,3213,3213,15698942,803,3,2197942,13501000,113,0,15698942,0,-13501000,13501000
2020-09-29,3053,3331,3053,3215,113187872,5777,18,85337149,27850723,10202,12,107453019,5734853,-22115870,22115870
2020-09-30,3199,3230,3014,3211,55567508,5256,25,47924699,7642809,5324,9,45503778,10063730,2420921,-2420921
2020-10-03,3209,3291,3163,3291,35591235,2458,9,34526477,1064758,3384,7,30313594,5277641,4212883,-4212883
2020-10-04,3337,3347,3116,3132,88656052,7986,21,51903899,36752153,4215,9,68670252,19985800,-16766353,16766353
2020-10-05,3018,3152,3012,3016,80336821,7827,19,63400143,16936678,5335,8,73998239,6338582,-10598096,10598096
2020-10-06,3022,3177,3022,3177,94758392,6245,20,61598814,33159578,5080,20,63980805,30777587,-2381991,2381991
2020-10-07,3230,3270,3053,3144,62696051,9425,13,55925717,6770334,4432,11,54264271,8431780,1661446,-1661446
2020-10-10,3112,3163,3016,3081,65558039,9299,17,58481409,7076630,6206,11,56562898,8995141,1918511,-1918511
2020-10-11,3118,3217,3112,3132,101313044,7078,16,88755044,12558000,6084,16,78046553,23266491,10708491,-10708491
2020-10-12,3095,3230,3045,3098,65177147,7309,25,54732896,10444251,5694,6,62079993,3097154,-7347097,7347097
2020-10-13,3100,3195,2978,3132,61297488,6085,27,50759710,10537778,5127,5,59583788,1713700,-8824078,8824078
2020-10-14,3112,3130,2966,3012,50913445,4541,49,38580163,12333282,4741,22,45157218,5756227,-6577055,6577055
2020-10-18,2907,2957,2892,2892,46930566,3274,42,21333101,25597465,1873,11,39708258,7222308,-18375157,18375157
2020-10-19,2752,2752,2752,2752,11842046,854,6,2829146,9012900,215,1,11792046,50000,-8962900,8962900
2020-10-20,2616,2616,2616,2616,31395256,1143,7,5790256,25605000,679,12,29262404,2132852,-23472148,23472148
2020-10-21,2582,2699,2486,2561,118106992,6437,38,90056679,28050313,7477,18,98275110,19831882,-8218431,8218431
2020-10-24,2405,2431,2405,2405,12933628,908,4,5831851,7101777,545,2,8833628,4100000,-3001777,3001777
2020-10-26,2285,2285,2285,2285,40405635,1020,8,25755635,14650000,2904,6,36098871,4306764,-10343236,10343236
2020-10-27,2244,2263,2171,2171,31527650,1416,8,21308695,10218955,2053,6,27377650,4150000,-6068955,6068955
2020-10-28,2086,2214,2086,2214,128169512,3908,30,60325129,67844383,8008,18,112714302,15455210,-52389173,52389173
2020-10-31,2206,2236,2149,2236,54196627,3468,13,39065026,15131601,3609,10,40405126,13791501,-1340100,1340100
2020-11-01,2283,2283,2116,2116,41130656,2655,19,24795627,16335029,3075,5,36945656,4185000,-12150029,12150029
2020-11-02,2058,2147,2033,2086,33007550,1673,13,19162828,13844722,2938,8,25258845,7748705,-6096017,6096017
2020-11-04,2163,2165,2088,2165,26463061,245,1,20781372,5681689,2186,6,16663061,9800000,4118311,-4118311
2020-11-07,2058,2058,2058,2058,14092913,1022,8,6166913,7926000,164,4,12680913,1412000,-6514000,6514000
2020-11-08,1956,1956,1956,1956,8715729,479,5,1065729,7650000,70,2,8343729,372000,-7278000,7278000
2020-11-09,1901,1960,1877,1911,142736722,2842,25,55351809,93049854,5070,22,97997563,50404100,-42645754,42645754
2020-11-10,1911,1960,1846,1960,55338080,2247,15,30756408,24581672,3341,12,49541927,5796153,-18785519,18785519
2020-11-11,1871,1982,1832,1982,60896946,2440,20,47909060,12987886,4366,12,49647901,11249045,-1738841,1738841
2020-11-14,2019,2019,2019,2019,11040000,41,5,7890000,3150000,810,5,5816472,5223528,2073528,-2073528
2020-11-15,2110,2110,2051,2110,149463232,4582,19,133854038,15609194,4804,24,114570387,34892845,19283651,-19283651
2020-11-16,2110,2210,2043,2210,44036279,1634,8,39173490,4862789,2265,14,32926728,11109551,6246762,-6246762
2020-11-17,2293,2293,2248,2293,35073198,652,8,22333198,12740000,945,9,17188768,17884430,5144430,-5144430
2020-11-18,2407,2407,2407,2407,26878367,151,7,21618367,5260000,924,7,8583715,18294652,13034652,-13034652
2020-11-21,2527,2527,2383,2433,204158837,7949,31,138445984,65712853,5735,27,145617403,58541434,-7171419,7171419
2020-11-22,2454,2636,2387,2565,104092956,6471,20,82855176,21237780,5173,15,89085340,15007616,-6230164,6230164
2020-11-23,2588,2638,2502,2561,60276735,5267,15,50106522,10170213,3328,11,51477764,8798971,-1371242,1371242
2020-11-24,2559,2561,2441,2441,88387552,4733,17,51586552,36801000,3350,13,74819701,13567851,-23233149,23233149
2020-11-25,2368,2551,2338,2472,73539392,5186,18,56379901,17059491,4769,5,67094178,6345214,-10714277,10714277
2020-11-28,2427,2596,2385,2596,77955737,4274,11,59512895,18442842,5232,10,61134846,16820891,-1621951,1621951
2020-11-29,2689,2689,2626,2689,115828463,4146,16,84273860,31554603,3131,19,47800472,68027991,36473388,-36473388
2020-11-30,2813,2823,2748,2821,120584840,6554,31,74120342,46464498,4595,18,83894110,36690730,-9773768,9773768
2020-12-01,2758,2935,2685,2880,103944793,6219,36,80240418,23704375,6626,10,99091821,4852972,-18851403,18851403
2020-12-06,2974,2974,2834,2880,103030042,8431,26,85012000,18018042,6083,15,70395736,32634306,14616264,-14616264
2020-12-07,2917,2943,2771,2771,89883041,6460,33,59495097,30387944,7611,6,85289041,4594000,-25793944,25793944
2020-12-08,2756,2815,2679,2701,76556011,5267,36,53161025,23394986,6873,7,75629376,926635,-22468351,22468351
2020-12-09,2643,2738,2604,2701,62876103,5108,25,47205696,15670407,6448,13,50811271,12064832,-3605575,3605575
2020-12-12,2706,2799,2706,2748,106660261,6184,29,66797077,39863184,6026,27,64650513,42009748,2146564,-2146564
2020-12-13,2768,2872,2681,2750,69413544,4453,20,37817195,31596349,4799,12,57776711,11636833,-19959516,19959516
2020-12-14,2697,2815,2639,2639,48329002,3251,14,22951913,25377089,3746,9,46451011,1877991,-23499098,23499098
2020-12-15,2545,2559,2545,2545,25544737,906,10,5416737,20128000,1222,6,18603450,6941287,-13186713,13186713
2020-12-16,2419,2498,2419,2444,105262499,4723,34,62231651,43030848,5684,19,72058930,33203569,-9827279,9827279
2020-12-19,2502,2555,2484,2555,54970387,2277,10,36864055,18106332,3450,14,33463635,21506752,3400420,-3400420
2020-12-20,2665,2665,2462,2563,35973180,2961,15,28491034,7482146,3492,11,31579081,4394099,-3088047,3088047
2020-12-21,2484,2610,2458,2482,34008738,2464,13,22459291,11549447,3182,11,30458889,3549849,-7999598,7999598
2020-12-22,2454,2541,2446,2490,47403640,3583,16,33448549,13955091,4365,8,40283039,7120601,-6834490,6834490
2020-12-23,2490,2563,2425,2433,40528947,3297,17,35886369,4647810,3856,6,39896179,638000,-4009810,4009810
2020-12-26,2417,2476,2338,2354,61784909,3215,26,35995345,25789564,5235,9,52977678,8807231,-16982333,16982333
2020-12-27,2338,2496,2314,2399,40946491,3410,14,36398856,4547635,4229,13,33000458,7946033,3398398,-3398398
2020-12-28,2403,2515,2393,2515,62825542,4160,13,56658271,6170797,4369,12,45386964,17442104,11271307,-11271307
2020-12-29,2531,2531,2383,2407,45005403,2406,18,22786228,22219175,3644,8,41389599,3615804,-18603371,18603371
2020-12-30,2383,2458,2313,2352,43264106,2239,15,21397339,21866767,4180,5,42406100,858006,-21008761,21008761
2021-01-02,2275,2324,2255,2255,70369738,2203,20,24483269,45886469,4183,6,52849737,17520001,-28366468,28366468
2021-01-03,2226,2336,2222,2295,37274835,2028,16,17139327,20135508,3564,10,34195426,3079409,-17056099,17056099
2021-01-04,2287,2342,2285,2324,25601196,2357,10,18758693,6842503,2516,7,22804145,2797051,-4045452,4045452
2021-01-05,2287,2316,2238,2255,38782321,1514,9,10420545,28361776,3600,4,38388552,393769,-27968007,27968007
2021-01-06,2200,2228,2163,2175,44587246,1478,22,22131235,22456011,4454,10,42768053,1819193,-20636818,20636818
2021-01-09,2137,2226,2074,2141,48099469,1756,22,29598447,18501022,4138,9,37805826,10293643,-8207379,8207379
2021-01-10,2110,2208,2110,2208,43408955,2504,7,39159130,4249825,2848,10,22303228,21105727,16855902,-16855902
2021-01-11,2295,2295,2167,2182,36609597,2451,12,30093442,6516155,2735,5,28370245,8239352,1723197,-1723197
2021-01-12,2179,2181,2116,2116,20682485,965,11,10588572,10093913,1470,1,20557485,125000,-9968913,9968913
2021-01-13,2049,2121,2019,2033,43947233,1360,18,27979636,15967597,3731,10,42294044,1653189,-14314408,14314408
2021-01-16,1970,2019,1940,1944,79096060,1604,19,30881431,48214629,3985,8,55264004,23832056,-24382573,24382573
2021-01-18,1873,1901,1846,1846,86877115,1737,23,46779894,40097221,3709,16,69656948,17220167,-22877054,22877054
2021-01-19,1773,1938,1773,1938,63143951,2506,16,52599070,10544881,2575,13,39071950,24072001,13527120,-13527120
2021-01-20,1991,1995,1926,1995,19305019,338,2,16805019,2500000,833,4,6555019,12750000,10250000,-10250000
2021-01-23,2092,2092,2092,2092,19885009,110,4,16044080,3840929,574,7,2326675,17558334,13717405,-13717405
2021-01-24,2196,2196,2051,2141,108697287,3648,15,87774380,20922907,3813,21,86232021,22465266,1542359,-1542359
2021-01-25,2127,2281,2068,2281,60755591,2548,11,48934208,11821383,2844,8,53723579,7032012,-4789371,4789371
2021-01-26,2303,2311,2137,2137,35189972,2090,12,28023252,7166720,1737,11,32834078,2355894,-4810826,4810826
2021-01-27,2206,2265,2086,2228,37363113,1608,10,25581044,11782069,2671,9,33268676,4094437,-7687632,7687632
2021-01-30,2226,2293,2226,2293,17040969,302,2,15040969,2000000,1458,6,8290569,8750400,6750400,-6750400
2021-01-31,2405,2405,2324,2332,117581537,3761,21,103517315,14064222,4133,15,94286638,23294899,9230677,-9230677
2021-02-01,2336,2443,2281,2291,45785033,1828,18,27716655,18068378,2731,7,43739330,2045703,-16022675,16022675
2021-02-02,2253,2313,2246,2253,37479625,1441,27,22753983,14725642,2609,7,36030960,1448665,-13276977,13276977
2021-02-03,2253,2322,2151,2151,40619325,1201,21,21446840,19172485,2163,9,31453256,9166069,-10006416,10006416
2021-02-06,2165,2184,2058,2058,48577094,736,14,11036894,37540200,2371,9,40914931,7662163,-29878037,29878037
2021-02-07,2088,2169,2088,2169,15415042,198,4,11289770,4125272,1242,13,8100527,7314515,3189243,-3189243
2021-02-08,2271,2271,2194,2271,75272601,1352,10,47960763,27311838,3059,16,56721200,18551401,-8760437,8760437
2021-02-09,2265,2379,2236,2379,29222551,440,3,28232551,990000,1572,10,19199051,10023500,9033500,-9033500
2021-02-13,2517,2517,2462,2517,61712042,2712,11,54528908,7183134,2481,19,37351389,24360653,17177519,-17177519
2021-02-14,2561,2600,2466,2466,40826338,2363,14,24948696,15877642,2033,13,34569533,6256805,-9620837,9620837
2021-02-15,2458,2508,2458,2458,30375502,1259,11,15812916,14562586,1564,7,28237502,2138000,-12424586,12424586
2021-02-16,2462,2482,2413,2413,18957779,546,6,4957779,14000000,956,3,18283779,674000,-13326000,13326000
2021-02-17,2387,2454,2374,2383,21496955,973,6,12036217,9460738,1952,2,20996955,500000,-8960738,8960738
2021-02-20,2334,2383,2334,2334,16529421,618,10,5799421,10730000,853,1,16516677,12744,-10717256,10717256
2021-02-21,2289,2289,2289,2289,3243241,158,3,702981,2540260,17,1,2743241,500000,-2040260,2040260
2021-02-22,2273,2273,2273,2273,2635014,104,1,635014,2000000,35,1,2435014,200000,-1800000,1800000
2021-02-23,2261,2340,2261,2326,49799745,1447,9,23720466,26079279,2625,12,42908421,6891324,-19187955,19187955
2021-02-24,2236,2248,2234,2234,9278674,390,3,3078674,6200000,844,1,9228674,50000,-6150000,6150000
2021-02-27,2194,2194,2194,2194,6048770,146,6,1093770,4955000,206,0,6048770,0,-4955000,4955000
2021-02-28,2169,2169,2169,2169,3619994,120,3,509994,3110000,53,2,2869994,750000,-2360000,2360000
2021-03-01,2153,2186,2153,2165,34578872,1392,15,19513440,15065432,2856,9,29142147,5436725,-9628707,9628707
2021-03-02,2129,2226,2121,2157,20101299,1200,12,13269306,6831993,1945,6,14241867,5859432,-972561,972561
2021-03-03,2157,2157,2116,2141,21984012,791,14,7269517,14714495,1511,6,17246918,4737094,-9977401,9977401
2021-03-06,2092,2145,2086,2100,25710454,1105,11,12370485,13339969,1785,5,21220661,4489793,-8850176,8850176
2021-03-07,2068,2214,2068,2214,43534099,1569,18,30922165,12611934,2890,15,23957134,19576965,6965031,-6965031
2021-03-08,2246,2313,2220,2313,58715064,1570,13,42693842,16021222,2972,18,38206625,20508439,4487217,-4487217
2021-03-09,2393,2403,2285,2297,33112111,1691,14,19888850,13223261,2450,6,29103591,4008520,-9214741,9214741
2021-03-10,2305,2378,2285,2328,31928009,1339,17,20547687,11380322,2065,12,22462484,9465525,-1914797,1914797
2021-03-13,2364,2476,2336,2476,82223348,2137,29,30376760,51846588,4224,20,54745503,27477845,-24368743,24368743
2021-03-17,2471,2502,2433,2475,24413601,1061,9,19863601,4550000,870,5,19713601,4700000,150000,-150000
2021-03-27,2454,2618,2422,2538,39902926,1520,18,18548619,21354307,1761,13,33938943,5963983,-15390324,15390324
2021-03-28,2570,2589,2492,2496,15704548,961,9,12260851,3444697,1167,5,13903566,1801982,-1642715,1642715
2021-03-28,2502,2502,2502,2502,1000,961,9,12260851,3444697,1167,5,13903566,1801982,-1642715,1642715
2021-03-30,2481,2570,2475,2481,12744256,937,10,9204926,3539330,1076,3,10567288,2176968,-1362362,1362362
2021-03-31,2460,2525,2456,2456,9484281,633,12,4702409,4781872,837,2,9423829,60452,-4721420,4721420
2021-04-03,2414,2414,2414,2414,4484906,191,4,772906,3712000,120,0,4484906,0,-3712000,3712000
2021-04-04,2393,2393,2393,2393,7829980,160,5,1829980,6000000,252,1,7029980,800000,-5200000,5200000
2021-04-05,2357,2401,2357,2393,26192550,1093,13,17672214,8520336,1674,11,22315467,3877083,-4643253,4643253
2021-04-06,2348,2399,2315,2315,12640540,797,10,7853851,4786689,968,3,10511826,2128714,-2657975,2657975
2021-04-07,2287,2287,2287,2287,5694469,529,6,1764005,3930464,256,1,5594469,100000,-3830464,3830464
2021-04-10,2264,2264,2264,2264,1148059,177,1,769282,378777,17,0,1148059,0,-378777,378777
2021-04-11,2260,2260,2260,2260,3509799,145,4,683799,2826000,24,0,3509799,0,-2826000,2826000
2021-04-12,2245,2254,2245,2254,29777719,1148,20,18959471,10818248,1580,6,25385822,4391897,-6426351,6426351
2021-04-13,2275,2376,2266,2308,37396540,1980,5,34857295,2539245,1956,12,21166239,16230301,13691056,-13691056
2021-04-14,2300,2338,2256,2256,19866608,1060,11,12524033,7342575,1360,3,17259423,2607185,-4735390,4735390
2021-04-17,2233,2233,2233,2233,2424047,236,5,919047,1505000,163,1,2423852,195,-1504805,1504805
2021-04-18,2222,2222,2222,2222,800735,117,2,296024,504711,20,0,800735,0,-504711,504711
2021-04-19,2218,2218,2218,2218,8011358,237,5,1394809,6616549,81,2,8008862,2496,-6614053,6614053
2021-04-20,2188,2275,2186,2186,24926711,1473,11,16907818,8018893,1957,2,24766711,160000,-7858893,7858893
2021-04-21,2153,2228,2142,2142,18761249,704,16,12927254,5833995,1044,0,18761249,0,-5833995,5833995
2021-04-24,2087,2127,2083,2083,21365424,828,10,8764919,12600505,1130,4,21169790,195634,-12404871,12404871
2021-04-25,2032,2072,2030,2030,33658349,789,10,12585704,21072645,1254,12,29840848,3817501,-17255144,17255144
2021-04-26,1978,2106,1978,2079,16054252,833,7,9670129,6384123,1390,5,14979484,1074768,-5309355,5309355
2021-04-27,2049,2174,2049,2171,22373035,896,7,18464715,3908320,1587,10,17064249,5308786,1400466,-1400466
2021-04-28,2148,2239,2136,2159,10950834,826,10,7908708,3042126,948,2,8600834,2350000,-692126,692126
2021-05-01,2123,2188,2102,2102,13808186,657,10,4572118,9236068,1023,4,13294053,514133,-8721935,8721935
2021-05-02,2056,2083,2056,2062,20030005,598,8,4142296,15887709,763,10,16960506,3069499,-12818210,12818210
2021-05-03,1999,2041,1997,1997,27342814,825,10,7987003,19355811,870,6,14303915,13038899,-6316912,6316912
2021-05-05,2007,2091,1997,2064,14413294,760,9,10836100,3577194,1332,8,9485723,4927571,1350377,-1350377
2021-05-08,2032,2104,1988,2005,15323023,540,12,7408083,7914940,1206,3,14861023,462000,-7452940,7452940
2021-05-09,1963,2011,1955,1957,36269023,694,13,19115846,17153177,1128,4,22210595,14058428,-3094749,3094749
2021-05-10,1919,2075,1919,2075,35502398,1065,9,30058997,5443401,1739,14,18077994,17424404,11981003,-11981003
2021-05-11,2106,2161,2043,2161,28166023,1366,16,20672037,7493986,1327,7,19937719,8228304,734318,-734318
2021-05-12,2161,2203,2075,2110,17250358,832,12,8709176,8541182,1389,7,13582281,3668077,-4873105,4873105
2021-05-15,2045,2207,2045,2138,20280454,668,11,13532458,6747996,1050,6,11609658,8670796,1922800,-1922800
2021-05-16,2085,2167,2085,2119,10074674,534,10,5456804,4617870,800,3,6674070,3400604,-1217266,1217266
2021-05-17,2064,2127,2026,2028,16970808,697,14,8066406,8881331,752,4,8790173,8157564,-723767,723767
2021-05-18,2011,2110,2001,2068,14606789,436,9,3535175,11071614,819,4,8127309,6479480,-4592134,4592134
2021-05-19,2018,2079,1969,1969,24976653,713,19,10821990,14154663,758,6,20769462,4207191,-9947472,9947472
2021-05-22,1933,1999,1904,1904,20333197,760,14,6596036,13737161,807,7,16904395,3428802,-10308359,10308359
2021-05-23,1834,1959,1834,1896,21567795,495,15,7515010,14052785,902,8,11509730,10058065,-3994720,3994720
2021-05-24,1851,1965,1851,1938,19490170,591,11,10644271,8845899,1206,11,11330256,8159914,-685985,685985
2021-05-25,1925,2007,1925,1978,15257949,589,8,11329108,3928841,1053,3,8962123,6295826,2366985,-2366985
2021-05-26,1917,2016,1917,1988,11477315,505,8,9735182,1742133,1360,3,7225091,4252224,2510091,-2510091
2021-05-29,2001,2091,2001,2091,23807862,164,3,17778589,6029273,633,9,4266501,19541361,13512088,-13512088
2021-05-30,2193,2193,2115,2155,49545730,980,8,40216883,9328847,1466,14,26842436,22703294,13374447,-13374447
2021-05-31,2169,2241,2110,2163,25403471,608,8,10472082,14931389,1193,10,22757737,2645734,-12285655,12285655
2021-06-01,2121,2188,2121,2159,11036805,352,10,4430296,6606509,715,3,9580038,1456767,-5149742,5149742
2021-06-02,2127,2249,2127,2233,16702357,695,7,12936496,3765861,906,4,11456675,5245682,1479821,-1479821
2021-06-07,2233,2275,2220,2258,9268600,623,9,7943600,1325000,794,4,6083227,3185373,1860373,-1860373
2021-06-08,2205,2275,2169,2188,21549623,739,8,12544235,8981105,1007,6,19592751,1932589,-7048516,7048516
2021-06-09,2127,2209,2127,2184,14159841,369,7,6994375,7165466,697,5,11343465,2816376,-4349090,4349090
2021-06-12,2129,2184,2119,2134,10333360,337,8,3514568,6818792,618,3,8711359,1622001,-5196791,5196791
2021-06-13,2089,2186,2089,2138,11205431,436,9,4938869,6266562,711,4,6765253,4440178,-1826384,1826384
2021-06-14,2125,2212,2125,2205,19708669,572,9,12859638,6849031,797,7,11249104,8459565,1610534,-1610534
2021-06-15,2174,2230,2148,2150,18432449,364,11,8800940,9631509,778,6,13678140,4754309,-4877200,4877200
2021-06-16,2127,2201,2127,2188,17390932,329,11,4426139,12964793,814,3,9190932,8200000,-4764793,4764793
2021-06-19,2169,2292,2169,2292,55956540,1007,14,37146857,18809683,1231,13,20841540,35115000,16305317,-16305317
2021-06-20,2298,2311,2235,2266,22744282,981,7,11536306,11207976,971,9,17291703,5452579,-5755397,5755397
2021-06-21,2237,2304,2237,2294,45232297,1127,9,9401785,35830512,820,6,13224814,32007483,-3823029,3823029
2021-06-22,2296,2344,2254,2334,21593318,1004,11,17102085,4491233,961,8,17802864,3790454,-700779,700779
2021-06-23,2296,2418,2296,2418,74474963,942,21,42867128,31607835,1514,19,36950933,37524030,5916195,-5916195
2021-06-26,2481,2521,2418,2458,60215914,2239,12,46923911,13292003,1964,18,33300180,26915734,13623731,-13623731
2021-06-27,2403,2546,2403,2464,27942565,1367,17,15847644,12094921,1690,9,23240994,4701571,-7393350,7393350
2021-06-28,2426,2485,2382,2473,26490881,960,19,16337343,10153538,1483,7,23549705,2941176,-7212362,7212362
2021-06-29,2435,2536,2426,2481,22813559,814,13,12369010,10444549,1109,12,15994143,6819416,-3625133,3625133
2021-06-30,2481,2517,2468,2517,30060755,896,23,19848409,10212346,1246,8,18060086,12000669,1788323,-1788323
2021-07-03,2475,2515,2401,2401,23035943,678,16,10243325,12792618,1342,8,19967792,3068151,-9724467,9724467
2021-07-04,2433,2492,2382,2452,15179160,556,22,6468168,8710992,939,3,12592453,2586707,-6124285,6124285
2021-07-05,2428,2551,2428,2527,17158325,744,13,13617255,3541070,1191,4,12519164,4639161,1098091,-1098091
2021-07-06,2576,2624,2536,2624,31749771,363,4,30632050,1117721,1328,7,11239799,20509972,19392251,-19392251
2021-07-07,2723,2753,2666,2721,119113281,2845,29,98851844,20261437,3663,35,86738269,32375012,12113575,-12113575
2021-07-10,2725,2728,2631,2696,22054602,1039,26,13471567,8583035,1782,8,19989478,2065124,-6517911,6517911
2021-07-11,2612,2795,2612,2753,34132359,1356,19,21382742,12749617,1733,6,29870646,4261713,-8487904,8487904
2021-07-12,2719,2862,2719,2793,45341832,1404,20,18020365,27321467,2370,20,35154349,10187483,-17133984,17133984
2021-07-13,2744,2848,2744,2765,22793610,888,12,11792924,11000686,1672,15,19699423,3094187,-7906499,7906499
2021-07-14,2742,2780,2696,2757,40908392,1107,17,19030113,21878279,1625,7,26768765,14139627,-7738652,7738652
2021-07-17,2845,2848,2696,2717,26442434,1247,19,17638600,8803834,1313,8,24121325,2321109,-6482725,6482725
2021-07-18,2736,2736,2677,2711,34887705,808,18,12429211,22458494,1858,12,25262705,9625000,-12833494,12833494
2021-07-19,2692,2749,2658,2717,59621943,915,21,16911446,42710497,1356,10,18572905,41049038,-1661459,1661459
2021-07-26,2738,2784,2728,2746,23221571,930,17,14311996,8909575,1468,4,18251910,4969661,-3939914,3939914
2021-07-27,2749,2751,2685,2694,19723712,617,19,10852743,8870969,1222,6,18417522,1306190,-7564779,7564779
2021-07-28,2675,2784,2675,2770,29473721,683,22,12924514,16549207,1559,9,21549227,7924494,-8624713,8624713
2021-07-31,2753,2890,2753,2890,42337817,501,7,31398918,10938899,2050,17,25625131,16712686,5773787,-5773787
2021-08-01,3010,3010,2909,2926,60671343,1947,20,40068343,20603000,2662,16,42221976,18449367,-2153633,2153633
2021-08-02,2926,3073,2923,2974,28159969,1504,13,23498868,4661101,2272,10,23221731,4938238,277137,-277137
2021-08-03,2959,3052,2930,3016,32274534,1183,23,19316942,12957592,2176,14,23963307,8311227,-4646365,4646365
2021-08-04,3018,3168,3018,3168,125292500,2314,36,89281298,36011202,4360,38,52381320,72911180,36899978,-36899978
2021-08-07,3191,3244,3075,3109,44070334,2265,22,27715306,16355028,2843,13,40791107,3279227,-13075801,13075801
2021-08-08,3092,3214,3079,3140,34135532,1660,21,20776545,13358987,2429,10,27858352,6277180,-7081807,7081807
2021-08-09,3123,3218,3117,3172,29823773,1370,22,13106727,16717046,1948,16,22991899,6831874,-9885172,9885172
2021-08-10,3191,3273,3149,3269,48148247,1328,24,16220645,31927602,2474,14,37722964,10425283,-21502319,21502319
2021-08-11,3281,3376,3227,3376,86980138,1875,27,37859765,49120373,4156,27,51811864,35168274,-13952099,13952099
2021-08-14,3374,3423,3307,3391,40264403,2071,24,17307871,22956532,3202,15,35209765,5054638,-17901894,17901894
2021-08-15,3307,3511,3307,3475,37123230,1662,20,17693515,19429715,2377,17,23982337,13140893,-6288822,6288822
2021-08-22,3393,3454,3372,3429,50455453,2421,27,28290718,22164735,3617,15,42971635,7483818,-14680917,14680917
2021-08-23,3370,3429,3336,3391,33376754,1563,22,17358203,16018551,2614,10,24328772,9047982,-6970569,6970569
2021-08-24,3370,3507,3353,3496,45904445,1597,23,14241959,31662486,2315,24,23209146,22695299,-8967187,8967187
2021-08-25,3460,3576,3374,3492,44200198,1689,16,23674807,20525391,2687,20,30441430,13758768,-6766623,6766623
2021-08-28,3477,3581,3477,3549,33200779,1811,24,17674373,15526406,2507,16,21028879,12171900,-3354506,3354506
2021-08-29,3545,3648,3437,3496,51936390,1732,30,21792474,30143916,3656,23,40811576,11124814,-19019102,19019102
2021-08-30,3370,3496,3370,3370,73056129,1102,18,11671156,61384973,2658,14,58715161,14340968,-47044005,47044005
2021-08-31,3214,3393,3208,3210,80569139,2074,23,29738437,50830702,2633,17,37324982,43244157,-7586545,7586545
2021-09-01,3142,3391,3142,3330,28572396,1406,22,19195032,9377364,1105,8,17470424,11101972,1724608,-1724608
2021-09-04,3349,3389,3290,3359,47912292,1431,13,15810638,32101654,1816,18,29801632,18110660,-13990994,13990994
2021-09-05,3246,3338,3241,3256,44862839,1478,20,13286042,31576797,1510,9,23122924,21739915,-9836882,9836882
2021-09-06,3267,3292,3182,3201,31082619,1270,17,12187239,18895380,2496,11,20043857,11038762,-7856618,7856618
2021-09-07,3178,3231,3111,3119,34155736,1162,20,15957812,18197924,2802,11,27140561,7015175,-11182749,11182749
2021-09-08,3111,3201,3111,3159,25977850,1114,13,14580239,11397611,2951,11,12090022,13887828,2490217,-2490217
2021-09-11,3182,3252,3142,3172,27374657,1180,17,17026990,10347667,1344,10,14958812,12415845,2068178,-2068178
2021-09-12,3172,3172,3054,3128,40585375,992,18,5787941,34797434,1630,10,28220377,12364998,-22432436,22432436
2021-09-13,3054,3180,3054,3153,17736203,680,15,7068461,10667742,1725,6,12211929,5524274,-5143468,5143468
2021-09-14,3159,3239,3107,3182,24420404,960,18,15742670,8677734,1636,11,12717343,11703061,3025327,-3025327
2021-09-15,3161,3180,3100,3138,17865233,628,15,8158476,9706757,2229,4,12598047,5267186,-4439571,4439571
2021-09-18,3077,3174,2999,3001,23182969,691,17,4853860,18329109,1265,5,15968072,7214897,-11114212,11114212
2021-09-19,2991,3022,2921,2947,30188698,613,24,7470105,22718593,1571,10,19580854,10607844,-12110749,12110749
2021-09-20,2951,3052,2944,2947,25116064,775,18,7814114,17301950,881,8,11163473,13952591,-3349359,3349359
2021-09-21,2970,3029,2856,2928,20267029,510,17,4846104,15420925,1275,9,13359247,6907782,-8513143,8513143
2021-09-22,2885,2980,2841,2932,16362998,940,18,9031655,7331343,1249,12,9211359,7151639,-179704,179704
2021-09-25,3008,3052,2980,3052,36555512,844,16,23157074,13398438,941,15,6729314,29826198,16427760,-16427760
2021-09-26,3113,3204,3052,3204,31533834,1364,14,23695874,7837960,1906,13,23904552,7629282,-208678,208678
2021-09-28,3231,3263,3185,3197,21257364,1339,13,17218499,4038865,1462,3,16834931,4422433,383568,-383568
2021-09-29,3128,3374,3128,3374,59523019,2034,26,32986642,26536377,3757,23,35079673,24443346,-2093031,2093031
2021-10-02,3454,3528,3433,3528,78522609,2049,20,48259370,30263239,3690,24,34796208,43726401,13463162,-13463162
2021-10-03,3433,3568,3423,3475,44186990,1525,22,18237767,25949223,3497,12,40090702,4096288,-21852935,21852935
2021-10-04,3391,3515,3380,3412,35500333,1126,24,12058523,23441810,2224,14,24178311,11322022,-12119788,12119788
2021-10-06,3473,3503,3416,3450,18964111,755,12,9883063,9081048,1879,6,15075801,3888310,-5192738,5192738
2021-10-09,3414,3496,3292,3300,23054315,793,20,8899855,14154460,1576,4,22007800,1046515,-13107945,13107945
2021-10-10,3305,3393,3265,3380,16773079,730,15,7607791,9165288,1279,2,14473079,2300000,-6865288,6865288
2021-10-11,3380,3429,3332,3353,18066439,708,16,5711728,12354711,1265,11,9352726,8713713,-3640998,3640998
2021-10-12,3307,3349,3212,3239,20847372,588,16,9300801,11546571,1332,9,15240986,5606386,-5940185,5940185
2021-10-13,3206,3347,3128,3185,19977746,529,10,5997930,13979816,1077,4,15617918,4359828,-9619988,9619988
2021-10-16,3328,3334,3254,3334,14932010,349,4,11615010,3317000,955,13,6875540,8056470,4739470,-4739470
2021-10-17,3391,3395,3324,3328,16196842,649,10,4651350,11545492,1252,8,12809742,3387100,-8158392,8158392
2021-10-18,3227,3412,3227,3374,21787220,497,16,5734540,16052680,1164,10,13571399,8215821,-7836859,7836859
2021-10-19,3372,3501,3364,3414,30594473,916,20,18537542,12056931,2263,22,19766841,10827632,-1229299,1229299
2021-10-20,3412,3475,3349,3372,11482776,613,11,5718708,5764068,1047,6,10285659,1197117,-4566951,4566951
2021-10-23,3229,3279,3229,3235,25560661,731,15,6969789,18590872,936,9,18535456,7025205,-11565667,11565667
2021-10-25,3138,3279,3117,3199,15285273,476,16,5107214,10178059,1099,12,10271853,5013420,-5164639,5164639
2021-10-26,3136,3244,3134,3218,7932948,476,11,3770687,4162261,960,4,6821965,1110983,-3051278,3051278
2021-10-27,3161,3288,3159,3233,9106200,457,13,5152163,3955037,862,6,6578836,2528364,-1426673,1426673
2021-10-27,3185,3185,3185,3185,1000,457,13,5152163,3955037,862,6,6578836,2528364,-1426673,1426673
2021-10-30,3168,3229,3117,3153,12457496,502,12,3526793,8930703,1237,5,11587284,870212,-8060491,8060491
2021-10-31,3060,3136,2984,2989,28417963,620,20,5166266,23251697,1276,18,17726746,10691217,-12560480,12560480
2021-11-01,2991,3151,2991,3054,17118497,1007,9,13379183,3739314,828,9,14367719,2750778,-988536,988536
2021-11-02,3054,3176,3052,3107,13958301,663,13,7439123,6519178,701,9,8096389,5861912,-657266,657266
2021-11-03,3111,3273,3111,3254,47351134,802,19,14925144,32425990,1163,13,13970303,33380831,954841,-954841
2021-11-06,3204,3343,3204,3307,26482517,1092,10,19682717,6799800,1186,13,14316703,12165814,5366014,-5366014
2021-11-07,3273,3391,3189,3201,24913166,899,12,10638605,14274561,1150,9,18463072,6450094,-7824467,7824467
2021-11-08,3197,3338,3197,3286,9507749,582,9,4942618,4565131,849,10,8429258,1078491,-3486640,3486640
2021-11-09,3286,3429,3265,3288,27371442,1162,13,17724833,9646609,1634,16,14808751,12562691,2916082,-2916082
2021-11-10,3338,3423,3319,3368,16592298,837,15,9544012,7048286,1163,10,12784132,3808166,-3240120,3240120
2021-11-13,3303,3345,3248,3269,13236455,553,17,5732824,7503631,1075,5,10056368,3180087,-4323544,4323544
2021-11-14,3288,3357,3220,3258,6785975,473,10,3286088,3499887,889,9,5773297,1012678,-2487209,2487209
2021-11-15,3288,3288,3174,3191,7083093,399,14,2987183,4095910,769,4,5665123,1417970,-2677940,2677940
2021-11-16,3208,3244,3138,3151,8079093,645,8,5777359,2301734,651,9,6767098,1311995,-989739,989739
2021-11-17,3159,3250,3140,3170,7979659,498,12,3823390,4156269,679,9,6428370,1551289,-2604980,2604980
2021-11-20,3109,3109,3018,3067,12450849,884,11,7485620,4965229,698,4,11868135,582714,-4382515,4382515
2021-11-21,3012,3142,3012,3075,17954893,1017,7,11874872,6080021,746,11,9875248,8079645,1999624,-1999624
2021-11-22,3096,3197,3075,3151,15582813,1051,12,11205649,4377164,798,10,8535231,7047582,2670418,-2670418
2021-11-23,3094,3185,3043,3105,11791890,728,10,5259424,6532466,836,14,7320997,4470893,-2061573,2061573
2021-11-24,3096,3111,3033,3098,13092520,616,15,5355685,7736835,730,18,7937013,5155507,-2581328,2581328
2021-11-27,3020,3043,2919,2921,29316428,1409,30,12835553,16480875,918,14,23345130,5971298,-10509577,10509577
2021-11-28,2930,3052,2907,3003,14248699,620,9,11084281,3164418,946,19,10681253,3567446,403028,-403028
2021-11-29,2989,3073,2982,3001,13383472,474,13,6893619,6489853,695,7,6953229,6430243,-59610,59610
2021-11-30,2991,3065,2972,3041,12248419,405,8,6345176,5903243,821,7,9817570,2430849,-3472394,3472394
2021-12-01,2980,3033,2875,2959,14703324,705,15,5807258,8896066,632,9,9942619,4760705,-4135361,4135361
2021-12-04,2951,3012,2881,3010,12216024,544,9,6964637,5251387,1077,9,10222901,1993123,-3258264,3258264
2021-12-05,3012,3079,2987,3037,16934508,696,15,8547604,8386904,783,16,7688690,9245818,858914,-858914
2021-12-06,3041,3094,3012,3058,10204402,410,10,5663195,4541207,730,13,6181967,4022435,-518772,518772
2021-12-07,3052,3092,3001,3086,8279398,248,10,4328089,3951309,663,9,6379398,1900000,-2051309,2051309
2021-12-08,3035,3201,3035,3178,13591862,480,13,4957235,8634627,1037,11,7142333,6449529,-2185098,2185098
2021-12-11,3170,3208,3107,3170,7505100,350,8,4293188,3211912,846,6,5735887,1769213,-1442699,1442699
2021-12-14,3050,3140,2993,3075,14488097,346,9,3208185,11279912,660,9,9291910,5196187,-6083725,6083725
2021-12-15,3077,3096,2989,3075,15111388,425,12,3660502,11450886,780,12,9902182,5209206,-6241680,6241680
2021-12-18,2991,3134,2991,3073,11997837,380,5,3438337,8559500,667,9,6865526,5132311,-3427189,3427189
2021-12-19,3117,3117,2961,3003,8569368,328,11,3805771,4763597,568,3,7094036,1475332,-3288265,3288265
2021-12-20,3008,3073,2970,3025,15483277,463,14,7153709,8329568,592,4,14163277,1320000,-7009568,7009568
2021-12-21,3006,3115,3006,3100,19438878,294,13,7127953,12310925,555,10,8706443,10732435,-1578490,1578490
2021-12-22,3075,3233,3075,3233,32762837,728,13,18521150,14241687,1051,18,13744368,19018469,4776782,-4776782
2021-12-25,3227,3307,3170,3229,21985160,760,15,10555110,11430050,1127,12,16840697,5144463,-6285587,6285587
2021-12-26,3199,3244,3161,3241,14142260,434,15,4286618,9855642,803,9,9719656,4422604,-5433038,5433038
2021-12-27,3220,3349,3218,3281,12682490,465,11,5905604,6776886,854,6,8876747,3805743,-2971143,2971143
2021-12-28,3254,3307,3212,3263,13132120,456,12,5419641,7712479,669,9,7613841,5518279,-2194200,2194200
2021-12-29,3254,3273,3134,3218,21161432,563,20,4383128,16778304,783,7,16403418,4758014,-12020290,12020290
2022-01-01,3119,3222,3088,3170,11861923,533,11,4705720,7156203,610,5,6693856,5168067,-1988136,1988136
2022-01-02,3119,3159,3096,3136,6787829,431,11,2973136,3814693,508,6,4841229,1946600,-1868093,1868093
2022-01-03,3111,3145,3077,3079,8013498,378,12,2003690,6009808,435,10,3534930,4478568,-1531240,1531240
2022-01-04,3075,3111,3012,3050,10155298,324,11,1992520,8162778,426,6,5548677,4606621,-3556157,3556157
2022-01-05,3035,3138,3022,3075,13873846,372,16,3424343,10449503,547,10,10484308,3389538,-7059965,7059965
2022-01-08,3043,3075,3012,3029,8725684,446,11,3592091,5133593,573,8,5777686,2947998,-2185595,2185595
2022-01-09,3022,3022,2892,2913,25126161,949,19,9807938,15318223,571,7,21966767,3159394,-12158829,12158829
2022-01-10,2885,2966,2864,2936,8648684,584,10,4605118,4043566,553,6,6099914,2548770,-1494796,1494796
2022-01-11,2949,2984,2902,2923,7559560,559,10,3676367,3883193,419,8,3673261,3886299,3106,-3106
2022-01-12,2904,2995,2904,2934,14439198,416,9,4101666,10337532,464,11,8855382,5583816,-4753716,4753716
2022-01-15,2934,2991,2871,2888,6857628,474,8,4490618,2367010,458,4,6661955,195673,-2171337,2171337
2022-01-16,2885,2907,2803,2852,9414481,466,11,3152979,6261502,570,9,6263687,3150794,-3110708,3110708
2022-01-17,2843,2907,2757,2761,7554099,560,10,3662912,3891187,515,5,5750437,1803662,-2087525,2087525
2022-01-18,2755,2801,2666,2723,25299895,793,15,7758481,17541414,771,10,21000453,4299442,-13241972,13241972
2022-01-19,2643,2780,2643,2768,8295593,418,4,5466152,2829441,600,8,6287372,2008221,-821220,821220
2022-01-22,2776,2843,2688,2755,12598581,428,9,9618722,2979859,634,8,11015900,1582681,-1397178,1397178
2022-01-23,2702,2740,2618,2669,20159032,497,13,8588263,11570769,564,14,11466129,8692903,-2877866,2877866
2022-01-24,2622,2675,2546,2549,13991156,441,7,5066441,8924715,554,7,12929335,1061821,-7862894,7862894
2022-01-25,2561,2620,2475,2508,39108846,754,17,17477092,21631754,665,16,24692097,14416749,-7215005,7215005
2022-01-26,2527,2635,2527,2635,19173669,513,7,14901161,4272508,678,9,17270465,1903204,-2369304,2369304
2022-01-29,2717,2753,2696,2753,8903480,176,4,7552900,1350580,446,5,5322264,3581216,2230636,-2230636
2022-01-30,2877,2877,2822,2877,19985954,758,10,16104268,3881686,930,13,15037802,4948152,1066466,-1066466
2022-01-31,2867,2944,2858,2885,14737562,629,9,6382749,8354813,607,5,12309627,2427935,-5926878,5926878
2022-02-01,2900,2934,2858,2860,10294197,369,8,4701743,5592454,529,7,8025935,2268262,-3324192,3324192
2022-02-02,2877,2885,2839,2879,6628595,241,5,3026840,3601755,509,5,4810237,1818358,-1783397,1783397
2022-02-05,2892,2926,2824,2839,8647245,341,6,3469262,5177983,515,6,5957192,2690053,-2487930,2487930
2022-02-06,2862,2864,2721,2721,17945851,566,10,5237702,12708149,484,10,14213824,3732027,-8976122,8976122
2022-02-07,2746,2770,2692,2711,11594505,335,7,4382149,7212356,546,5,8605494,2989011,-4223345,4223345
2022-02-08,2730,2801,2723,2730,8857663,309,5,4079244,4778419,445,7,4913403,3944260,-834159,834159
2022-02-09,2746,2753,2713,2715,11307082,378,7,4152728,7154354,626,7,10076416,1230666,-5923688,5923688
2022-02-12,2736,2799,2725,2799,10808888,181,6,2267320,8541568,589,10,7748983,3059905,-5481663,5481663
2022-02-13,2746,2776,2696,2717,7253472,292,4,2513187,4740285,344,8,3435473,3817999,-922286,922286
2022-02-14,2654,2751,2654,2717,5337087,321,5,3596504,1740583,315,7,2906566,2430521,689938,-689938
2022-02-16,2688,2738,2688,2698,4393854,310,7,2582620,1811234,351,6,2199283,2194571,383337,-383337
2022-02-19,2700,2753,2664,2698,8811763,477,6,6433621,2378142,481,8,5531336,3280427,902285,-902285
2022-02-20,2666,2728,2601,2622,9688635,581,9,7563545,2125090,392,1,6046839,3641796,1516706,-1516706
2022-02-21,2633,2658,2601,2612,12840347,622,6,10502943,2337404,397,10,7035895,5804452,3467048,-3467048
2022-02-22,2622,2654,2591,2647,11595148,493,10,9206669,2388479,421,6,7402148,4193000,1804521,-1804521
2022-02-23,2620,2673,2614,2645,12611855,546,5,8616445,3995410,433,11,4399208,8212647,4217237,-4217237
2022-02-26,2652,2717,2637,2656,12986604,547,4,9569223,3417381,573,8,6708926,6277678,2860297,-2860297
2022-02-27,2683,2683,2654,2666,10622161,366,5,7700161,2922000,437,5,5722161,4900000,1978000,-1978000
2022-02-28,2675,2749,2675,2706,13801031,637,3,11510297,2290734,556,9,5725621,8075410,5784676,-5784676
2022-03-02,2753,2822,2753,2768,17316129,847,2,17046129,270000,766,8,9839784,7476345,7206345,-7206345
2022-03-05,2843,2913,2839,2858,33132751,994,12,26382552,6750199,1013,15,18952552,14180199,7430000,-7430000
2022-03-06,2907,2995,2885,2995,24649904,766,13,15833777,8816127,1035,9,12422235,12227669,3411542,-3411542
2022-03-07,3012,3102,2970,3054,43952755,1121,15,32960719,10992036,1483,24,22098540,21854215,10862179,-10862179
2022-03-08,3075,3134,3025,3092,16585724,619,7,10473769,6111955,1003,6,14765434,1820290,-4291665,4291665
2022-03-09,3060,3140,3060,3081,22822924,710,10,12107766,10715158,799,11,11374111,11448813,733655,-733655
2022-03-12,3071,3079,3029,3067,25582264,898,13,17091906,8490358,1044,6,14587606,10994658,2504300,-2504300
2022-03-16,3084,3097,3084,3097,4754207,164,3,1941050,2813157,105,1,4454207,300000,-2513157,2513157
2022-03-19,3135,3135,3053,3075,29063800,1261,20,15267898,13795902,622,7,17022822,12040978,-1754924,1754924
2022-03-26,3101,3208,3075,3184,12163322,668,9,8587366,3575956,564,3,9013500,3149822,-426134,426134
2022-03-27,3148,3274,3148,3233,11946305,673,7,5498178,6448127,460,5,9254622,2691683,-3756444,3756444
2022-03-28,3208,3281,3208,3255,12677781,863,5,9788024,2889757,519,5,9699341,2978440,88683,-88683
2022-03-29,3255,3293,3174,3179,12946200,626,9,5802909,7143291,589,6,11287459,1658741,-5484550,5484550
2022-03-30,3165,3238,3135,3216,13963321,841,11,10401033,3562288,536,4,12760592,1202729,-2359559,2359559
2022-04-03,3216,3349,3216,3325,21458646,827,11,15552047,5906599,861,15,13089986,8368660,2462061,-2462061
2022-04-04,3315,3366,3208,3242,20462993,785,14,8974762,11488231,791,13,11976587,8486406,-3001825,3001825
2022-04-05,3233,3262,3201,3235,17991605,801,12,11421036,6570569,545,7,9230650,8760955,2190386,-2190386
2022-04-06,3233,3257,3179,3204,14966574,581,11,10017786,4948788,596,9,11229820,3736754,-1212034,1212034
2022-04-09,3182,3242,3145,3228,12683423,498,18,7201395,5482028,572,10,8419150,4264273,-1217755,1217755
2022-04-10,3213,3267,3213,3247,16705548,593,13,7471059,9234489,504,10,6151676,10553872,1319383,-1319383
2022-04-11,3267,3342,3250,3306,14116110,660,10,8001929,6114181,765,7,11818619,2297491,-3816690,3816690
2022-04-12,3301,3301,3189,3194,14124787,418,9,5947269,8177518,717,5,13337936,786851,-7390667,7390667
2022-04-13,3177,3291,3177,3267,9567230,355,10,5010273,4556957,549,6,7484562,2082668,-2474289,2474289
2022-04-16,3276,3323,3252,3284,16210094,501,11,8206712,8003382,681,9,10982942,5227152,-2776230,2776230
2022-04-17,3325,3444,3286,3444,32359816,1127,16,24115107,8244709,1333,12,23501323,8858493,613784,-613784
2022-04-18,3495,3578,3454,3473,22510324,1058,20,13008006,9502318,1084,17,12815049,9695275,192957,-192957
2022-04-19,3466,3529,3427,3488,17478890,956,12,11371909,6106981,875,3,12312638,5166252,-940729,940729
2022-04-20,3507,3507,3432,3476,17472115,673,10,14646086,2887189,783,8,15506831,2026444,-860745,860745
2022-04-24,3454,3498,3447,3447,17584320,515,6,10009644,7574676,748,9,11249967,6334353,-1240323,1240323
2022-04-25,3432,3437,3391,3420,12609971,735,15,7391335,5218636,734,5,10231746,2378225,-2840411,2840411
2022-04-26,3408,3498,3405,3437,11400996,737,5,9401405,1999591,633,9,6540801,4860195,2860604,-2860604
2022-04-27,3449,3461,3403,3408,10961053,1038,11,6584871,4376182,812,9,7008330,3952723,-423459,423459
2022-04-30,3403,3471,3376,3449,25082355,750,15,13345999,11736356,950,7,12069966,13012389,1276033,-1276033
2022-05-01,3444,3451,3381,3400,11350929,836,13,7392378,3958551,614,5,5071673,6279256,2320705,-2320705
2022-05-02,3381,3459,3381,3459,7929751,478,9,5416664,2513087,600,5,5294973,2634778,121691,-121691
2022-05-07,3459,3551,3420,3456,25346372,969,16,20540468,4805904,817,12,10125082,15221290,10415386,-10415386
2022-05-08,3432,3476,3430,3437,16767886,688,13,8331080,8436806,796,7,11929606,4838280,-3598526,3598526
2022-05-09,3434,3454,3369,3400,15871102,702,18,9890285,5980817,787,5,13389722,2481380,-3499437,3499437
2022-05-10,3398,3449,3311,3413,23253118,809,17,17868118,5385000,689,12,12091934,11161184,5776184,-5776184
2022-05-11,3393,3590,3393,3590,52772123,981,29,38494089,14278034,1475,19,22210569,30561554,16283520,-16283520
2022-05-14,3605,3767,3590,3704,47178242,1649,19,36851410,10326832,1816,19,38841667,8336575,-1990257,1990257
2022-05-15,3738,3738,3631,3709,21406913,912,6,15415812,5991101,1207,7,18767822,2639091,-3352010,3352010
2022-05-16,3682,3789,3682,3726,18070343,878,9,11821675,6248668,1245,6,11834519,6235824,-12844,12844
2022-05-17,3697,3884,3697,3748,17072168,812,8,8522731,8549437,1132,8,12499823,4572345,-3977092,3977092
2022-05-18,3750,3750,3658,3673,13294973,604,8,6806142,6488831,914,8,9561673,3733300,-2755531,2755531
2022-05-21,3634,3634,3524,3595,16213231,760,16,7067216,9146015,784,4,15271604,941627,-8204388,8204388
2022-05-22,3561,3648,3561,3643,14941182,881,8,8971037,5970145,720,3,12026703,2914479,-3055666,3055666
2022-05-23,3585,3646,3500,3534,16330781,907,9,8461004,7869777,928,4,15025701,1305080,-6564697,6564697
2022-05-24,3481,3592,3481,3588,10603373,499,9,4433904,6169469,586,4,7636434,2966939,-3202530,3202530
2022-05-25,3529,3670,3529,3575,19495761,1169,11,12207954,7287807,599,9,14464783,5030978,-2256829,2256829
2022-05-28,3643,3699,3524,3571,14351084,518,7,6707387,7643697,779,5,7935614,6415470,-1228227,1228227
2022-05-29,3451,3588,3451,3554,30587237,450,14,6043920,24543317,754,11,11859684,18727553,-5815764,5815764
2022-05-30,3554,3592,3500,3549,10981893,478,14,6579573,4402320,627,6,6836286,4145607,-256713,256713
2022-05-31,3522,3585,3522,3580,15796764,492,10,8871163,6925601,562,11,7232827,8563937,1638336,-1638336
2022-06-01,3573,3575,3490,3520,12028783,557,12,6244251,5784532,480,7,6124434,5904349,119817,-119817
2022-06-06,3500,3517,3359,3391,21481932,616,12,6655188,14826744,830,6,13194254,8287678,-6539066,6539066
2022-06-07,3379,3413,3362,3381,16114043,467,9,6640458,9473585,521,7,8383006,7731037,-1742548,1742548
2022-06-08,3459,3459,3393,3449,15209657,321,9,4090849,11118808,546,10,8465408,6744249,-4374559,4374559
2022-06-11,3400,3439,3400,3410,13735163,298,10,5833759,7901404,645,6,8413528,5321635,-2579769,2579769
2022-06-12,3403,3592,3403,3556,21984471,528,15,13905975,8078496,899,12,14959540,7024931,-1053565,1053565
2022-06-13,3532,3699,3532,3699,39029601,768,17,17148135,21881466,1358,16,20105461,18924140,-2957326,2957326
2022-06-14,3724,3729,3648,3678,13100145,640,11,8339123,4761022,806,8,11721686,1378459,-3382563,3382563
2022-06-15,3646,3670,3617,3646,10105706,239,12,2746048,7359658,587,5,7726036,2379670,-4979988,4979988
2022-06-18,3639,3643,3575,3626,9522163,191,13,2164471,7357692,704,4,8378816,1143347,-6214345,6214345
2022-06-19,3658,3658,3580,3597,13284086,226,9,5278363,8005723,552,8,7036887,6247199,-1758524,1758524
2022-06-20,3583,3646,3583,3607,19205462,246,11,3942241,15263221,520,9,12836780,6368682,-8894539,8894539
2022-06-21,3622,3622,3541,3546,7704388,271,7,2653451,5050937,401,7,3622197,4082191,-968746,968746
2022-06-22,3524,3568,3493,3529,12945776,224,6,1656016,11289760,487,4,5980857,6964919,-4324841,4324841
2022-06-25,3529,3529,3405,3437,17029186,534,10,6247720,10781466,520,12,7609113,9420073,-1361393,1361393
2022-06-26,3410,3427,3296,3376,23677345,527,12,9244737,14432608,526,14,10898441,12778904,-1653704,1653704
2022-06-27,3354,3379,3320,3379,11149741,507,4,5826957,5322784,478,7,3236725,7913016,2590232,-2590232
2022-06-28,3398,3454,3359,3454,8080495,304,4,5410483,2670012,487,5,4473366,3607129,937117,-937117
2022-06-29,3466,3503,3403,3500,12837094,257,7,2750295,10086799,562,9,4975454,7861640,-2225159,2225159
2022-07-02,3396,3464,3396,3420,6745897,177,5,1358552,5387345,535,3,5631377,1114520,-4272825,4272825
2022-07-03,3396,3466,3396,3449,7928859,200,9,3597755,4331104,460,8,3819969,4108890,-222214,222214
2022-07-04,3500,3505,3427,3430,7860637,305,7,3418330,4442307,390,5,4664533,3196104,-1246203,1246203
2022-07-05,3413,3451,3410,3437,10688415,235,8,5211931,5476484,433,6,4084004,6604411,1127927,-1127927
2022-07-06,3415,3447,3374,3388,8270823,272,7,2459512,5811311,443,7,6846079,1424744,-4386567,4386567
2022-07-09,3381,3413,3379,3405,8452070,205,4,7190574,1261496,544,2,8039242,412828,-848668,848668
2022-07-11,3388,3410,3354,3354,14498276,242,6,5723503,8774773,543,9,8978254,5520022,-3254751,3254751
2022-07-12,3345,3410,3342,3398,9663872,253,8,3787083,5876789,476,7,6300643,3363229,-2513560,2513560
2022-07-13,3403,3444,3398,3410,6111924,201,6,3086507,3025417,412,4,3936924,2175000,-850417,850417
2022-07-16,3381,3410,3376,3381,6743546,178,5,3245469,3498077,455,2,6711174,32372,-3465705,3465705
2022-07-17,3369,3379,3306,3318,5920178,292,4,4313116,1607062,435,5,4724688,1195490,-411572,411572
2022-07-19,3306,3410,3298,3405,6133887,197,8,3326735,2807152,500,7,4975933,1157954,-1649198,1649198
2022-07-20,3374,3437,3374,3417,5242076,188,3,3293903,1948173,408,4,4451624,790452,-1157721,1157721
2022-07-23,3461,3554,3442,3464,9680900,376,8,5903122,3777778,586,7,5744918,3935982,158204,-158204
2022-07-24,3461,3517,3427,3427,14499109,260,10,5368644,9130465,553,13,8529593,5969516,-3160949,3160949
2022-07-25,3410,3451,3379,3383,8135988,242,8,3149211,4986777,442,5,6926896,1209092,-3777685,3777685
2022-07-26,3383,3410,3376,3400,10674551,218,8,2180646,8493905,359,11,6240828,4433723,-4060182,4060182
2022-07-27,3383,3408,3383,3403,13782658,211,13,3509985,10272673,333,6,4162307,9620351,-652322,652322
2022-07-30,3403,3495,3403,3427,11052505,266,6,5315701,5736804,503,11,6732498,4320007,-1416797,1416797
2022-07-31,3405,3488,3379,3447,17528075,228,8,3814247,13713828,629,11,12222738,5305337,-8408491,8408491
2022-08-01,3415,3449,3415,3442,5119185,188,5,3758831,1360354,384,7,4723122,396063,-964291,964291
2022-08-02,3422,3512,3415,3500,17017766,297,12,12329819,4687947,460,5,5403463,11614303,6926356,-6926356
2022-08-03,3476,3512,3456,3500,70220070,309,11,4393413,65826657,367,6,3640698,66579372,752715,-752715
2022-08-06,3466,3583,3466,3578,5799352,322,5,5020090,779262,564,1,5159352,640000,-139262,139262
2022-08-09,3527,3571,3507,3551,5139235,247,5,3971271,1170046,420,4,4281317,860000,-310046,310046
2022-08-10,3505,3554,3505,3522,5365613,156,4,3691567,1674046,390,2,5245613,120000,-1554046,1554046
2022-08-13,3520,3614,3515,3554,13126548,414,10,6410488,6716060,534,6,8489012,4637536,-2078524,2078524
2022-08-14,3515,3585,3503,3532,5647325,244,12,1889695,3757630,424,5,4765892,881433,-2876197,2876197
2022-08-15,3524,3568,3512,3524,6871035,223,11,3476299,3394736,391,2,6002609,868426,-2526310,2526310
2022-08-16,3517,3549,3454,3456,4756834,221,9,2699289,2057545,358,2,4206833,550001,-1507544,1507544
2022-08-17,3466,3510,3439,3476,7714894,243,6,3734803,3980091,400,2,5800121,1914773,-2065318,2065318
2022-08-20,3488,3488,3383,3478,7270205,322,8,4272555,2997650,391,8,5466260,1803945,-1193705,1193705
2022-08-21,3427,3439,3357,3393,12286485,276,10,3214616,9071869,344,6,7775940,4510545,-4561324,4561324
2022-08-22,3371,3422,3371,3398,5489026,177,6,1271679,4217347,307,7,4701927,787099,-3430248,3430248
2022-08-23,3379,3425,3371,3417,5602160,276,7,3657524,1944636,291,5,4637459,964701,-979935,979935
2022-08-24,3427,3447,3403,3425,17218294,297,9,3566736,13651558,300,5,4206112,13012182,-639376,639376
2022-08-27,3447,3524,3405,3466,8261463,266,11,4960997,3300466,456,7,6128697,2132766,-1167700,1167700
2022-08-28,3520,3580,3444,3498,16234682,491,8,8912858,7321824,443,6,3865356,12369326,5047502,-5047502
2022-08-29,3534,3534,3451,3490,9235075,250,8,6611154,2623921,354,5,8281406,953669,-1670252,1670252
2022-08-30,3456,3495,3456,3476,4227943,171,9,1401479,2826464,338,1,4177943,50000,-2776464,2776464
2022-08-31,3464,3583,3444,3500,15872470,479,7,14120280,1752190,470,9,8665932,7206538,5454348,-5454348
2022-09-03,3481,3500,3393,3456,7222295,337,10,2659841,4562454,447,5,6098816,1123479,-3438975,3438975
2022-09-04,3451,3512,3427,3451,7572465,186,8,1517932,6054533,379,5,5687695,1884770,-4169763,4169763
2022-09-05,3464,3473,3449,3456,7192537,128,8,823392,6369145,338,0,7192537,0,-6369145,6369145
2022-09-06,3439,3473,3437,3439,3964257,152,8,1354657,2609600,269,5,3224426,739831,-1869769,1869769
2022-09-07,3430,3471,3425,3425,3872723,162,10,1905522,1967201,336,1,3413032,459691,-1507510,1507510
2022-09-10,3413,3442,3383,3388,10046301,267,11,2234891,7811410,409,5,9616857,429444,-7381966,7381966
2022-09-11,3383,3420,3383,3391,7117084,165,7,1314457,5802627,350,4,5414849,1702235,-4100392,4100392
2022-09-12,3393,3413,3349,3354,15858422,326,10,6610922,9247500,271,5,13640510,2217912,-7029588,7029588
2022-09-13,3359,3425,3354,3383,4950739,367,10,3116062,1834677,273,7,2926907,2023832,189155,-189155
2022-09-14,3403,3415,3364,3403,8095843,191,5,7344343,751500,305,7,5053114,3042729,2291229,-2291229
2022-09-18,3376,3410,3357,3366,10077340,204,11,7590892,2486448,375,5,8949683,1127657,-1358791,1358791
2022-09-19,3354,3400,3345,3347,6804254,239,4,2001536,4802718,274,9,3736975,3067279,-1735439,1735439
2022-09-20,3347,3371,3318,3318,9234334,259,5,2830818,6403516,298,5,6035334,3199000,-3204516,3204516
2022-09-21,3366,3366,3262,3269,7873414,364,6,3621111,4252303,317,8,3724208,4149206,-103097,103097
2022-09-24,3259,3276,3128,3162,14203105,380,8,3861237,10341868,458,7,12424372,1778733,-8563135,8563135
2022-09-26,3157,3306,3155,3298,9618352,227,12,2271111,7347241,333,6,8688083,930269,-6416972,6416972
2022-09-28,3240,3352,3240,3269,2820719,267,5,1805356,1015363,254,1,2570719,250000,-765363,765363
2022-10-01,3235,3238,3162,3165,6964586,274,11,2376302,4588284,365,2,6204678,759908,-3828376,3828376
2022-10-02,3174,3208,3165,3201,7571146,138,12,1459292,6111854,346,4,6294538,1276608,-4835246,4835246
2022-10-03,3194,3291,3162,3255,8953794,173,7,1263001,7690793,463,10,5272543,3681251,-4009542,4009542
2022-10-04,3255,3269,3189,3264,6958578,197,10,2858904,4099674,300,6,5210513,1748065,-2351609,2351609
2022-10-08,3238,3301,3206,3211,4092994,194,13,2201849,1891145,265,5,3695401,397593,-1493552,1493552
2022-10-09,3201,3242,3157,3199,8317270,160,9,1612821,6704449,342,4,7312656,1004614,-5699835,5699835
2022-10-10,3213,3267,3211,3267,9764908,114,11,1719498,8045410,384,5,6550260,3214648,-4830762,4830762
2022-10-11,3233,3313,3230,3308,7095979,130,4,3239380,3856599,315,9,3221772,3874207,17608,-17608
2022-10-12,3269,3366,3269,3354,6783245,142,5,3606565,3176680,346,10,4845935,1937310,-1239370,1239370
2022-10-15,3313,3330,3311,3328,4003512,125,7,1269709,2733803,313,2,3653512,350000,-2383803,2383803
2022-10-16,3281,3325,3267,3298,16933590,115,9,1813612,15119978,336,7,8862097,8071493,-7048485,7048485
2022-10-17,3281,3332,3274,3313,6592527,95,6,341326,6251201,365,3,4098945,2493582,-3757619,3757619
2022-10-18,3306,3342,3306,3330,14563014,119,10,1217076,13345938,266,7,3623540,10939474,-2406464,2406464
2022-10-19,3311,3354,3311,3330,5136557,93,4,1331557,3805000,318,3,4733127,403430,-3401570,3401570
2022-10-22,3330,3330,3279,3279,3538582,170,4,986998,2551584,290,3,3053615,484967,-2066617,2066617
2022-10-23,3293,3306,3264,3272,6727956,126,6,707124,6020832,300,2,5654546,1073410,-4947422,4947422
2022-10-24,3272,3293,3189,3233,7466500,215,9,1825826,5640674,358,6,4303408,3163092,-2477582,2477582
2022-10-25,3211,3269,3155,3157,7938632,272,5,2539231,5399401,464,9,3918136,4020496,-1378905,1378905
2022-10-26,3160,3194,3046,3055,14609652,394,13,3520628,11089024,468,10,12132014,2477638,-8611386,8611386
2022-10-29,3116,3208,3111,3206,23037840,186,7,1627797,21410043,664,12,18731540,4306300,-17103743,17103743
2022-10-30,3143,3230,3140,3155,17156476,291,12,3753690,13402786,354,6,11839389,5317087,-8085699,8085699
2022-10-31,3160,3221,3157,3201,12853812,304,12,5027851,7825961,479,7,9144346,3709466,-4116495,4116495
2022-11-01,3216,3293,3206,3281,11389550,267,4,5338953,6050597,445,9,8118840,3270710,-2779887,2779887
2022-11-02,3257,3259,3221,3250,10670499,188,11,2941812,7728687,357,6,5993004,4677495,-3051192,3051192
2022-11-05,3247,3473,3221,3473,20155011,217,13,9149024,13399128,760,15,7337035,15211117,1811989,-1811989
2022-11-06,3512,3573,3451,3481,9430531,398,8,5094185,4336346,652,14,6597448,2833083,-1503263,1503263
2022-11-07,3520,3765,3481,3765,28962631,399,14,10252272,18710359,1065,12,14627223,14335408,-4374951,4374951
2022-11-08,3797,3957,3719,3743,18655290,580,20,10328198,8327092,1125,20,13604593,5050697,-3276395,3276395
2022-11-09,3792,3935,3719,3889,15736285,389,15,7300753,8435532,1062,9,11499098,4237187,-4198345,4198345
2022-11-12,3879,3940,3857,3889,16840097,296,12,3087976,13752121,863,12,9826531,7013566,-6738555,6738555
2022-11-13,3894,3894,3836,3877,16756284,222,13,2198624,14557660,943,8,11576669,5179615,-9378045,9378045
2022-11-14,3879,3889,3767,3860,11353685,175,14,2035300,9318385,756,8,8715627,2638058,-6680327,6680327
2022-11-15,3887,3891,3838,3879,8215011,187,5,2844477,5370534,587,10,5828643,2386368,-2984166,2984166
2022-11-16,3889,3957,3840,3938,11604094,175,9,1875574,9728520,820,10,7914130,3689964,-6038556,6038556
2022-11-19,3945,3945,3811,3889,11737021,169,10,1888702,9848319,673,10,9147444,2589577,-7258742,7258742
2022-11-20,3831,3921,3826,3879,3103370,204,4,2505663,597707,403,5,2584968,518402,-79305,79305
2022-11-21,3874,3906,3860,3877,15171777,174,11,1658265,13513512,381,6,4468057,10703720,-2809792,2809792
2022-11-22,3848,3911,3848,3884,9753632,160,7,2231415,7522217,388,10,7356366,2397266,-5124951,5124951
2022-11-23,3845,3899,3845,3884,4806428,147,7,1459417,3372011,308,2,4722011,109417,-3262594,3262594
2022-11-26,3889,3918,3860,3884,8062869,176,9,2497671,5565198,442,3,7272990,789879,-4775319,4775319
2022-11-27,3884,3887,3860,3887,5563339,160,6,2473859,3089480,357,5,4010746,1552593,-1536887,1536887
2022-11-28,3855,3911,3855,3872,5941803,168,8,2433955,3507848,356,5,3498934,2442869,-1064979,1064979
2022-11-29,3879,3911,3867,3882,5012585,163,6,1913428,3099157,325,4,4466029,546556,-2552601,2552601
2022-11-30,3860,3884,3860,3879,5517961,150,6,1426649,4091312,284,3,4092378,1425583,-2665729,2665729
2022-12-03,3857,3889,3853,3865,6380460,154,6,1884864,4495596,411,5,5752360,628100,-3867496,3867496
2022-12-04,3855,3862,3821,3850,6367895,194,7,2144217,4223678,349,6,5702890,665005,-3558673,3558673
2022-12-05,3833,3872,3833,3838,9990447,128,12,1178657,8811790,361,8,4955970,5034477,-3777313,3777313
2022-12-06,3828,3872,3823,3857,7517368,109,7,1199548,6317820,411,7,5046613,2470755,-3847065,3847065
2022-12-07,3857,3860,3831,3850,6309553,133,5,709110,5600443,401,6,4358053,1951500,-3648943,3648943
2022-12-10,3838,3850,3748,3782,10553446,183,11,2103365,8450081,465,8,7275263,3278183,-5171898,5171898
2022-12-11,3814,3838,3748,3792,7614886,202,9,1760038,5854848,377,9,6547063,1067823,-4787025,4787025
2022-12-12,3799,3889,3799,3872,10578048,228,6,5531961,5046087,443,11,5997878,4580170,-465917,465917
2022-12-13,3889,4132,3889,4132,33868836,483,9,15064299,18804537,1352,17,16056016,17812820,-991717,991717
2022-12-14,4142,4193,4108,4134,10751966,371,7,3825665,6926301,875,9,8790422,1961544,-4964757,4964757
2022-12-17,4139,4169,4064,4156,9190037,293,7,5173889,4016148,718,6,6717089,2472948,-1543200,1543200
2022-12-18,4144,4346,4144,4283,22508895,464,9,6210235,16298660,999,14,12183179,10325716,-5972944,5972944
2022-12-19,4256,4329,4256,4305,17149275,282,10,1915519,15233756,885,15,11414562,5734713,-9499043,9499043
2022-12-20,4305,4307,4241,4256,19939172,218,8,2848874,17090298,638,10,9267465,10671707,-6418591,6418591
2022-12-21,4241,4353,4241,4297,17200511,208,7,3867721,13332790,731,7,15300292,1900219,-11432571,11432571
2022-12-24,4239,4545,4239,4463,20672470,469,13,8529328,12143142,1011,12,9492539,11179931,-963211,963211
2022-12-25,4533,4642,4463,4642,38447535,497,8,3552708,34894827,1573,17,21444281,17003254,-17891573,17891573
2022-12-26,4640,4703,4477,4694,31338640,525,11,4611841,26726799,1436,19,14203021,17135619,-9591180,9591180
2022-12-28,4577,4949,4577,4949,34022781,657,21,9069945,24952836,2107,18,15384509,18638272,-6314564,6314564
2022-12-31,4562,4771,4560,4596,45961391,1143,13,9446661,36514730,1904,19,36563533,9397858,-27116872,27116872
2023-01-01,4594,4684,4460,4565,31498926,482,11,8430010,23068916,1294,15,18800329,12698597,-10370319,10370319
2023-01-02,4548,4657,4499,4584,14094538,666,16,7511866,6582672,826,10,10455988,3638550,-2944122,2944122
2023-01-03,4553,4618,4521,4545,25672819,449,13,2516410,23156409,800,14,13242599,12430220,-10726189,10726189
2023-01-04,4570,4589,4477,4497,18068034,341,10,1935023,16133011,633,14,8898172,9169862,-6963149,6963149
2023-01-07,4545,4545,4419,4482,17868964,756,11,7268534,10600430,1239,16,11227421,6641543,-3958887,3958887
2023-01-08,4533,4638,4533,4570,35797344,917,13,13268938,22528406,1311,31,11235315,24562029,2033623,-2033623
2023-01-09,4618,4628,4572,4606,25239016,635,18,11362716,13876300,818,14,7927465,17311551,3435251,-3435251
2023-01-10,4630,4728,4611,4650,25550500,612,25,10066505,15483995,893,18,11040158,14510342,-973653,973653
2023-01-11,4635,4635,4516,4519,30009937,428,20,9328878,20681059,796,23,19079156,10930781,-9750278,9750278
2023-01-14,4387,4613,4387,4557,14980320,403,14,3598399,11381921,683,17,6348856,8631464,-2750457,2750457
2023-01-16,4555,4618,4550,4601,34381188,855,30,12450979,21930209,925,15,10077090,24304098,2373889,-2373889
2023-01-17,4574,4633,4536,4560,17794151,516,22,3158861,14635290,928,14,9903380,7890771,-6744519,6744519
2023-01-18,4514,4638,4509,4553,19855621,507,20,6363857,13491764,899,14,6677558,13178063,-313701,313701
2023-01-21,4545,4591,4446,4472,15673557,429,13,5478659,10194898,703,17,9006934,6666623,-3528275,3528275
2023-01-22,4446,4587,4446,4540,12298839,434,14,3381753,8917086,728,16,7744060,4554779,-4362307,4362307
2023-01-23,4536,4618,4521,4543,12963341,384,8,2740118,10223223,725,10,8226737,4736604,-5486619,5486619
2023-01-24,4536,4616,4499,4591,12033816,254,9,3533550,8500266,700,12,9067673,2966143,-5534123,5534123
2023-01-25,4509,4591,4463,4494,15532564,300,10,2698450,12834114,676,9,10162223,5370341,-7463773,7463773
2023-01-28,4492,4519,4475,4494,9079282,292,5,3201861,5877421,727,9,6954673,2124609,-3752812,3752812
2023-01-29,4480,4482,4300,4375,17997373,345,14,3854655,14142718,1028,9,13424265,4573108,-9569610,9569610
2023-01-30,4331,4385,4329,4331,18296526,420,13,4593626,13702900,655,12,6353314,11943212,-1759688,1759688
2023-01-31,4334,4482,4334,4482,12741632,299,8,2035193,10706439,576,16,5434781,7306851,-3399588,3399588
2023-02-01,4480,4480,4375,4412,7941291,186,9,1162733,6778558,407,10,4721639,3219652,-3558906,3558906
2023-02-05,4380,4436,4334,4380,15855695,183,9,1733401,14122294,532,9,7121184,8734511,-5387783,5387783
2023-02-06,4300,4387,4300,4387,7931863,200,5,1341885,6589978,437,6,6770800,1161063,-5428915,5428915
2023-02-07,4375,4436,4368,4409,7083460,254,5,2114823,4968637,368,7,6341551,741909,-4226728,4226728
2023-02-08,4402,4412,4353,4375,25525171,240,8,1152122,24373049,348,12,4381176,21143995,-3229054,3229054
2023-02-12,4363,4373,4312,4370,21437949,279,9,2564572,18873377,473,14,8881595,12556354,-6317023,6317023
2023-02-13,4309,4365,4305,4317,7008078,225,8,1475227,5532851,346,11,4210438,2797640,-2735211,2735211
2023-02-14,4302,4341,4297,4300,11463153,188,15,2045268,9417885,358,13,4248198,7214955,-2202930,2202930
2023-02-15,4292,4300,4234,4244,8195198,217,6,3349540,4845658,395,9,6108879,2086319,-2759339,2759339
2023-02-19,4224,4295,4193,4263,18662716,294,10,7002103,11660613,572,10,11880406,6782310,-4878303,4878303
2023-02-20,4273,4540,4273,4540,62367216,738,22,34768426,27598790,780,21,6650181,55717035,28118245,-28118245
2023-02-21,4621,4849,4596,4788,53955712,1098,25,24844709,29111003,1447,17,23685933,30269779,1158776,-1158776
2023-02-22,4796,4873,4708,4861,37811109,558,12,9378186,28432923,1195,20,14697083,23114026,-5318897,5318897
2023-02-25,4929,5129,4929,5129,52130490,822,20,23041278,29089212,1080,16,11776176,40354314,11265102,-11265102
2023-02-26,5483,5483,5294,5362,80859029,1468,19,24429092,56429937,2255,29,44810224,36048805,-20381132,20381132
2023-02-27,5352,5629,5228,5476,37996704,803,14,12343926,25652778,1622,18,24023475,13973229,-11679549,11679549
2023-02-28,5457,5508,5384,5462,41404226,751,15,13780454,27623772,1127,25,21911071,19493155,-8130617,8130617
2023-03-01,5372,5428,5219,5308,37767011,529,13,5901437,31865574,1006,12,20452393,17314618,-14550956,14550956
2023-03-04,5330,5420,5155,5299,20164917,488,10,9527843,10637074,988,12,13251694,6913223,-3723851,3723851
2023-03-05,5299,5505,5299,5432,10410862,400,7,3773653,6637209,794,10,7902484,2508378,-4128831,4128831
2023-03-06,5432,5539,5333,5498,15646128,369,6,4099822,11546306,831,9,13785690,1860438,-9685868,9685868
2023-03-07,5498,5590,5457,5549,17779281,664,8,8226777,9552504,871,15,11331023,6448258,-3104246,3104246
2023-03-11,5537,5600,5437,5437,22208587,555,7,7464143,14744444,868,15,15565879,6642708,-8101736,8101736
2023-03-12,5469,5586,5418,5435,18816552,369,11,7073108,11743444,914,11,12023424,6793128,-4950316,4950316
2023-03-13,5435,5469,5403,5420,16194250,395,7,5552711,10641539,1061,6,6305705,9888545,-752994,752994
2023-03-14,5491,5491,5408,5430,12521954,405,11,2772772,9749182,1506,13,5610974,6910980,-2838202,2838202
2023-03-15,5469,5807,5469,5804,34101434,980,20,11221414,22880020,984,15,20882654,13218780,-9661240,9661240
2023-03-18,5809,6086,5802,6086,37102735,770,20,12460346,24642389,937,14,15577328,21525407,-3116982,3116982
2023-03-19,6295,6439,6052,6235,26473465,997,16,7111013,19362452,994,15,10293456,16180009,-3182443,3182443
2023-03-25,6237,6237,5962,6016,13002564,1132,7,7812578,5189986,943,5,12261625,740939,-4449047,4449047
2023-03-26,6004,6213,5936,5987,11322421,761,8,4939967,6382454,942,9,9196885,2125536,-4256918,4256918
2023-03-27,6096,6096,5894,5991,17317607,1083,9,7370874,9946733,806,13,12648757,4668850,-5277883,5277883
2023-03-28,5991,6074,5919,5933,11931626,976,10,5439483,6492143,746,8,9165500,2766126,-3726017,3726017
2023-03-29,6004,6077,5868,5967,10972795,998,16,7379458,3593337,852,6,8273340,2699455,-893882,893882
2023-04-03,5860,6101,5804,5962,13096191,921,12,7806911,5289280,979,7,11626451,1469740,-3819540,3819540
2023-04-04,6047,6220,5955,5982,8092851,696,11,4299652,3793199,962,8,6356799,1736052,-2057147,2057147
2023-04-05,5846,6147,5846,6028,8889809,736,11,5341097,3548712,803,9,4162883,4726926,1178214,-1178214
2023-04-08,5923,6269,5923,6179,16757985,1141,18,8850548,7907437,1222,13,11894332,4863653,-3043784,3043784
2023-04-09,6176,6198,6089,6130,15342183,944,11,7667548,7674635,1000,9,9850523,5491660,-2182975,2182975
2023-04-10,6101,6273,6040,6077,19565554,673,8,3498601,16066953,1108,15,13043076,6522478,-9544475,9544475
2023-04-11,6077,6295,6004,6295,17038748,616,12,4808956,12229792,975,6,16073977,964771,-11265021,11265021
2023-04-15,6312,6587,6273,6563,33251310,1657,9,22104368,11146942,1491,12,14100279,19151031,8004089,-8004089
2023-04-17,6718,6993,6718,6837,27569339,1420,12,12922140,14647199,1027,14,19456742,8112597,-6534602,6534602
2023-04-18,7029,7292,6915,7287,57803795,2093,13,18330404,39473391,1936,23,37812787,19991008,-19482383,19482383
2023-04-25,7285,7285,6952,7113,6625125,289,7,2082412,4542713,245,4,6176579,448546,-4094167,4094167
2023-04-26,7036,7129,6865,6941,33620933,1616,15,12737982,20882951,1584,8,23663653,9957280,-10925671,10925671
2023-04-29,6957,7287,6944,7256,28496457,1123,15,9463015,19033442,1216,18,20858640,7637817,-11395625,11395625
2023-04-30,7366,7366,7155,7274,57991421,2106,17,9918705,48072716,1452,21,25250159,32741262,-15331454,15331454
2023-05-01,7380,7380,7079,7250,16854935,1013,9,4771394,12083541,1225,8,15045565,1809370,-10274171,10274171
2023-05-02,7250,7300,7131,7190,12905145,1122,12,5548946,7356199,1193,4,12182189,722956,-6633243,6633243
2023-05-03,7155,7314,7023,7153,26183052,1014,15,5773717,20409335,1345,11,17740544,8442508,-11966827,11966827
2023-05-06,7102,7131,7026,7079,16255661,1034,11,6229406,10026255,1400,7,12751852,3503809,-6522446,6522446
2023-05-07,7079,7089,6593,6601,36495737,980,14,5040146,31455591,1616,15,20762166,15733571,-15722020,15722020
2023-05-08,6353,6487,6337,6337,42721785,876,12,5437143,37284642,1925,13,29670901,13050884,-24233758,24233758
2023-05-09,5941,6733,5941,6559,15004552,1129,6,10227011,4777541,1206,10,7743628,7260924,2483383,-2483383
2023-05-10,6469,6582,6149,6382,30102032,700,12,10118229,19983803,1027,14,11350213,18751819,-1231984,1231984
2023-05-13,6139,6337,6007,6271,32570858,511,11,3881603,28689255,1253,16,18959520,13611338,-15077917,15077917
2023-05-14,6165,6463,6165,6350,21844049,1323,11,18227805,3616244,651,13,5540918,16303131,12686887,-12686887
2023-05-15,6350,6416,6178,6363,17203571,687,11,3972142,13231429,720,10,9695623,7507948,-5723481,5723481
2023-05-17,6363,6522,6297,6495,29205652,861,9,6670631,22535021,678,12,6274212,22931440,396419,-396419
2023-05-20,6213,6453,6213,6334,10178317,521,7,3011461,7166856,615,9,5241663,4936654,-2230202,2230202
2023-05-21,6326,6395,6221,6363,16015367,514,5,2105850,13909517,558,13,10222195,5793172,-8116345,8116345
2023-05-22,6413,6519,6316,6461,16770277,576,4,3042125,13728152,694,8,9507913,7262364,-6465788,6465788
2023-05-23,6239,6469,6239,6405,14171039,471,4,2628018,11543021,486,14,6403836,7767203,-3775818,3775818
2023-05-24,6548,6551,6337,6403,15459226,405,10,2441200,13018026,532,9,6679615,8779611,-4238415,4238415
2023-05-27,6342,6450,6279,6305,19736983,352,6,2312949,17424034,643,10,5369131,14367852,-3056182,3056182
2023-05-28,6263,6331,6157,6221,25404393,410,5,2800982,22603879,635,20,20074636,5330225,-17273654,17273654
2023-05-28,6165,6165,6165,6165,468,410,5,2800982,22603879,635,20,20074636,5330225,-17273654,17273654
2023-05-29,6337,6440,6141,6205,16082193,453,7,1540420,14541773,425,16,5958002,10124191,-4417582,4417582
2023-05-30,6194,6258,6115,6173,13709734,460,5,1721096,11988638,489,18,9443750,4265984,-7722654,7722654
2023-05-31,6091,6284,6065,6178,8075243,274,6,1091480,6983763,439,10,4607010,3468233,-3515530,3515530
2023-06-03,6128,6302,6115,6160,18286877,290,3,3871797,14415080,507,10,5633009,12653868,-1761212,1761212
2023-06-06,6104,6360,6104,6226,13133027,218,5,1660559,11472468,561,9,6117896,7015131,-4457337,4457337
2023-06-07,6337,6350,6173,6247,11518505,268,5,1823781,9694724,479,9,5289135,6229370,-3465354,3465354
2023-06-10,6160,6160,5832,5888,19578220,637,16,8256463,11321757,644,11,9122353,10455867,-865890,865890
2023-06-11,5835,6009,5835,5920,8498109,247,5,1382251,7115858,725,11,5813261,2684848,-4431010,4431010
2023-06-12,5729,5909,5558,5560,15169773,661,3,6729710,8440063,587,7,12353670,2816103,-5623960,5623960
2023-06-13,5574,5753,5574,5737,14529489,336,4,2385099,12144390,384,7,5217710,9311779,-2832611,2832611
2023-06-14,5782,5838,5626,5671,4436423,450,5,2365545,2070878,271,10,2437287,1999136,-71742,71742
2023-06-17,5809,5851,5587,5590,8799589,427,6,3895792,4903797,343,6,3702880,5096709,192912,-192912
2023-06-18,5809,5809,5642,5687,13993929,244,11,2361799,11632130,360,9,4488094,9505835,-2126295,2126295
2023-06-19,5840,5840,5663,5682,9310332,234,6,1792334,7517998,366,10,4244749,5065583,-2452415,2452415
2023-06-20,5803,5803,5645,5729,4306479,206,5,1194938,3111541,295,7,1983590,2322889,-788652,788652
2023-06-21,5716,5835,5650,5677,4374337,271,3,1609800,2764537,296,6,2943745,1430592,-1333945,1333945
2023-06-24,5888,5888,5679,5737,5375091,330,3,2190374,3184717,361,10,3244120,2130971,-1053746,1053746
2023-06-25,5732,5883,5732,5795,12000678,236,3,1966326,5939662,249,7,4231277,3674711,-2264951,2264951
2023-06-26,5885,5922,5764,5785,6968201,317,4,2896996,4071205,325,5,4090964,2877237,-1193968,1193968
2023-06-27,5759,5788,5563,5568,16772713,523,8,3894904,12877809,300,15,8183803,8588910,-4288899,4288899
2023-06-28,5571,5626,5436,5492,9073049,445,4,2896224,6176825,330,14,5849041,3224008,-2952817,2952817
2023-07-01,5505,5542,5413,5502,10802983,371,9,2659986,8142997,364,14,5152206,5650777,-2492220,2492220
2023-07-02,5389,5597,5389,5505,9399587,314,6,2372117,7027470,308,7,7174080,2225507,-4801963,4801963
2023-07-03,5729,5729,5439,5537,19813336,801,6,10947938,8865398,332,8,4507248,15306088,6440690,-6440690
2023-07-04,5558,5571,5352,5365,25971230,1390,7,8991254,16979976,412,12,10011659,15959571,-1020405,1020405
2023-07-05,5428,5465,5347,5357,8326688,714,7,4274429,4052259,344,6,4226852,4099836,47577,-47577
2023-07-08,5476,5476,5291,5307,12538301,707,5,3526109,9012192,334,11,3161235,9377066,364874,-364874
2023-07-09,5381,5381,5093,5193,22641389,1046,9,5525911,17115478,390,10,4827307,17814082,698604,-698604
2023-07-10,5191,5254,5088,5088,9276297,628,7,3230411,6045886,347,9,3062220,6214077,168191,-168191
2023-07-11,5238,5238,4985,5011,10742622,646,6,2992723,7749899,398,10,6815828,3926794,-3823105,3823105
2023-07-12,4995,5046,4800,4871,9457636,690,7,3523152,5934484,418,5,4545635,4912001,-1022483,1022483
2023-07-15,4871,5061,4800,4858,9032055,768,9,4253893,4778162,308,9,3158452,5873603,1095441,-1095441
2023-07-16,4885,4895,4607,4652,11740428,863,10,5312234,6428194,421,6,4636176,7104252,676058,-676058
2023-07-17,4673,4681,4357,4671,19980248,717,11,10452009,9528239,623,6,8548848,11431400,1903161,-1903161
2023-07-18,4634,4755,4531,4702,16532687,858,8,15164894,1367793,375,6,5154160,11378527,10010734,-10010734
2023-07-19,4742,4879,4502,4512,11611050,902,7,9096993,2514057,584,7,8164317,3446733,932676,-932676
2023-07-22,4494,4584,4433,4520,9157411,460,8,2859783,6297628,359,9,5847549,3309862,-2987766,2987766
2023-07-23,4515,4610,4491,4523,4530284,379,3,3749404,780880,226,4,1866473,2663811,1882931,-1882931
2023-07-24,4531,4755,4531,4700,13977027,452,7,3475466,10501561,388,9,4604820,9372207,-1129354,1129354
2023-07-25,4811,4832,4562,4665,7251234,456,5,4449285,2801949,286,17,4882069,2369165,-432784,432784
2023-07-26,4697,4697,4599,4679,4703012,266,6,1631328,3071684,153,5,1208680,3494332,422648,-422648
2023-07-29,4668,4734,4668,4697,3760010,227,5,2636224,1123786,236,5,2201194,1558816,435030,-435030
2023-07-30,4694,4694,4586,4621,5652724,268,6,2034459,3618265,291,3,4354463,1298261,-2320004,2320004
2023-07-31,4700,4700,4586,4681,5422818,192,6,3512979,1909839,212,6,2858817,2564001,654162,-654162
2023-08-01,4655,4813,4655,4811,5817303,248,5,4979832,837471,293,5,2958813,2858490,2021019,-2021019
2023-08-05,4879,4911,4792,4890,4387372,346,6,3653940,733432,349,2,3353414,1033958,300526,-300526
2023-08-06,4853,4932,4776,4892,7154623,294,8,3020563,4134060,323,4,4135839,3018784,-1115276,1115276
2023-08-07,4856,4951,4856,4924,3710631,171,5,1781526,1929105,372,4,2943718,766913,-1162192,1162192
2023-08-08,4937,4937,4861,4890,2959327,167,6,1179737,1779590,261,3,2442185,517142,-1262448,1262448
2023-08-09,4908,4998,4887,4929,3956443,186,7,1499757,2456686,260,5,1873631,2082812,-373874,373874
2023-08-12,4879,4916,4724,4729,7916171,227,9,1330409,6585762,346,7,6234182,1681989,-4903773,4903773
2023-08-13,4650,4813,4650,4803,3680223,184,5,1992511,1687712,249,6,1698506,1981717,294005,-294005
2023-08-14,4805,4861,4745,4763,4042226,233,4,2412370,1629856,175,4,2118848,1923378,293522,-293522
2023-08-15,4705,4800,4705,4784,2998318,136,7,1106006,1892312,244,5,2030396,967922,-924390,924390
2023-08-16,4679,4776,4679,4774,3407376,137,8,928363,2479013,279,6,1805834,1601542,-877471,877471
2023-08-19,4753,4779,4689,4745,4796896,172,9,2439737,2357159,281,7,2998005,1798891,-558268,558268
2023-08-20,4734,4800,4708,4771,5537618,109,5,744002,3919853,200,6,2200182,2463673,-1456180,1456180
2023-08-21,4779,4826,4779,4787,5361330,127,6,785370,4575960,278,5,2965822,2395508,-2180452,2180452
2023-08-22,4782,4787,4705,4747,6177853,149,6,891452,5286401,218,3,5665789,512064,-4774337,4774337
2023-08-23,4687,4832,4687,4824,3434255,202,7,1187845,2246410,190,2,2773735,660520,-1585890,1585890
2023-08-26,4742,5011,4742,4972,5406675,316,8,4106476,1300199,307,6,2044546,3362129,2061930,-2061930
2023-08-27,5017,5209,5006,5199,17574305,591,7,15096359,2477946,560,8,8413915,9160390,6682444,-6682444
2023-08-28,5215,5500,5201,5439,35743054,852,20,23355014,12388040,1038,13,16659038,19084016,6695976,-6695976
2023-08-29,5494,5693,5426,5497,13802501,477,10,6402051,7400450,695,6,9461425,4341076,-3059374,3059374
2023-08-30,5545,5621,5465,5595,6545910,324,9,2378478,4167432,514,4,4745839,1800071,-2367361,2367361
2023-09-02,5545,5674,5465,5518,16382140,327,12,2427996,13954144,484,7,13984344,2397796,-11556348,11556348
2023-09-03,5481,5640,5481,5553,19360865,316,7,6921606,12439259,433,12,9673617,9687248,-2752011,2752011
2023-09-04,5497,5729,5497,5587,7985373,334,4,4558007,3427366,383,9,3805075,4180298,752932,-752932
2023-09-05,5724,5724,5605,5621,9681289,315,9,2367440,7313849,402,7,4615988,5065301,-2248548,2248548
2023-09-09,5597,5724,5518,5566,6115346,214,8,2028095,4087251,409,5,4858061,1257285,-2829966,2829966
2023-09-10,5489,5597,5489,5537,8123045,218,9,1686836,6436209,281,5,3804524,4318521,-2117688,2117688
2023-09-11,5571,5571,5505,5518,6230085,196,5,1416871,4796139,250,9,3755235,2457775,-2338364,2338364
2023-09-12,5529,5582,5510,5516,7163083,183,9,1224361,5938722,222,11,2777811,4385272,-1553450,1553450
2023-09-13,5492,5584,5489,5560,5942262,164,7,1312345,4629917,250,8,3229559,2712703,-1917214,1917214
2023-09-17,5553,5621,5518,5579,5934021,188,7,2744659,3189362,305,8,3547046,2386975,-802387,802387
2023-09-18,5632,5632,5563,5582,5035685,144,6,1756267,3279418,283,10,2904811,2130874,-1148544,1148544
2023-09-19,5518,5613,5518,5545,4045086,140,4,1115490,2936326,205,4,3141565,910251,-2026075,2026075
2023-09-20,5545,5571,5489,5489,6825708,205,8,2624644,4201064,180,9,4673573,2152135,-2048929,2048929
2023-09-23,5492,5531,5476,5479,3515008,196,7,1595149,1919859,229,3,2914666,600342,-1319517,1319517
2023-09-25,5500,5500,5423,5460,7556233,196,9,1560914,5995319,278,6,5721081,1835152,-4160167,4160167
2023-09-26,5368,5463,5368,5447,3793370,180,7,1036888,2756482,231,6,2891000,902370,-1854112,1854112
2023-09-27,5402,5505,5402,5455,2624046,155,4,2083871,540175,200,3,1497479,1126567,586392,-586392
2023-09-30,5421,5510,5421,5452,5888490,176,4,2771579,3116911,325,5,4994432,894058,-2222853,2222853
2023-10-01,5418,5450,5405,5418,4677554,173,5,1250400,3427154,279,4,3070672,1606882,-1820272,1820272
2023-10-02,5386,5463,5386,5452,4297090,147,5,1284459,3012631,202,5,2816346,1480744,-1531887,1531887
2023-10-04,5421,5492,5413,5473,3076577,156,4,1792462,1284115,205,5,2231689,844888,-439227,439227
2023-10-07,5468,5531,5392,5439,3034004,128,8,1162156,1873868,240,2,2408908,627116,-1246752,1246752
2023-10-08,5397,5463,5236,5289,6729405,221,11,2374483,4354922,386,4,5877240,852165,-3502757,3502757
2023-10-09,5178,5439,5178,5310,5070519,155,5,3011852,2058667,276,7,3040791,2029728,-28939,28939
2023-10-10,5270,5479,5270,5439,4019714,116,3,2230719,1788995,244,4,3039744,979970,-809025,809025
2023-10-11,5505,5505,5378,5452,2505463,115,2,780783,1724680,202,8,1804164,701299,-1023381,1023381
2023-10-14,5494,5494,5286,5355,3192489,113,7,905466,2287023,238,5,2273648,918841,-1368182,1368182
2023-10-15,5323,5439,5323,5394,6472391,113,7,485061,5987330,242,9,4175396,2296995,-3690335,3690335
2023-10-16,5397,5518,5384,5465,4269433,279,7,2664876,1604557,195,6,2117580,2151853,547296,-547296
2023-10-17,5426,5492,5410,5421,5346232,182,8,2282024,3064208,159,9,2048616,3297616,233408,-233408
2023-10-18,5423,5458,5410,5428,2519752,109,6,894790,1624962,237,2,2359641,160111,-1464851,1464851
2023-10-21,5328,5452,5328,5376,1827266,167,4,1256089,571177,205,4,1485820,341446,-229731,229731
2023-10-22,5347,5439,5347,5381,3443352,176,4,1321723,2121629,178,7,1573407,1869945,-251684,251684
2023-10-23,5341,5410,5341,5386,1826409,133,3,820886,1005523,158,1,1743230,83179,-922344,922344
2023-10-24,5362,5386,5275,5302,9575411,243,8,3830142,5745269,193,4,4147558,5427853,-317416,317416
2023-10-25,5304,5394,5283,5307,3532268,140,7,1022656,2509612,144,5,1408550,2123718,-385894,385894
2023-10-28,5291,5291,5135,5138,5430551,242,6,1224470,4206081,324,4,3906803,1523748,-2682333,2682333
2023-10-29,5172,5307,5172,5254,3340562,150,10,602181,2738381,247,4,2455997,884565,-1853816,1853816
2023-10-30,5254,5410,5230,5278,2460109,163,7,1118731,1341378,173,7,1253567,1206542,-134836,134836
2023-10-31,5333,5333,5244,5259,2840299,157,8,687551,2152748,173,5,2034340,805959,-1346789,1346789
2023-11-01,5254,5360,5151,5299,3947551,117,7,815731,3131820,253,6,3065092,882459,-2249361,2249361
2023-11-04,5333,5531,5275,5320,2362369,210,2,2118722,243647,277,6,1861030,501339,257692,-257692
2023-11-05,5299,5629,5286,5619,7231107,233,8,4090097,3141010,404,2,6571107,660000,-2481010,2481010
2023-11-06,5619,5642,5566,5587,2408457,250,3,1928245,480212,282,5,2121216,287241,-192971,192971
2023-11-07,5597,5748,5487,5650,5646510,301,8,3802323,1844187,283,3,2779320,2867190,1023003,-1023003
2023-11-08,5645,5780,5574,5619,8015721,294,11,3134822,4880899,274,6,2956346,5059375,178476,-178476
2023-11-11,5634,5700,5584,5650,3495414,162,9,1017299,2478115,305,3,2155414,1340000,-1138115,1138115
2023-11-12,5597,5663,5597,5642,3530246,167,7,1233353,2296893,235,4,1337195,2193051,-103842,103842
2023-11-13,5642,5642,5568,5582,5564111,248,10,2251327,3312784,220,5,3390159,2173952,-1138832,1138832
2023-11-14,5576,5624,5524,5531,9075511,150,12,1127989,7947522,191,6,3572428,5503083,-2444439,2444439
2023-11-15,5529,5584,5442,5484,6474097,193,5,1453465,5020632,214,5,3219943,3254154,-1766478,1766478
2023-11-18,5524,5587,5436,5465,7169642,181,9,1213905,5955737,203,5,3250508,3919134,-2036603,2036603
2023-11-19,5481,5492,5426,5426,8966214,161,10,846932,8119282,143,6,2219135,6747079,-1372203,1372203
2023-11-20,5447,5452,5370,5370,9386047,180,8,1611695,7774352,206,7,3371497,6014550,-1759802,1759802
2023-11-21,5465,5521,5347,5442,15052720,219,7,2219900,12832820,227,6,6998367,8054353,-4778467,4778467
2023-11-22,5413,5516,5360,5418,4967966,192,7,1279865,3688101,198,5,1440401,3527565,-160536,160536
2023-11-25,5362,5487,5286,5399,9829268,144,6,1221507,8607761,236,8,2801268,7028000,-1579761,1579761
2023-11-26,5489,5489,5428,5489,3515729,136,4,1391533,2124196,216,6,1363488,2152241,28045,-28045
2023-11-27,5494,5508,5428,5465,8811646,142,7,1762914,7048732,204,7,4350621,4461025,-2587707,2587707
2023-11-28,5465,5505,5439,5492,13615818,147,7,1158912,12456906,223,8,5896393,7719425,-4737481,4737481
2023-11-29,5465,5817,5465,5740,22362345,318,5,5426320,16936025,476,14,7841620,14520725,-2415300,2415300
2023-12-02,5756,5803,5679,5687,14142924,492,13,6951948,7190976,303,11,5078203,9064721,1873745,-1873745
2023-12-03,5698,6096,5671,5988,21256832,416,14,4916006,16340826,538,14,9981480,11275352,-5065474,5065474
2023-12-04,5922,6096,5901,5967,18105029,442,6,5986188,12118841,473,17,6951291,11153738,-965103,965103
2023-12-05,5967,6086,5941,6020,15605345,290,7,2460999,13144346,392,16,9557066,6048279,-7096067,7096067
2023-12-06,6004,6099,5941,6091,14221061,193,6,985108,13235953,445,15,9940130,4280931,-8955022,8955022
2023-12-09,5946,6099,5941,6046,5325058,178,5,1164993,4160065,374,8,2542218,2782840,-1377225,1377225
2023-12-10,6099,6112,5959,6073,5995500,192,6,1363511,4631989,309,10,1920508,4074992,-556997,556997
2023-12-11,6073,6118,6041,6067,8847112,179,7,1657626,7189486,259,4,3687006,5160106,-2029380,2029380
2023-12-12,6057,6118,6038,6046,8651403,161,5,1552288,7099115,272,16,3438408,5212995,-1886120,1886120
2023-12-13,6070,6091,5993,6060,15224807,140,5,949653,14275154,233,6,3455183,11769624,-2505530,2505530
2023-12-16,6007,6186,5996,6178,6450267,193,6,1337400,5112867,329,9,2401708,4048559,-1064308,1064308
2023-12-18,6128,6350,6128,6310,15518000,279,6,3763673,11754327,458,16,5303867,10214133,-1540194,1540194
2023-12-19,6300,6429,6289,6324,11876319,209,10,1596187,10280132,384,12,5471162,6405157,-3874975,3874975
2023-12-20,6284,6360,6284,6310,16940502,165,8,977511,15953553,330,19,6594059,10337005,-5616548,5616548
2023-12-23,6289,6350,6289,6302,13868427,190,8,712085,13252378,298,15,6578663,7385800,-5866578,5866578
2023-12-24,6284,6310,6244,6265,8093490,162,6,989859,7103631,301,9,2902830,5190660,-1912971,1912971
2023-12-25,6279,6297,6247,6271,5096478,145,9,1104097,3992381,270,8,3120339,1976139,-2016242,2016242
2023-12-26,6178,6263,6178,6244,11832252,120,6,904058,10928194,317,7,5484363,6347889,-4580305,4580305
2023-12-27,6165,6263,6128,6226,21506094,141,9,1330978,20175116,284,17,7135403,14370691,-5804425,5804425
2023-12-30,6194,6310,6194,6213,7119542,237,9,3689503,3430039,234,13,1483771,5635771,2205732,-2205732
2023-12-31,6244,6318,6194,6202,14492195,253,8,1917226,12574969,238,18,8071240,6420955,-6154014,6154014
2024-01-01,6228,6236,6147,6189,12506576,176,9,1614683,10891893,314,13,5839254,6667322,-4224571,4224571
2024-01-02,6184,6247,6128,6149,5874934,168,18,928512,4946422,241,16,3394737,2480197,-2466225,2466225
2024-01-03,6152,6152,6091,6139,5402971,137,6,857459,4545512,205,6,3513522,1889449,-2656063,2656063
2024-01-06,6136,6136,6049,6126,7941054,144,9,969275,6971779,263,9,3712272,4228782,-2742997,2742997
2024-01-07,6099,6133,6073,6107,5298728,187,7,1485402,3814204,226,10,1823454,3476152,-338052,338052
2024-01-08,6126,6126,6065,6086,6116092,178,13,1397583,4718509,213,12,2098549,4017543,-700966,700966
2024-01-09,6083,6094,6049,6086,6816986,200,13,2637727,4179259,212,9,2309451,4507535,328276,-328276
2024-01-10,6052,6268,6052,6263,11078049,289,10,5289351,5788698,338,9,3078270,7999779,2211081,-2211081
2024-01-13,6141,6258,6141,6234,13388128,327,13,4723990,8867603,307,7,6253072,7338521,-1529082,1529082
2024-01-14,6205,6442,6205,6442,13597385,356,10,7515699,6081686,484,9,3371260,10226125,4144439,-4144439
2024-01-15,6363,6440,6326,6337,17671852,321,11,2132488,15539364,424,24,3093882,14577970,-961394,961394
2024-01-16,6324,6387,6305,6305,11029268,216,10,1024644,10004624,257,12,2503258,8526010,-1478614,1478614
2024-01-17,6331,6442,6331,6331,10148177,236,7,3339391,6808786,240,11,1265661,8882516,2073730,-2073730
2024-01-20,6453,6453,6218,6218,12912393,259,10,4216624,8695769,332,5,9879229,3033164,-5662605,5662605
2024-01-21,6284,6292,6110,6252,8363413,197,12,1741970,6621443,290,7,3716616,4646797,-1974646,1974646
2024-01-22,6223,6258,6133,6189,13127622,213,7,1088408,12039214,244,8,2911322,10216300,-1822914,1822914
2024-01-23,6210,6213,6131,6192,13086072,140,13,596400,12489672,342,9,6513204,6572868,-5916804,5916804
2024-01-24,6165,6218,6144,6205,9246607,213,10,3270207,5976400,214,6,3110929,6135678,159278,-159278
2024-01-27,6199,6223,6168,6170,6849617,185,9,1771640,5077977,223,7,2204224,4645393,-432584,432584
2024-01-28,6178,6184,6141,6144,6789363,189,12,1423026,5366337,229,9,1666418,5122945,-243392,243392
2024-01-29,6165,6170,6062,6110,16657526,320,12,5785577,10871949,268,11,1896098,14761428,3889479,-3889479
2024-01-30,6086,6089,5986,6020,8875452,263,11,2723877,6151575,285,12,2033486,6841966,690391,-690391
2024-01-31,6046,6070,5986,6020,6868065,248,8,2801133,4066932,224,7,2100604,4767461,700529,-700529
2024-02-03,6025,6141,6009,6009,6202715,312,7,3217464,2985251,217,11,2573329,3629386,644135,-644135
2024-02-04,6046,6086,5988,5988,12681591,172,6,1109205,11572386,184,7,2053383,10628208,-944178,944178
2024-02-05,6020,6020,5935,5938,10671646,261,5,2252720,8418926,200,9,1313653,9357993,939067,-939067
2024-02-06,5980,5980,5925,5927,4495621,149,4,1442226,3053395,190,7,1842011,2653610,-399785,399785
2024-02-07,5938,6015,5901,5993,7533058,184,6,1505829,6027229,232,5,2078255,5454803,-572426,572426
2024-02-10,5993,5993,5949,5970,2771495,173,5,883108,1888387,219,4,1972338,799157,-1089230,1089230
2024-02-12,5959,6020,5848,5856,6400528,209,9,1583515,4817013,203,6,1552037,4848491,31478,-31478
2024-02-13,5912,5970,5838,5840,7413147,178,8,933510,6479637,189,4,1704191,5708956,-770681,770681
2024-02-14,5885,5888,5785,5806,4277584,246,6,1604701,2672883,213,7,1423237,2854347,181464,-181464
2024-02-17,5838,5875,5690,5751,7416092,281,7,2327601,5088491,261,4,2675604,4740488,-348003,348003
2024-02-18,5753,5832,5719,5764,4062661,248,7,1299787,2762874,165,5,2137771,1924890,-837984,837984
2024-02-19,5809,5819,5677,5790,6948478,347,10,2505779,4471993,202,10,1887883,5089889,617896,-617896
2024-02-20,5677,5925,5677,5735,8966257,233,5,1760998,9675151,173,11,4534447,6901702,-2773449,2773449
2024-02-21,5756,5817,5729,5756,3417725,175,3,962994,2650856,171,7,1743356,1870494,-780362,780362
2024-02-24,5756,5780,5690,5729,4347862,213,4,1427769,2920093,228,8,2917750,1430112,-1489981,1489981
2024-02-26,5729,5756,5579,5642,3616132,253,6,1217083,2399049,248,4,2961653,654479,-1744570,1744570
2024-02-27,5698,5729,5634,5729,4170802,208,3,1390133,3989071,194,6,3063748,2315456,-1673615,1673615
2024-02-28,5687,5819,5687,5700,1923748,214,4,1489658,434090,139,6,1180697,743051,308961,-308961
2024-03-02,5706,6104,5703,6104,12383949,346,9,6146258,6237691,424,10,6177066,6206883,-30808,30808
2024-03-03,6096,6260,6096,6162,11379623,396,5,4629974,6749649,317,10,4118266,7261357,511708,-511708
2024-03-04,6244,6244,6126,6144,3751996,202,6,2204088,1547908,247,7,2359323,1392673,-155235,155235
2024-03-05,6258,6495,6170,6379,16122095,324,10,3865348,12256747,423,14,5364438,10757657,-1499090,1499090
2024-03-06,6358,6461,6294,6355,6662285,192,6,1434087,5228198,269,8,5351432,1310853,-3917345,3917345
2024-03-09,6358,6427,6289,6289,3795208,198,5,2865903,929305,300,6,2591455,1203753,274448,-274448
2024-03-10,6355,6366,6239,6324,10174983,157,12,1284491,8890492,358,10,4906768,5268215,-3622277,3622277
2024-03-11,6308,6324,6223,6305,4405757,215,10,1362061,3043696,260,7,2289468,2116289,-927407,927407
2024-03-12,6268,6321,6136,6178,7926704,249,11,2770197,5156507,203,6,4499071,3427633,-1728874,1728874
2024-03-13,6213,6223,6046,6067,13031867,264,11,2745732,10286135,202,11,3825096,9206771,-1079364,1079364
2024-03-16,6091,6099,6007,6041,4822008,336,7,3091257,1730751,179,8,2143553,2678455,947704,-947704
2024-03-17,6073,6265,6073,6162,13028519,260,9,2285789,10742730,157,10,2705884,10322635,-420095,420095
2024-03-18,6165,6429,6165,6413,19134103,322,9,3766094,15368009,234,9,4899393,14234710,-1133299,1133299
2024-03-24,6469,6598,6469,6580,5726282,435,9,3956308,1769974,224,12,2569563,3156719,1386745,-1386745
2024-03-25,6595,6775,6529,6603,8586899,402,11,3368140,5218759,340,10,4642900,3943999,-1274760,1274760
2024-03-26,6632,6632,6556,6601,4862555,232,8,1358081,3504474,210,3,3601380,1261175,-2243299,2243299
2024-03-27,6601,6654,6580,6601,7983746,290,7,2304652,5679094,224,5,3638804,4344942,-1334152,1334152
2024-03-30,6595,6627,6580,6606,4574448,254,6,1727829,2846619,206,4,2787943,1786505,-1060114,1060114
2024-04-02,6593,6609,6392,6598,7136846,291,10,1889098,5247748,340,6,5433357,1703489,-3544259,3544259
2024-04-03,6588,6601,6574,6574,4938227,264,10,1698429,3239798,288,6,3413091,1525136,-1714662,1714662
2024-04-06,6595,6720,6540,6548,10852926,424,11,4380894,6472032,417,8,6601542,4251384,-2220648,2220648
2024-04-07,6585,6640,6577,6601,12688165,314,12,2432809,10255356,307,11,5355988,7332177,-2923179,2923179
2024-04-08,6611,6772,6603,6630,12080974,511,5,9551595,2529379,299,10,3484226,8596748,6067369,-6067369
2024-04-09,6685,6772,6667,6714,12685149,319,10,4123481,8561668,283,10,4243282,8441867,-119801,119801
2024-04-13,6701,6701,6522,6532,12217690,305,14,3908712,8308978,538,5,9136254,3081436,-5227542,5227542
2024-04-14,6522,6522,6522,6522,15769621,274,5,4218776,11550845,331,6,11988812,3780809,-7770036,7770036
2024-04-20,6849,6912,6549,6723,15678157,699,8,9198984,6479173,316,6,6352369,9325788,2846615,-2846615
2024-04-21,6657,6747,6540,6576,9464172,624,11,5264610,4199562,286,12,4208451,5255721,1056159,-1056159
2024-04-22,6624,6624,6495,6504,5351578,547,10,2827848,2523730,258,9,2646537,2705041,181311,-181311
2024-04-23,6537,6603,6332,6365,7382618,508,6,3314116,4068502,264,7,4087474,3295144,-773358,773358
2024-04-24,6428,6455,6371,6413,8447986,674,5,6219459,2228527,286,14,3552888,4895098,2666571,-2666571
2024-04-27,6425,6425,6281,6398,6613721,484,5,2725966,3887755,224,7,2506122,4107599,219844,-219844
2024-04-28,6446,6446,6242,6260,4549355,438,4,1992951,2556404,186,8,2547655,2001700,-554704,554704
2024-04-29,6299,6392,6239,6296,10125850,265,8,1110472,9015378,232,8,2179892,7945958,-1069420,1069420
2024-04-30,6371,6371,6215,6215,13297423,304,8,1451104,11846319,178,7,7178791,6118632,-5727687,5727687
2024-05-01,6257,6311,6185,6257,9884636,275,6,1042644,8841992,206,6,3927728,5956908,-2885084,2885084
2024-05-05,6248,6362,6188,6218,6706629,244,11,1436594,5270035,203,13,1451975,5254654,-15381,15381
2024-05-06,6257,6257,6164,6200,7699768,185,11,1069874,6629894,220,7,2798277,4901491,-1728403,1728403
2024-05-07,6221,6233,6092,6125,6968164,344,9,1808272,5159892,166,14,1294700,5673464,513572,-513572
2024-05-08,6104,6170,6008,6077,3608982,278,5,1239870,2369112,163,8,2348315,1260667,-1108445,1108445
2024-05-11,6251,6251,6065,6065,4388727,279,9,1310204,3078523,174,15,1615196,2773531,-304992,304992
2024-05-12,6131,6131,6062,6068,7246794,240,5,2343599,4903195,194,10,2729610,4517184,-386011,386011
2024-05-13,6131,6131,5966,6044,3750396,310,7,1940855,1809541,223,13,2455704,1294692,-514849,514849
2024-05-14,6041,6098,5999,6014,4275739,203,6,1328979,2946760,152,12,1574657,2701082,-245678,245678
2024-05-15,6044,6131,5930,6041,5447519,204,5,1087570,4359949,211,7,2456927,2990592,-1369357,1369357
2024-05-18,6041,6119,5881,5951,2141767,265,7,1077853,1063914,123,8,1761732,380035,-683879,683879
2024-05-19,6014,6014,5680,5806,7999059,363,14,1780222,6218837,253,11,4162238,3836821,-2382016,2382016
2024-05-21,5797,5902,5710,5890,9521029,179,9,761752,8759277,186,14,2027086,7493943,-1265334,1265334
2024-05-25,5806,5914,5698,5698,4389522,297,9,1100345,3289177,157,11,2352671,2036851,-1252326,1252326
2024-05-26,5752,5752,5641,5641,6688948,206,6,609431,6071147,201,14,5915474,765104,-5306043,5306043
2024-05-27,5662,5731,5548,5698,2515957,103,5,252220,2263737,115,4,1695084,820873,-1442864,1442864
2024-05-28,5578,5755,5578,5755,6264015,158,9,1526997,4737018,161,10,1306042,4957973,220955,-220955
2024-05-29,5863,5866,5860,5866,5111808,87,3,1389345,3722463,137,2,911808,4200000,477537,-477537
2024-06-01,5960,5960,5830,5845,9742982,211,6,2761861,6981121,224,11,1780854,7962128,981007,-981007
2024-06-02,5896,6014,5824,5996,4933952,77,7,449117,4484835,185,8,3435287,1498665,-2986170,2986170
2024-06-05,5905,6023,5863,6002,6623235,104,7,702705,5920530,183,8,2428806,4194429,-1726101,1726101
2024-06-08,5930,5975,5851,5923,4230825,92,4,429611,3801214,228,5,3275573,955252,-2845962,2845962
2024-06-09,5893,6011,5827,5972,4101078,116,8,1558476,2542602,232,7,2677330,1423748,-1118854,1118854
2024-06-10,6011,6041,5975,6026,4616938,151,7,962365,3654573,165,5,2132463,2484475,-1170098,1170098
2024-06-11,6011,6104,5984,5987,2415284,96,6,673568,1741716,144,5,1683457,731827,-1009889,1009889
2024-06-12,5966,6065,5948,6020,6374223,69,7,665295,5708928,144,6,1998675,4375548,-1333380,1333380
2024-06-15,5987,6005,5881,5893,8714129,110,8,449136,8264993,160,7,1798354,6915775,-1349218,1349218
2024-06-16,5890,5972,5788,5791,5799819,211,8,1412351,4387468,151,10,2789920,3009899,-1377569,1377569
2024-06-18,5872,5930,5764,5806,5468448,126,9,1497832,3970616,140,10,1166958,4301490,330874,-330874
2024-06-19,5827,5951,5827,5951,5683751,136,8,1203239,4311900,164,9,1808354,3706785,-605115,605115
2024-06-22,5981,5984,5836,5917,3633428,147,8,934363,2694965,152,11,1974925,1654403,-1040562,1040562
2024-06-23,5927,5978,5845,5881,3080103,126,7,729774,2350329,122,11,2469105,610998,-1739331,1739331
2024-06-24,5978,6011,5875,5905,14368173,227,8,5809345,8558828,173,13,6720869,7647304,-911524,911524
2024-06-26,6002,6044,5948,6044,24779557,200,4,5497365,19282192,174,13,6714931,18064626,-1217566,1217566
2024-06-29,6137,6137,5975,5975,3206553,177,8,1474165,1732388,146,5,2206522,1000031,-732357,732357
2024-06-30,6035,6077,5830,6008,6397647,112,8,1823785,4573862,205,6,4922434,1475213,-3098649,3098649
2024-07-01,5990,6017,5951,6017,3558622,77,3,3188734,369888,135,6,1308144,2250478,1880590,-1880590
2024-07-02,5957,6251,5957,6068,3232618,89,6,1568392,1664226,156,8,1429884,1802734,138508,-138508
2024-07-03,6284,6284,6050,6098,1594273,114,7,1094583,499690,147,4,1067646,526627,26937,-26937
2024-07-06,6413,6413,6413,6413,5235806,5,1,2435806,2800000,154,4,838763,4397043,1597043,-1597043
2024-07-07,6747,6747,6549,6627,20435174,369,12,6795554,13639620,364,12,6319521,14115653,476033,-476033
2024-07-08,6654,6684,6597,6675,6294663,124,6,439042,5855621,297,2,5840471,454192,-5401429,5401429
2024-07-09,6621,6684,6573,6624,4512769,94,8,433210,4079559,224,7,2483432,2029337,-2050222,2050222
2024-07-10,6633,6741,6549,6615,7769911,107,11,739104,7030807,290,13,4022863,3747048,-3283759,3283759
2024-07-13,6762,6762,6576,6621,3622423,142,8,792618,2829805,220,7,3004634,617789,-2212016,2212016
2024-07-14,6738,6738,6579,6636,4704986,144,9,1008087,3696899,177,8,2651141,2053845,-1643054,1643054
2024-07-17,6699,6753,6603,6630,2648692,133,6,1041984,1606708,150,4,1399740,1248952,-357756,357756
2024-07-20,6633,6723,6582,6603,3074808,137,8,826772,2248036,212,4,1491915,1582893,-665143,665143
2024-07-21,6615,6762,6534,6624,13773813,171,9,1214761,12559052,268,13,4058153,9715660,-2843392,2843392
2024-07-22,6624,6735,6540,6636,9073405,279,7,1838310,7235095,223,12,5011551,4061854,-3173241,3173241
2024-09-09,6609,6609,6419,6419,35095567,722,10,19649780,16094578,259,18,14484893,21259465,5164887,-5164887
2024-09-10,6302,6392,6257,6257,33384079,548,13,17010221,16373858,147,12,10247023,23137056,6763198,-6763198
2024-09-11,6086,6275,6086,6086,100871767,1301,18,41821825,59193159,479,18,47298642,53716342,-5476817,5476817
2024-09-11,6086,6095,6086,6086,143217,1301,18,41821825,59193159,479,18,47298642,53716342,-5476817,5476817
2024-09-14,6221,6257,5933,6050,29866369,603,12,14208243,15658126,266,12,9417454,20448915,4790789,-4790789
2024-09-15,6032,6050,5942,6050,27349361,285,15,5191096,22158265,237,16,8779574,18569787,-3588478,3588478
2024-09-16,6050,6086,5960,5987,20118834,398,12,8680002,11438832,180,14,4327028,15791806,4352974,-4352974
2024-09-17,5978,6194,5978,6194,68499891,467,20,17038616,51461275,341,15,12146689,56353202,4891927,-4891927
2024-09-18,6194,6293,6113,6293,57977180,373,18,15592020,42385160,354,16,15084343,42892837,507677,-507677
2024-09-22,6401,6446,6266,6275,17184885,374,11,9186196,7998689,266,8,7874955,9309930,1311241,-1311241
2024-09-23,6320,6428,6266,6356,13577157,323,12,6841953,6735204,240,7,7153962,6423195,-312009,312009
2024-09-24,6374,6546,6356,6546,38259905,345,19,11041221,27218684,433,14,14669030,23590875,-3627809,3627809
2024-09-25,6546,6609,6356,6356,28632668,407,15,7894903,20737765,259,11,9842006,18790662,-1947103,1947103
2024-09-28,6374,6464,6374,6374,59366383,142,6,3277735,56088648,328,12,33929096,25437287,-30651361,30651361
2024-09-29,6311,6437,6311,6311,27742530,280,12,7857148,19885382,208,3,9630776,18111754,-1773628,1773628
2024-09-30,6356,6374,6248,6257,24781956,272,9,4283691,20498265,187,5,7474697,17307259,-3191006,3191006
2024-10-01,6230,6230,6203,6203,36456398,153,9,951751,35504647,199,8,25085191,11371207,-24133440,24133440
2024-10-02,6149,6194,6149,6149,41115848,210,5,3403343,37707505,233,8,27087525,14023323,-23684182,23684182
2024-10-05,6095,6131,6095,6095,39509467,181,5,5509467,34000000,202,9,14176157,25333310,-8666690,8666690
2024-10-06,6059,6059,6041,6041,3383994,95,4,1091094,2292900,56,6,1649497,1734497,-558403,558403
2024-10-07,6032,6140,6032,6077,19075936,291,11,7435453,11640483,269,7,10452093,8623843,-3016640,3016640
2024-10-08,6005,6095,6005,6095,15207262,164,5,6860148,8347114,177,8,2762319,12444943,4097829,-4097829
2024-10-09,6140,6140,6095,6140,43370099,148,4,21605859,21764240,141,8,2764952,40605147,18840907,-18840907
2024-10-12,6293,6320,6212,6320,35424774,185,8,27071040,8353734,235,8,10859312,24565462,16211728,-16211728
2024-10-13,6482,6510,6320,6492,46161241,323,9,29744750,16416491,446,22,17936843,28224398,11807907,-11807907
2024-10-14,6501,6663,6311,6311,23875674,229,9,6256650,17619024,287,7,18947647,4928027,-12690997,12690997
2024-10-15,6185,6428,6149,6158,10512172,230,9,4925969,5586203,180,3,10032275,479897,-5106306,5106306
2024-10-16,6293,6437,6266,6356,47300194,186,4,7762265,39537929,359,17,15087691,32212503,-7325426,7325426
2024-10-19,6501,6501,6230,6230,14328998,204,8,3075301,11253697,243,5,10440075,3888923,-7364774,7364774
2024-10-20,6230,6230,6113,6113,7393348,183,5,2045448,5347900,107,2,7104298,289050,-5058850,5058850
2024-10-21,6041,6401,6041,6041,24518711,427,12,10585789,13932922,314,11,10329088,14189623,256701,-256701
2024-10-22,6122,6293,5942,5942,13273487,270,7,5529587,7743900,139,7,7958423,5315064,-2428836,2428836
2024-10-23,5869,6131,5869,6032,53038292,299,6,9590940,43447352,343,13,26188079,26850213,-16597139,16597139
2024-10-26,6086,6086,6086,6086,12401174,53,1,9001174,3400000,158,2,4401174,8000000,4600000,-4600000
2024-10-27,6212,6212,6212,6212,11252195,28,1,7252195,4000000,105,6,1769222,9482973,5482973,-5482973
2024-10-28,6320,6320,6266,6320,46584451,466,9,27834451,18750000,325,11,25328212,21256239,2506239,-2506239
2024-10-29,6419,6419,6131,6140,22510113,359,15,8863836,13646277,251,9,15620487,6889626,-6756651,6756651
2024-10-30,6176,6356,6095,6302,22949042,227,8,11928900,11020142,316,11,12204939,10744103,-276039,276039
2024-11-02,6293,6482,6275,6311,20997628,226,7,8051293,12946335,314,6,10934315,10063313,-2883022,2883022
2024-11-03,6338,6392,6194,6194,13362561,173,6,2765742,10596819,185,5,11252674,2109887,-8486932,8486932
2024-11-04,6221,6302,6167,6194,10515282,154,9,3835901,6679381,213,6,6470175,4045107,-2634274,2634274
2024-11-05,6401,6410,6212,6248,6699587,150,8,3514751,3184836,173,5,3885007,2814580,-370256,370256
2024-11-06,6239,6329,6131,6311,11541286,169,6,7591063,3950223,182,5,3771590,7769696,3819473,-3819473
2024-11-09,6338,6446,6311,6446,37668188,286,8,27226339,10441849,268,13,7025911,30642277,20200428,-20200428
2024-11-10,6627,6627,6600,6627,33338246,208,3,25114957,8223289,211,10,10853455,22484791,14261502,-14261502
2024-11-11,6762,6807,6582,6636,45213400,439,12,15163403,30049997,454,11,34537082,10676318,-19373679,19373679
2024-11-12,6690,6780,6591,6627,19568686,222,10,6027196,13541490,263,10,15639595,3929091,-9612399,9612399
2024-11-13,6663,6699,6591,6672,15905495,276,8,5701281,10204214,228,6,9042397,6863098,-3341116,3341116
2024-11-16,6672,6843,6672,6843,53897728,154,6,35292475,18605253,285,14,14127233,39770495,21165242,-21165242
2024-11-17,6933,7014,6825,6852,35816212,322,11,12788773,23027439,362,13,18321755,17494457,-5532982,5532982
2024-11-18,6879,7078,6879,7078,103767728,286,17,30012290,73755438,371,19,15822361,87945367,14189929,-14189929
2024-11-19,7213,7249,6906,7005,22353793,378,8,11296137,11057656,427,4,18093365,4260428,-6797228,6797228
2024-11-20,7060,7195,6969,7069,26055298,198,10,3755464,22299834,357,6,13933223,12122075,-10177759,10177759
2024-11-23,7087,7285,7069,7168,13684401,283,10,6785346,6899055,275,5,6673912,7010489,111434,-111434
2024-11-24,7339,7384,7249,7384,40273900,419,10,22086827,18187073,437,17,15076635,25197265,7010192,-7010192
2024-11-25,7591,7591,7537,7591,45601971,465,8,27593133,18008838,397,15,14397069,31204902,13196064,-13196064
2024-11-26,7817,7817,7393,7429,91560306,660,14,26056970,65503336,625,21,36513060,55047246,-10456090,10456090
2024-11-27,7655,7907,7591,7790,47224624,341,15,9175628,38048996,574,10,29747352,17477272,-20571724,20571724
2024-11-30,7880,7952,7628,7637,19173713,315,6,11633489,7540224,478,10,14454011,4719702,-2820522,2820522
2024-12-01,7727,7934,7564,7619,29007193,207,9,6444565,22562628,317,11,13487695,15519498,-7043130,7043130
2024-12-02,7871,7916,7844,7916,32630346,127,10,12642091,19988255,344,8,8851093,23779253,3790998,-3790998
2024-12-03,8150,8150,7988,8114,84153649,476,22,26962331,57191318,489,13,25542116,58611533,1420215,-1420215
2024-12-04,8060,8286,8051,8177,23759779,400,9,13670238,10089541,407,10,11545743,12214036,2124495,-2124495
2024-12-07,8205,8205,7898,7934,65634843,449,22,9234002,56400841,432,14,37301718,28333125,-28067716,28067716
2024-12-08,7916,8150,7781,8105,94206436,352,13,25562394,68644042,665,20,35679775,58526661,-10117381,10117381
2024-12-09,8159,8304,8159,8304,73625915,302,10,17593042,56032873,343,18,10613653,63012262,6979389,-6979389
2024-12-10,8340,8502,8259,8268,46678869,372,16,9760174,36918695,430,12,15726003,30952866,-5965829,5965829
2024-12-11,8385,8574,8286,8574,36050522,314,14,8284145,27766377,559,12,21421668,14628854,-13137523,13137523
2024-12-14,8691,8691,8691,8691,16245846,29,16,7073565,9172281,272,3,3087846,13158000,3985719,-3985719
2024-12-15,8944,8944,8836,8944,156679436,656,29,47730903,108948533,518,19,40497639,116181797,7233264,-7233264
2024-12-16,9196,9205,9007,9169,108948869,683,18,39075997,69872872,812,26,41529334,67419535,-2453337,2453337
2024-12-17,9169,9458,8953,9016,83740020,722,20,22849246,60890774,956,29,46727195,37012825,-23877949,23877949
2024-12-18,9196,9557,9187,9557,73571043,378,15,32771040,40800003,829,32,24295542,49275501,8475498,-8475498
2024-12-21,9791,9791,9791,9791,20922037,153,3,16812037,4110000,248,10,5094606,15827431,11717431,-11717431
2024-12-22,10080,10080,10062,10080,77382037,508,10,41708719,35673318,492,19,33889150,43492887,7819569,-7819569
2024-12-23,10377,10377,10377,10377,31552065,42,3,10780352,20771713,294,9,3443058,28109007,7337294,-7337294
2024-12-24,10684,10684,10684,10684,40006634,169,10,34106634,5900000,339,9,3586947,36419687,30519687,-30519687
2024-12-25,10999,10999,10684,10999,236562335,2198,37,130247965,106314370,1359,36,94323619,142238716,35924346,-35924346
2024-12-28,10990,10990,10666,10666,104145262,1067,15,24156296,80193907,627,16,48143228,56206975,-23986932,23986932
2024-12-29,10368,10594,10359,10359,50178461,465,13,7840461,42338000,285,11,33206978,16971483,-25366517,25366517
2024-12-30,10062,10368,10062,10062,161866440,937,22,28041863,133824577,1229,33,73044795,88821645,-45002932,45002932
2024-12-31,9863,10359,9863,10332,36938975,712,16,26138564,10800411,894,15,28443502,8495473,-2304938,2304938
2025-01-01,10459,10567,10278,10567,47466882,699,16,29577882,17889000,855,9,21723400,25743482,7854482,-7854482
2025-01-04,10621,10666,10549,10666,52079923,448,14,27302739,24777184,313,17,6128262,45951661,21174477,-21174477
2025-01-05,10909,10909,10431,10522,31093743,1062,14,17360070,13733673,600,10,17045708,14048035,314362,-314362
2025-01-06,10504,10900,10314,10630,43158149,740,13,8270451,34887698,548,15,28763286,14394863,-20492835,20492835
2025-01-07,10729,10864,10630,10864,69414904,620,17,17810954,51603950,726,14,22673691,46741213,-4862737,4862737
2025-01-08,10936,11090,10738,10810,45668894,682,11,12827734,32841160,654,16,20586313,25082581,-7758579,7758579
2025-01-11,10972,10972,10531,10531,62109773,858,16,26736912,35372861,655,14,49332180,12777593,-22595268,22595268
2025-01-12,10269,10404,10260,10260,36261118,669,11,12979275,23281843,466,22,20726887,15534231,-7747612,7747612
2025-01-13,10152,10459,10143,10251,27674782,535,10,15948721,11726061,431,11,15861621,11813161,87100,-87100
2025-01-15,10332,10459,10125,10170,13983128,520,7,6076225,7906903,376,9,9820736,4162392,-3744511,3744511
2025-01-18,10170,10170,9909,9909,21513359,501,10,3707045,17806314,235,6,8451839,13061520,-4744794,4744794
2025-01-19,9638,9872,9620,9620,40521568,823,19,11293191,29228377,400,14,15550033,24971535,-4256842,4256842
2025-01-20,9494,9872,9386,9386,26707131,585,14,5979014,20728117,405,10,20356662,6350469,-14377648,14377648
2025-01-21,9413,9737,9250,9701,23884281,556,13,14015437,9868844,393,9,11832032,12052249,2183405,-2183405
2025-01-22,9800,9800,9800,9800,52777644,191,4,20922474,7919085,257,11,6264550,22577009,14657924,-14657924
2025-01-25,10089,10089,9945,10026,69840672,854,8,59897757,9942915,551,16,29393290,40447382,30504467,-30504467
2025-01-26,9981,10206,9818,9836,25194694,529,11,6471047,18723647,377,5,12023277,13171417,-5552230,5552230
2025-01-27,9836,10188,9665,9891,23628755,477,15,7201294,16427461,387,11,13151885,10476870,-5950591,5950591
2025-01-29,9963,10143,9891,9918,16908315,420,4,11442326,5465989,283,5,10603582,6304733,838744,-838744
2025-02-01,9719,9954,9656,9764,38707947,617,14,8147015,30560932,379,10,24993961,13713986,-16846946,16846946
2025-02-02,9854,9954,9710,9728,27657591,450,10,8501945,19155646,336,9,15821745,11835846,-7319800,7319800
2025-02-03,9909,9936,9692,9918,24454221,306,10,5611639,18842582,321,7,16120937,8333284,-10509298,10509298
2025-02-04,9918,10116,9918,10017,24385307,392,7,10168307,14217000,325,14,6837655,17547652,3330652,-3330652
2025-02-05,9999,10170,9809,10053,19737346,346,10,6792185,12945161,376,10,8308393,11428953,-1516208,1516208
2025-02-09,10089,10341,9954,10035,55741526,800,14,26992999,28748527,761,16,21620912,34120614,5372087,-5372087
2025-02-11,9990,10233,9945,9945,58000337,494,18,8039199,49961138,535,11,39740424,18259913,-31701225,31701225
2025-02-15,9782,9791,9692,9692,46465894,386,14,8299417,38166477,464,8,30166387,16299507,-21866970,21866970
2025-02-16,9593,9909,9413,9638,44270934,748,18,23572344,20698590,571,6,19907179,24363755,3665165,-3665165
2025-02-17,9683,9909,9683,9836,51615688,752,12,35906344,15709344,452,13,16001390,35614298,19904954,-19904954
2025-02-18,9882,10179,9882,10179,62282879,875,9,46863695,15419184,492,16,12924430,49358449,33939265,-33939265
2025-02-19,10305,10459,10215,10251,45620098,945,9,29907839,15712259,525,18,18213544,27406554,11694295,-11694295
2025-02-22,10323,10368,10116,10323,30585001,725,6,19614670,10970331,609,5,24343621,6241380,-4728951,4728951
2025-02-23,10188,10531,10188,10531,35713575,640,2,32996168,2717407,512,10,30565067,5148508,2431101,-2431101
2025-02-24,10693,10729,10684,10729,99554430,1314,17,79874459,19679971,691,16,28770488,70783942,51103971,-51103971
2025-03-01,10560,10600,10300,10400,20589958,376,3,7717908,12872050,224,2,17831700,2758258,-10113792,10113792
2025-03-02,10420,10660,10160,10630,45981026,894,12,25291542,20689484,588,10,33831380,12149646,-8539838,8539838
2025-03-03,10220,10220,10220,10220,16424807,468,6,4298265,12126542,124,2,13525967,2898840,-9227702,9227702
2025-03-04,10040,10380,9920,9950,53431178,1638,12,30585643,22845535,545,12,33802479,19628699,-3216836,3216836
2025-03-05,9990,10090,9740,9930,57306348,865,11,9909524,47396824,511,9,19389014,37917334,-9479490,9479490
2025-03-08,9780,9860,9600,9600,29183777,653,10,6124599,23059178,356,8,27919793,1263984,-21795194,21795194
2025-03-09,9600,9640,9360,9520,51806963,631,8,8449824,43357139,655,17,33141138,18665825,-24691314,24691314
2025-03-10,9690,9690,9330,9400,14835749,443,7,6742698,8093051,358,9,8881083,5954666,-2138385,2138385
2025-03-11,9420,9500,9140,9140,25523896,581,10,7806202,17717694,298,12,13078627,12445269,-5272425,5272425
2025-03-12,9180,9440,9050,9440,26227669,439,12,7714495,18513174,369,10,9639830,16587839,-1925335,1925335
2025-03-15,9470,9470,9400,9470,96921972,495,11,60590625,36331347,212,15,10899972,86022000,49690653,-49690653
2025-03-16,9690,9690,9300,9460,30516655,649,11,16966239,13550416,278,16,9265008,21251647,7701231,-7701231
2025-03-17,9470,9510,9240,9260,29471438,524,8,9305897,20165541,341,11,20432301,9039137,-11126404,11126404
2025-03-18,9080,9370,9080,9310,48802130,571,9,5960391,42841739,481,15,30097442,18704688,-24137051,24137051
2025-03-25,9400,9440,9360,9440,24079325,554,6,20078625,4000700,179,8,2839494,21239831,17239131,-17239131
2025-03-26,9580,9640,9330,9420,21118320,481,8,10411372,10706948,204,13,4721006,16397314,5690366,-5690366
2025-03-29,9450,9690,9400,9560,29278846,367,9,20297757,8981089,362,6,10620118,18658728,9677639,-9677639
2025-03-30,9600,9780,9500,9780,27018570,447,6,15482716,11535854,306,12,6839311,20179259,8643405,-8643405
2025-04-05,9800,9800,9520,9660,16896360,383,3,7253518,9642842,317,5,13925776,2970584,-6672258,6672258
2025-04-06,9510,9690,9400,9420,15895542,409,7,3993496,11902046,267,7,12025099,3870443,-8031603,8031603
2025-04-07,9300,9570,9250,9350,28410649,294,7,5980628,22430021,283,9,13287552,15123097,-7306924,7306924
2025-04-08,9660,9660,9660,9660,15837433,136,3,10704205,4602728,107,5,4006933,11300000,6697272,-6697272
